تلوثين	ت ل و ث ي ن
بجانب	ب ج ا ن ب
استعرفت	ا س ت ع ر ف ت
حجل	ح ج ل
فكرتم	ف ك ر ت م
توسمن	ت و س م ن
دحرجتن	د ح ر ج ت ن
استدرر	ا س ت د ر ر
مربيات	م ر ب ي ا ت
تتبعون	ت ت ب ع و ن
عمين	ع م ي ن
اقض	ا ق ض
نمحى	ن م ح ى
عاوني	ع ا و ن ي
يورد	ي و ر د
سائمة	س ا ئ م ة
تعجبنا	ت ع ج ب ن ا
ضمور	ض م و ر
تبتلعن	ت ب ت ل ع ن
توسم	ت و س م
بعدت	ب ع د ت
اسقطي	ا س ق ط ي
ارقص	ا ر ق ص
حطن	ح ط ن
دجال	د ج ا ل
ارتب	ا ر ت ب
رزي	ر ز ي
جومع	ج و م ع
قديرة	ق د ي ر ة
تعيدون	ت ع ي د و ن
يسلمون	ي س ل م و ن
تضادت	ت ض ا د ت
يزدردون	ي ز د ر د و ن
أنفار	أ ن ف ا ر
تخرقين	ت خ ر ق ي ن
خنت	خ ن ت
ميلان	م ي ل ا ن
تتطوع	ت ت ط و ع
يوافون	ي و ا ف و ن
يتوجد	ي ت و ج د
مارونيات	م ا ر و ن ي ا ت
ماش	م ا ش
سماحة	س م ا ح ة
يتنافسوا	ي ت ن ا ف س و ا
أرشدوا	أ ر ش د و ا
طود	ط و د
اغلطوا	ا غ ل ط و ا
جاب	ج ا ب
يهددون	ي ه د د و ن
شندقورة	ش ن د ق و ر ة
ينوين	ي ن و ي ن
أنبئوا	أ ن ب ئ و ا
استقالة	ا س ت ق ا ل ة
اخترعوا	ا خ ت ر ع و ا
تتجمعن	ت ت ج م ع ن
يتلعبون	ي ت ل ع ب و ن
تناسبن	ت ن ا س ب ن
فكاهة	ف ك ا ه ة
مقالات	م ق ا ل ا ت
نورى	ن و ر ى
نعتن	ن ع ت ن
شئان	ش ئ ا ن
أسعل	أ س ع ل
يتوفون	ي ت و ف و ن
تنفدن	ت ن ف د ن
وصاية	و ص ا ي ة
تحتلم	ت ح ت ل م
يطلقوا	ي ط ل ق و ا
ينظرن	ي ن ظ ر ن
يستعبدون	ي س ت ع ب د و ن
اصطلاء	ا ص ط ل ا ء
سرن	س ر ن
يجنن	ي ج ن ن
يوصلون	ي و ص ل و ن
راديو	ر ا د ي و
كونتن	ك و ن ت ن
سلختن	س ل خ ت ن
تروفع	ت ر و ف ع
رجعي	ر ج ع ي
اقترحنا	ا ق ت ر ح ن ا
أكاتب	أ ك ا ت ب
نفينا	ن ف ي ن ا
يتل	ي ت ل
شعرتن	ش ع ر ت ن
أزركش	أ ز ر ك ش
تصوم	ت ص و م
ارجحننتن	ا ر ج ح ن ن ت ن
نادى	ن ا د ى
أؤدب	أ ؤ د ب
سبحتم	س ب ح ت م
ملك	م ل ك
صيدوا	ص ي د و ا
تهت	ت ه ت
ثنوية	ث ن و ي ة
اشفق	ا ش ف ق
وريد	و ر ي د
أعملتم	أ ع م ل ت م
احتفظن	ا ح ت ف ظ ن
أجور	أ ج و ر
اقتراحات	ا ق ت ر ا ح ا ت
أحبل	أ ح ب ل
تتجاملون	ت ت ج ا م ل و ن
وقي	و ق ي
قساطل	ق س ا ط ل
بيمارستان	ب ي م ا ر س ت ا ن
تعالين	ت ع ا ل ي ن
تمكثون	ت م ك ث و ن
نعال	ن ع ا ل
صبحتن	ص ب ح ت ن
حوذان	ح و ذ ا ن
اخرنماس	ا خ ر ن م ا س
مصصتم	م ص ص ت م
توقظي	ت و ق ظ ي
أهدأ	أ ه د أ
العقوا	ا ل ع ق و ا
أبدال	أ ب د ا ل
ننعظ	ن ن ع ظ
استعجال	ا س ت ع ج ا ل
ترتد	ت ر ت د
اشتجار	ا ش ت ج ا ر
تشاركنا	ت ش ا ر ك ن ا
يحماررن	ي ح م ا ر ر ن
تتزين	ت ت ز ي ن
بكرتم	ب ك ر ت م
تتمثلي	ت ت م ث ل ي
آمرتن	آ م ر ت ن
صمتنا	ص م ت ن ا
يجسدون	ي ج س د و ن
سفانة	س ف ا ن ة
انفد	ا ن ف د
تتفطر	ت ت ف ط ر
يؤلون	ي ؤ ل و ن
اعتقدنا	ا ع ت ق د ن ا
استنرت	ا س ت ن ر ت
تصورنا	ت ص و ر ن ا
تبالين	ت ب ا ل ي ن
جنوبي	ج ن و ب ي
رفعوا	ر ف ع و ا
تكلم	ت ك ل م
يدررن	ي د ر ر ن
تقئ	ت ق ئ
حتام	ح ت ا م
ننمي	ن ن م ي
قولنج	ق و ل ن ج
غليتم	غ ل ي ت م
يسمين	ي س م ي ن
تثقف	ت ث ق ف
نباهة	ن ب ا ه ة
أتطاول	أ ت ط ا و ل
يخضلل	ي خ ض ل ل
روفعن	ر و ف ع ن
امتحنتم	ا م ت ح ن ت م
نجعل	ن ج ع ل
نؤل	ن ؤ ل
صحى	ص ح ى
كتيب	ك ت ي ب
فتلة	ف ت ل ة
تدروا	ت د ر و ا
نزدن	ن ز د ن
تمروا	ت م ر و ا
أعمدة	أ ع م د ة
أكواب	أ ك و ا ب
نطعن	ن ط ع ن
مشغولة	م ش غ و ل ة
انحل	ا ن ح ل
عرفانية	ع ر ف ا ن ي ة
تزلزلنا	ت ز ل ز ل ن ا
تتهيأوا	ت ت ه ي أ و ا
ننو	ن ن و
نستسر	ن س ت س ر
تلقوا	ت ل ق و ا
صيهب	ص ي ه ب
ترجعين	ت ر ج ع ي ن
أتوفى	أ ت و ف ى
انتظرتن	ا ن ت ظ ر ت ن
ترتعدي	ت ر ت ع د ي
نتبول	ن ت ب و ل
حسانية	ح س ا ن ي ة
نركض	ن ر ك ض
استسقينا	ا س ت س ق ي ن ا
استقطرت	ا س ت ق ط ر ت
انظروا	ا ن ظ ر و ا
دمجانة	د م ج ا ن ة
متفوقة	م ت ف و ق ة
أصلي	أ ص ل ي
أوقعتن	أ و ق ع ت ن
تبدي	ت ب د ي
صروحة	ص ر و ح ة
شوهدنا	ش و ه د ن ا
استحت	ا س ت ح ت
أحنى	أ ح ن ى
كباري	ك ب ا ر ي
صدي	ص د ي
ميلة	م ي ل ة
قلينا	ق ل ي ن ا
تريدي	ت ر ي د ي
تنوم	ت ن و م
ينبسطن	ي ن ب س ط ن
مقدمون	م ق د م و ن
اجلعبوا	ا ج ل ع ب و ا
ذقتم	ذ ق ت م
أشمئز	أ ش م ئ ز
يماسوا	ي م ا س و ا
فتحنا	ف ت ح ن ا
طاح	ط ا ح
استدفئ	ا س ت د ف ئ
اسبحوا	ا س ب ح و ا
شائعات	ش ا ئ ع ا ت
غاضب	غ ا ض ب
تتطاولي	ت ت ط ا و ل ي
نحال	ن ح ا ل
يبصر	ي ب ص ر
دعاء	د ع ا ء
يظلمون	ي ظ ل م و ن
ازو	ا ز و
تستقطرون	ت س ت ق ط ر و ن
علقم	ع ل ق م
أوسوس	أ و س و س
تفسقن	ت ف س ق ن
أحقر	أ ح ق ر
اقرعوا	ا ق ر ع و ا
شهدن	ش ه د ن
تسلنطعوا	ت س ل ن ط ع و ا
تحلمون	ت ح ل م و ن
بواليع	ب و ا ل ي ع
اعرقن	ا ع ر ق ن
ابدون	ا ب د و ن
أمدمي	أ م د م ي
يمح	ي م ح
سولن	س و ل ن
تقيموا	ت ق ي م و ا
يعتزمن	ي ع ت ز م ن
أكرهت	أ ك ر ه ت
أشخصتم	أ ش خ ص ت م
كحلتن	ك ح ل ت ن
جابرت	ج ا ب ر ت
استمسكنا	ا س ت م س ك ن ا
حرنكش	ح ر ن ك ش
تخذل	ت خ ذ ل
تبتين	ت ب ت ي ن
ارتدين	ا ر ت د ي ن
صفيتن	ص ف ي ت ن
ماهية	م ا ه ي ة
سارقنا	س ا ر ق ن ا
ساف	س ا ف
احتفلتم	ا ح ت ف ل ت م
نسخة	ن س خ ة
نيكاراغوا	ن ي ك ا ر ا غ و ا
أضئتم	أ ض ئ ت م
تنمون	ت ن م و ن
قرئنا	ق ر ئ ن ا
اضطرم	ا ض ط ر م
ختن	خ ت ن
بالى	ب ا ل ى
ظعن	ظ ع ن
تتكرهن	ت ت ك ر ه ن
آمن	آ م ن
نوسبت	ن و س ب ت
نبدو	ن ب د و
انعظي	ا ن ع ظ ي
تمتلكين	ت م ت ل ك ي ن
عرضتن	ع ر ض ت ن
تهربتم	ت ه ر ب ت م
تزحلي	ت ز ح ل ي
إتريوم	إ ت ر ي و م
ضوء	ض و ء
يفتقرن	ي ف ت ق ر ن
أصيد	أ ص ي د
أطعمات	أ ط ع م ا ت
حوقل	ح و ق ل
ختنا	خ ت ن ا
تمحقن	ت م ح ق ن
أممنا	أ م م ن ا
يجامل	ي ج ا م ل
تجوزوا	ت ج و ز و ا
يجذر	ي ج ذ ر
شوغلت	ش و غ ل ت
تبتسرن	ت ب ت س ر ن
تقيأنا	ت ق ي أ ن ا
اشتجر	ا ش ت ج ر
يبتلعوا	ي ب ت ل ع و ا
ينتهون	ي ن ت ه و ن
طحال	ط ح ا ل
تمنن	ت م ن ن
تنونون	ت ن و ن و ن
أمهار	أ م ه ا ر
انعكسوا	ا ن ع ك س و ا
أعسال	أ ع س ا ل
جلباب	ج ل ب ا ب
تكملون	ت ك م ل و ن
أنوى	أ ن و ى
اطراح	ا ط ر ا ح
سكينة	س ك ي ن ة
تؤمين	ت ؤ م ي ن
مرجوا	م ر ج و ا
أجنب	أ ج ن ب
نتماسك	ن ت م ا س ك
مالق	م ا ل ق
اثبري	ا ث ب ر ي
أسد	أ س د
تحطم	ت ح ط م
معجم	م ع ج م
صفوا	ص ف و ا
تشوقين	ت ش و ق ي ن
تتثاءبون	ت ت ث ا ء ب و ن
امرئ	ا م ر ئ
حملوا	ح م ل و ا
تذكرين	ت ذ ك ر ي ن
أخشوشب	أ خ ش و ش ب
تخيلن	ت خ ي ل ن
جاورن	ج ا و ر ن
يلقى	ي ل ق ى
يقفن	ي ق ف ن
تداورين	ت د ا و ر ي ن
نادر	ن ا د ر
ضهر	ض ه ر
اقمروا	ا ق م ر و ا
دريان	د ر ي ا ن
تخجيل	ت خ ج ي ل
يستعرفن	ي س ت ع ر ف ن
نكحتن	ن ك ح ت ن
تترجموا	ت ت ر ج م و ا
تبار	ت ب ا ر
اعتملن	ا ع ت م ل ن
ربيثاء	ر ب ي ث ا ء
يستخبر	ي س ت خ ب ر
يكتبوا	ي ك ت ب و ا
تبح	ت ب ح
أمم	أ م م
تبطلوا	ت ب ط ل و ا
غذاء	غ ذ ا ء
استفدتم	ا س ت ف د ت م
حلف	ح ل ف
دبلج	د ب ل ج
تناولن	ت ن ا و ل ن
اصفررتم	ا ص ف ر ر ت م
طولوا	ط و ل و ا
شرين	ش ر ي ن
تشريع	ت ش ر ي ع
يخشوشب	ي خ ش و ش ب
تقطرتم	ت ق ط ر ت م
اتسخن	ا ت س خ ن
قهقه	ق ه ق ه
اشتركي	ا ش ت ر ك ي
لوحظ	ل و ح ظ
عمليون	ع م ل ي و ن
تقلمون	ت ق ل م و ن
قمرن	ق م ر ن
توبعتم	ت و ب ع ت م
صبرة	ص ب ر ة
تسولي	ت س و ل ي
تستقال	ت س ت ق ا ل
تتغيبون	ت ت غ ي ب و ن
احمررتم	ا ح م ر ر ت م
ينفى	ي ن ف ى
تشمس	ت ش م س
ألمن	أ ل م ن
يضرون	ي ض ر و ن
عوار	ع و ا ر
افتكرت	ا ف ت ك ر ت
عباء	ع ب ا ء
ارتاح	ا ر ت ا ح
تداخلن	ت د ا خ ل ن
قهوات	ق ه و ا ت
افتتاحات	ا ف ت ت ا ح ا ت
ملتم	م ل ت م
ايقظوا	ا ي ق ظ و ا
وسيمة	و س ي م ة
كونسرفاتوار	ك و ن س ر ف ا ت و ا ر
قوطي	ق و ط ي
استميتي	ا س ت م ي ت ي
يتقطبوا	ي ت ق ط ب و ا
أعمرتن	أ ع م ر ت ن
دملوج	د م ل و ج
بيطار	ب ي ط ا ر
توحيد	ت و ح ي د
جراية	ج ر ا ي ة
أزني	أ ز ن ي
أجزى	أ ج ز ى
يصطبروا	ي ص ط ب ر و ا
مجري	م ج ر ي
نقهقه	ن ق ه ق ه
تماس	ت م ا س
تخاطبين	ت خ ا ط ب ي ن
تقشعرين	ت ق ش ع ر ي ن
تمسون	ت م س و ن
تتعملن	ت ت ع م ل ن
أمطرنا	أ م ط ر ن ا
إنكليزيات	إ ن ك ل ي ز ي ا ت
نكتشف	ن ك ت ش ف
تتماسون	ت ت م ا س و ن
مطلب	م ط ل ب
مويه	م و ي ه
املأن	ا م ل أ ن
تتقولون	ت ت ق و ل و ن
يجاروا	ي ج ا ر و ا
تقروا	ت ق ر و ا
زرنباد	ز ر ن ب ا د
أظهر	أ ظ ه ر
يطاوعن	ي ط ا و ع ن
أتابع	أ ت ا ب ع
يمنن	ي م ن ن
يقارض	ي ق ا ر ض
منوع	م ن و ع
تسم	ت س م
نحول	ن ح و ل
تسمحين	ت س م ح ي ن
صغوت	ص غ و ت
استماتوا	ا س ت م ا ت و ا
عملة	ع م ل ة
ينفعوا	ي ن ف ع و ا
مضمدة	م ض م د ة
ثانوي	ث ا ن و ي
أخن	أ خ ن
خونتم	خ و ن ت م
تشتجرن	ت ش ت ج ر ن
تطاوعون	ت ط ا و ع و ن
بعدما	ب ع د م ا
لاقوا	ل ا ق و ا
خطام	خ ط ا م
تتهربن	ت ت ه ر ب ن
استقرضن	ا س ت ق ر ض ن
بصقتم	ب ص ق ت م
عيشومة	ع ي ش و م ة
كيفتم	ك ي ف ت م
يشاجر	ي ش ا ج ر
حراقة	ح ر ا ق ة
ابتلع	ا ب ت ل ع
كربلاء	ك ر ب ل ا ء
رومانيات	ر و م ا ن ي ا ت
ترشدوا	ت ر ش د و ا
تورثي	ت و ر ث ي
مناخي	م ن ا خ ي
اربطوا	ا ر ب ط و ا
لبنوا	ل ب ن و ا
تلتفتوا	ت ل ت ف ت و ا
تبختر	ت ب خ ت ر
تشبحوا	ت ش ب ح و ا
نأبى	ن أ ب ى
ندمر	ن د م ر
كهف	ك ه ف
تتأمر	ت ت أ م ر
يتأملون	ي ت أ م ل و ن
تضاددتن	ت ض ا د د ت ن
استجير	ا س ت ج ي ر
عقلاء	ع ق ل ا ء
أوجبن	أ و ج ب ن
يبنون	ي ب ن و ن
أورشليم	أ و ر ش ل ي م
أعامل	أ ع ا م ل
تميتين	ت م ي ت ي ن
خضاب	خ ض ا ب
نسار	ن س ا ر
اتكؤوا	ا ت ك ؤ و ا
مقار	م ق ا ر
دعموص	د ع م و ص
قبضنا	ق ب ض ن ا
يتكافؤون	ي ت ك ا ف ؤ و ن
اثقفوا	ا ث ق ف و ا
تستنين	ت س ت ن ي ن
مصارعة	م ص ا ر ع ة
يجسد	ي ج س د
كوريا	ك و ر ي ا
تخضوضعوا	ت خ ض و ض ع و ا
تدوخلت	ت د و خ ل ت
تبلدن	ت ب ل د ن
تنسحبن	ت ن س ح ب ن
تشرون	ت ش ر و ن
يسببن	ي س ب ب ن
يضائون	ي ض ا ئ و ن
ثابر	ث ا ب ر
قواتل	ق و ا ت ل
نلمس	ن ل م س
عطلتم	ع ط ل ت م
مقدر	م ق د ر
يتمنوا	ي ت م ن و ا
حققن	ح ق ق ن
يعن	ي ع ن
تعزمن	ت ع ز م ن
قسطر	ق س ط ر
استوى	ا س ت و ى
عبقري	ع ب ق ر ي
مرابع	م ر ا ب ع
تستدري	ت س ت د ر ي
مخطط	م خ ط ط
يرعدون	ي ر ع د و ن
سئت	س ئ ت
قمرة	ق م ر ة
انكربن	ا ن ك ر ب ن
تغديت	ت غ د ي ت
امطروا	ا م ط ر و ا
مضاجعة	م ض ا ج ع ة
انتحلن	ا ن ت ح ل ن
يرقد	ي ر ق د
تعضون	ت ع ض و ن
مبان	م ب ا ن
تهودين	ت ه و د ي ن
استرجلي	ا س ت ر ج ل ي
نطوع	ن ط و ع
تماست	ت م ا س ت
يرشش	ي ر ش ش
يرجسوا	ي ر ج س و ا
نيسر	ن ي س ر
باريتن	ب ا ر ي ت ن
تشاجرين	ت ش ا ج ر ي ن
نناسب	ن ن ا س ب
أوصال	أ و ص ا ل
تواضعتم	ت و ا ض ع ت م
يزيتون	ي ز ي ت و ن
تتكالب	ت ت ك ا ل ب
شبك	ش ب ك
ختان	خ ت ا ن
تعتملن	ت ع ت م ل ن
جنبي	ج ن ب ي
كائن	ك ا ئ ن
كفر	ك ف ر
هذروا	ه ذ ر و ا
طووعن	ط و و ع ن
تروددن	ت ر و د د ن
نخرطم	ن خ ر ط م
تأجري	ت أ ج ر ي
استنسبتم	ا س ت ن س ب ت م
تشميس	ت ش م ي س
سرحان	س ر ح ا ن
تحيلي	ت ح ي ل ي
أجهد	أ ج ه د
يطبون	ي ط ب و ن
كزمازج	ك ز م ا ز ج
تجنبون	ت ج ن ب و ن
يصطبرون	ي ص ط ب ر و ن
تتواقف	ت ت و ا ق ف
تستطعن	ت س ت ط ع ن
تعاقبين	ت ع ا ق ب ي ن
سنباذج	س ن ب ا ذ ج
نستقتل	ن س ت ق ت ل
مضمد	م ض م د
جوزوا	ج و ز و ا
استجمعنا	ا س ت ج م ع ن ا
تالين	ت ا ل ي ن
تستقرؤون	ت س ت ق ر ؤ و ن
فنار	ف ن ا ر
تنقلي	ت ن ق ل ي
كوخ	ك و خ
كاكنج	ك ا ك ن ج
اذلعببن	ا ذ ل ع ب ب ن
تيقظوا	ت ي ق ظ و ا
نهاوند	ن ه ا و ن د
سلة	س ل ة
يطف	ي ط ف
ارتجل	ا ر ت ج ل
تمسس	ت م س س
نتحفظ	ن ت ح ف ظ
اخرجي	ا خ ر ج ي
الطف	ا ل ط ف
إكتاب	إ ك ت ا ب
تبدؤون	ت ب د ؤ و ن
اقلموا	ا ق ل م و ا
انطفأنا	ا ن ط ف أ ن ا
باطني	ب ا ط ن ي
تخلق	ت خ ل ق
أبهمت	أ ب ه م ت
شفي	ش ف ي
يشعرن	ي ش ع ر ن
يقهقهون	ي ق ه ق ه و ن
ممطر	م م ط ر
زاغ	ز ا غ
تتماثلين	ت ت م ا ث ل ي ن
افتعلنا	ا ف ت ع ل ن ا
شوب	ش و ب
تتدوري	ت ت د و ر ي
شخبط	ش خ ب ط
أنمى	أ ن م ى
طلبات	ط ل ب ا ت
جومعوا	ج و م ع و ا
نضاع	ن ض ا ع
أنبئتم	أ ن ب ئ ت م
خص	خ ص
تمضون	ت م ض و ن
اتمم	ا ت م م
جاوشير	ج ا و ش ي ر
أهد	أ ه د
احرنفزي	ا ح ر ن ف ز ي
تدلون	ت د ل و ن
عبدتم	ع ب د ت م
استوردتن	ا س ت و ر د ت ن
صحاح	ص ح ا ح
أعطوا	أ ع ط و ا
طحمة	ط ح م ة
ينفعلوا	ي ن ف ع ل و ا
تخضيل	ت خ ض ي ل
تجلعدون	ت ج ل ع د و ن
مضو	م ض و
لزج	ل ز ج
تماسون	ت م ا س و ن
نفونا	ن ف و ن ا
مظلمون	م ظ ل م و ن
شعير	ش ع ي ر
انعكسنا	ا ن ع ك س ن ا
كريك	ك ر ي ك
اوهلوا	ا و ه ل و ا
عوملتن	ع و م ل ت ن
احتربت	ا ح ت ر ب ت
تتوافق	ت ت و ا ف ق
نغرر	ن غ ر ر
أنجزتن	أ ن ج ز ت ن
أخامر	أ خ ا م ر
استهداف	ا س ت ه د ا ف
حساء	ح س ا ء
فارقت	ف ا ر ق ت
تفرجون	ت ف ر ج و ن
تصرر	ت ص ر ر
يؤكلوا	ي ؤ ك ل و ا
تواصلتم	ت و ا ص ل ت م
تأخري	ت أ خ ر ي
حمدتم	ح م د ت م
تظللون	ت ظ ل ل و ن
أستلق	أ س ت ل ق
تمحصين	ت م ح ص ي ن
أللنا	أ ل ل ن ا
يرافقن	ي ر ا ف ق ن
تبالوا	ت ب ا ل و ا
متداولة	م ت د ا و ل ة
احلموا	ا ح ل م و ا
طالبة	ط ا ل ب ة
أزهرن	أ ز ه ر ن
أعبس	أ ع ب س
تصدير	ت ص د ي ر
قسطنطين	ق س ط ن ط ي ن
تخلدن	ت خ ل د ن
اجرؤن	ا ج ر ؤ ن
برنية	ب ر ن ي ة
تحكمون	ت ح ك م و ن
يتسمم	ي ت س م م
اعبدن	ا ع ب د ن
تسدوا	ت س د و ا
غجر	غ ج ر
غيوم	غ ي و م
أنيون	أ ن ي و ن
بسطنا	ب س ط ن ا
تستسلموا	ت س ت س ل م و ا
عناب	ع ن ا ب
مرتد	م ر ت د
تتراددي	ت ت ر ا د د ي
معلقة	م ع ل ق ة
نضر	ن ض ر
اخص	ا خ ص
يبطؤون	ي ب ط ؤ و ن
كفف	ك ف ف
مزاح	م ز ا ح
يبدأوا	ي ب د أ و ا
تبرغشون	ت ب ر غ ش و ن
لقيت	ل ق ي ت
تجنبين	ت ج ن ب ي ن
يريح	ي ر ي ح
خطمية	خ ط م ي ة
تنحلت	ت ن ح ل ت
تلقن	ت ل ق ن
يسولوا	ي س و ل و ا
تستنبؤوا	ت س ت ن ب ؤ و ا
تثبري	ت ث ب ر ي
ألفن	أ ل ف ن
يؤتي	ي ؤ ت ي
سلكتن	س ل ك ت ن
تؤاتون	ت ؤ ا ت و ن
تنهي	ت ن ه ي
اختتنتن	ا خ ت ت ن ت ن
رجيتن	ر ج ي ت ن
فررت	ف ر ر ت
كفات	ك ف ا ت
امتلكن	ا م ت ل ك ن
عفر	ع ف ر
امطري	ا م ط ر ي
ترتجين	ت ر ت ج ي ن
افتتحتن	ا ف ت ت ح ت ن
تنفرين	ت ن ف ر ي ن
احرنشفت	ا ح ر ن ش ف ت
اخنبوا	ا خ ن ب و ا
يؤولن	ي ؤ و ل ن
أتعالى	أ ت ع ا ل ى
يتجمعون	ي ت ج م ع و ن
دفوق	د ف و ق
تنمي	ت ن م ي
أسخر	أ س خ ر
حووطتن	ح و و ط ت ن
تسندن	ت س ن د ن
تضيعون	ت ض ي ع و ن
ناجد	ن ا ج د
يتعربون	ي ت ع ر ب و ن
رثوا	ر ث و ا
اقتصد	ا ق ت ص د
تطارحي	ت ط ا ر ح ي
أتجدد	أ ت ج د د
احجبة	ا ح ج ب ة
يجرع	ي ج ر ع
تؤوون	ت ؤ و و ن
تتوجدوا	ت ت و ج د و ا
نذرى	ن ذ ر ى
تخبرون	ت خ ب ر و ن
تشركوا	ت ش ر ك و ا
نوديتن	ن و د ي ت ن
بجع	ب ج ع
يبتسرون	ي ب ت س ر و ن
تستحضرون	ت س ت ح ض ر و ن
تفرقون	ت ف ر ق و ن
يصبح	ي ص ب ح
تناعس	ت ن ا ع س
تجاهدين	ت ج ا ه د ي ن
كشط	ك ش ط
تتآمر	ت ت آ م ر
تباركنا	ت ب ا ر ك ن ا
بوليتن	ب و ل ي ت ن
حيعل	ح ي ع ل
مضجع	م ض ج ع
تمصص	ت م ص ص
تجهزين	ت ج ه ز ي ن
يقدموا	ي ق د م و ا
رطانة	ر ط ا ن ة
يثأروا	ي ث أ ر و ا
يبشروا	ي ب ش ر و ا
تجلنفع	ت ج ل ن ف ع
تستقرض	ت س ت ق ر ض
سجنتم	س ج ن ت م
أنهر	أ ن ه ر
باطس	ب ا ط س
آتيتن	آ ت ي ت ن
ترهفوا	ت ر ه ف و ا
يأبوا	ي أ ب و ا
تحريم	ت ح ر ي م
يوهبوا	ي و ه ب و ا
مخطوب	م خ ط و ب
دمنة	د م ن ة
تتثنون	ت ت ث ن و ن
ندري	ن د ر ي
تتكاثرون	ت ت ك ا ث ر و ن
سجلات	س ج ل ا ت
אבן	א ב ן
تنقصون	ت ن ق ص و ن
تتخبرين	ت ت خ ب ر ي ن
يكتبن	ي ك ت ب ن
ميثرة	م ي ث ر ة
نعطس	ن ع ط س
يتلل	ي ت ل ل
ينج	ي ن ج
سؤنا	س ؤ ن ا
ناعور	ن ا ع و ر
صتيت	ص ت ي ت
عفريت	ع ف ر ي ت
تستفهموا	ت س ت ف ه م و ا
أتقى	أ ت ق ى
يثقفون	ي ث ق ف و ن
انسد	ا ن س د
كاتبتم	ك ا ت ب ت م
تمتلكي	ت م ت ل ك ي
درن	د ر ن
عزبتن	ع ز ب ت ن
اطلبي	ا ط ل ب ي
تحالي	ت ح ا ل ي
تفصلين	ت ف ص ل ي ن
جلست	ج ل س ت
طع	ط ع
انفرد	ا ن ف ر د
مجدنا	م ج د ن ا
يمرنوا	ي م ر ن و ا
احملي	ا ح م ل ي
تفجرين	ت ف ج ر ي ن
تبدأن	ت ب د أ ن
ميلولة	م ي ل و ل ة
يغرم	ي غ ر م
حفلتن	ح ف ل ت ن
سورقوا	س و ر ق و ا
أصعب	أ ص ع ب
قدام	ق د ا م
انتسبت	ا ن ت س ب ت
أبرز	أ ب ر ز
يتفقون	ي ت ف ق و ن
مرخ	م ر خ
اعوججنا	ا ع و ج ج ن ا
أقبرت	أ ق ب ر ت
جواب	ج و ا ب
يتضايق	ي ت ض ا ي ق
نمكث	ن م ك ث
تتأمري	ت ت أ م ر ي
صرصور	ص ر ص و ر
يقنعن	ي ق ن ع ن
جي	ج ي
يثقف	ي ث ق ف
أسوء	أ س و ء
حسرة	ح س ر ة
مرانة	م ر ا ن ة
احرنفز	ا ح ر ن ف ز
تثقلون	ت ث ق ل و ن
مصرن	م ص ر ن
كبستم	ك ب س ت م
حطتن	ح ط ت ن
ألمانيات	أ ل م ا ن ي ا ت
نجل	ن ج ل
نجمت	ن ج م ت
سرعتم	س ر ع ت م
ترددنا	ت ر د د ن ا
أتزلزل	أ ت ز ل ز ل
عنابر	ع ن ا ب ر
أساوى	أ س ا و ى
استقيل	ا س ت ق ي ل
أيوبي	أ ي و ب ي
استرجلت	ا س ت ر ج ل ت
تألون	ت أ ل و ن
يتطوع	ي ت ط و ع
تحاشوا	ت ح ا ش و ا
قلدي	ق ل د ي
اجتماع	ا ج ت م ا ع
مفاوز	م ف ا و ز
ايبقوا	ا ي ب ق و ا
تقود	ت ق و د
خطمي	خ ط م ي
اندفاق	ا ن د ف ا ق
حسست	ح س س ت
ثبطن	ث ب ط ن
أخالط	أ خ ا ل ط
بالاديوم	ب ا ل ا د ي و م
يتببن	ي ت ب ب ن
إسبانيون	إ س ب ا ن ي و ن
يكفر	ي ك ف ر
تجرتم	ت ج ر ت م
افرضن	ا ف ر ض ن
بردانة	ب ر د ا ن ة
زلزلت	ز ل ز ل ت
يمكنوا	ي م ك ن و ا
دفقتم	د ف ق ت م
احكمي	ا ح ك م ي
نعامل	ن ع ا م ل
يشاهر	ي ش ا ه ر
اغتصاب	ا غ ت ص ا ب
طولن	ط و ل ن
نجير	ن ج ي ر
اثنيتن	ا ث ن ي ت ن
أميبي	أ م ي ب ي
نخشوشن	ن خ ش و ش ن
يهمل	ي ه م ل
تجلعبوا	ت ج ل ع ب و ا
تستقطرين	ت س ت ق ط ر ي ن
تعطسوا	ت ع ط س و ا
فاكهة	ف ا ك ه ة
ادرجي	ا د ر ج ي
ألزموا	أ ل ز م و ا
تشرط	ت ش ر ط
قطورات	ق ط و ر ا ت
استحضر	ا س ت ح ض ر
مربون	م ر ب و ن
مذي	م ذ ي
عفارم	ع ف ا ر م
تكلف	ت ك ل ف
يستعدوا	ي س ت ع د و ا
تتجانسين	ت ت ج ا ن س ي ن
متدينون	م ت د ي ن و ن
يدلوا	ي د ل و ا
خضلتن	خ ض ل ت ن
احصدوا	ا ح ص د و ا
حالات	ح ا ل ا ت
يتقامرن	ي ت ق ا م ر ن
فقدتم	ف ق د ت م
لومسنا	ل و م س ن ا
عجيب	ع ج ي ب
تساءلون	ت س ا ء ل و ن
طهاية	ط ه ا ي ة
أغربة	أ غ ر ب ة
تفهرسي	ت ف ه ر س ي
زبدتن	ز ب د ت ن
إنجيل	إ ن ج ي ل
مظلة	م ظ ل ة
تشمعن	ت ش م ع ن
بارينا	ب ا ر ي ن ا
يأتمم	ي أ ت م م
يشخصوا	ي ش خ ص و ا
تحكمت	ت ح ك م ت
رجلتم	ر ج ل ت م
يحمرر	ي ح م ر ر
كدمة	ك د م ة
مخاض	م خ ا ض
تنكف	ت ن ك ف
يصرف	ي ص ر ف
نعتمر	ن ع ت م ر
زباء	ز ب ا ء
هضب	ه ض ب
تتمنوا	ت ت م ن و ا
نتضوأ	ن ت ض و أ
احكي	ا ح ك ي
اضرغطاط	ا ض ر غ ط ا ط
تضلي	ت ض ل ي
طهى	ط ه ى
تقفزي	ت ق ف ز ي
حض	ح ض
يتصل	ي ت ص ل
أرف	أ ر ف
شمعتن	ش م ع ت ن
تتعرقوا	ت ت ع ر ق و ا
أصغرتن	أ ص غ ر ت ن
بوسي	ب و س ي
نرهف	ن ر ه ف
تتداخلي	ت ت د ا خ ل ي
أرجى	أ ر ج ى
يفضلن	ي ف ض ل ن
أبث	أ ب ث
يسرتم	ي س ر ت م
اهدفي	ا ه د ف ي
انتظار	ا ن ت ظ ا ر
نستعليق	ن س ت ع ل ي ق
مقاشر	م ق ا ش ر
عاهة	ع ا ه ة
زهاد	ز ه ا د
تتضاددوا	ت ت ض ا د د و ا
قلما	ق ل م ا
تفحشي	ت ف ح ش ي
طير	ط ي ر
أستعدد	أ س ت ع د د
نتعفن	ن ت ع ف ن
سيروا	س ي ر و ا
تتنجمن	ت ت ن ج م ن
تدرسون	ت د ر س و ن
يرقدون	ي ر ق د و ن
يتوب	ي ت و ب
أوقفوا	أ و ق ف و ا
تتصادرون	ت ت ص ا د ر و ن
ناتو	ن ا ت و
تخضرون	ت خ ض ر و ن
سميد	س م ي د
محقتن	م ح ق ت ن
مثليون	م ث ل ي و ن
غلم	غ ل م
تدورت	ت د و ر ت
تستدير	ت س ت د ي ر
أنحلتن	أ ن ح ل ت ن
طحين	ط ح ي ن
أدون	أ د و ن
أربط	أ ر ب ط
تحاربتن	ت ح ا ر ب ت ن
باذنجانة	ب ا ذ ن ج ا ن ة
تقفيل	ت ق ف ي ل
يتكاثروا	ي ت ك ا ث ر و ا
قبلة	ق ب ل ة
انعكاس	ا ن ع ك ا س
قع	ق ع
تستمرر	ت س ت م ر ر
بحروا	ب ح ر و ا
كودين	ك و د ي ن
يكفروا	ي ك ف ر و ا
جاورنا	ج ا و ر ن ا
يمحص	ي م ح ص
ركزنا	ر ك ز ن ا
نرخ	ن ر خ
جاودار	ج ا و د ا ر
شوغل	ش و غ ل
ملأتن	م ل أ ت ن
ابطلوا	ا ب ط ل و ا
أبق	أ ب ق
قميحة	ق م ي ح ة
أجبل	أ ج ب ل
سخري	س خ ر ي
تنيمي	ت ن ي م ي
أويتم	أ و ي ت م
جبلي	ج ب ل ي
تساءلين	ت س ا ء ل ي ن
أخزن	أ خ ز ن
نفقت	ن ف ق ت
مبتذلة	م ب ت ذ ل ة
موافقون	م و ا ف ق و ن
تبتسري	ت ب ت س ر ي
تبيض	ت ب ي ض
تتحفظين	ت ت ح ف ظ ي ن
أشغلوا	أ ش غ ل و ا
سجدتم	س ج د ت م
يتحوى	ي ت ح و ى
تأملتم	ت أ م ل ت م
سننت	س ن ن ت
يتقيؤون	ي ت ق ي ؤ و ن
اربوا	ا ر ب و ا
تعطس	ت ع ط س
صودرتم	ص و د ر ت م
تطفوا	ت ط ف و ا
فجائي	ف ج ا ئ ي
توكأن	ت و ك أ ن
جبس	ج ب س
يستجمعن	ي س ت ج م ع ن
افرشن	ا ف ر ش ن
قددن	ق د د ن
تتسممون	ت ت س م م و ن
تطرفت	ت ط ر ف ت
تقفلون	ت ق ف ل و ن
مقاوم	م ق ا و م
يقاس	ي ق ا س
تؤتون	ت ؤ ت و ن
آثرتن	آ ث ر ت ن
اقتضبي	ا ق ت ض ب ي
قهر	ق ه ر
نبطأ	ن ب ط أ
تخلفي	ت خ ل ف ي
رمانيات	ر م ا ن ي ا ت
الفاطر	ا ل ف ا ط ر
نعنى	ن ع ن ى
حوضرتن	ح و ض ر ت ن
أرجوحة	أ ر ج و ح ة
بقشة	ب ق ش ة
بريد	ب ر ي د
تشاءم	ت ش ا ء م
إفرنجي	إ ف ر ن ج ي
أتفرق	أ ت ف ر ق
اجررن	ا ج ر ر ن
كرز	ك ر ز
ذباب	ذ ب ا ب
يبتلع	ي ب ت ل ع
اخضلي	ا خ ض ل ي
قبط	ق ب ط
تتماسسن	ت ت م ا س س ن
قادت	ق ا د ت
تفاضلن	ت ف ا ض ل ن
يطأ	ي ط أ
سمكية	س م ك ي ة
استهزئتم	ا س ت ه ز ئ ت م
سكباجة	س ك ب ا ج ة
تقسس	ت ق س س
ينزووا	ي ن ز و و ا
بعيثران	ب ع ي ث ر ا ن
يجتمعوا	ي ج ت م ع و ا
يمرشن	ي م ر ش ن
تستطاع	ت س ت ط ا ع
نتجدد	ن ت ج د د
متدينة	م ت د ي ن ة
ينبئون	ي ن ب ئ و ن
أرحام	أ ر ح ا م
إلكتروني	إ ل ك ت ر و ن ي
تجهلي	ت ج ه ل ي
تكحلين	ت ك ح ل ي ن
أستعيذ	أ س ت ع ي ذ
صادر	ص ا د ر
وصفتن	و ص ف ت ن
تتشاجرين	ت ت ش ا ج ر ي ن
اقلبوا	ا ق ل ب و ا
أعلنوا	أ ع ل ن و ا
لأك	ل أ ك
توفي	ت و ف ي
دملج	د م ل ج
استقامت	ا س ت ق ا م ت
تتخوفي	ت ت خ و ف ي
تتواضعون	ت ت و ا ض ع و ن
منقاش	م ن ق ا ش
يتدخلوا	ي ت د خ ل و ا
زوري	ز و ر ي
الزرقاء	ا ل ز ر ق ا ء
شربين	ش ر ب ي ن
أطفأتن	أ ط ف أ ت ن
يشوقوا	ي ش و ق و ا
تثورين	ت ث و ر ي ن
سفوف	س ف و ف
ألية	أ ل ي ة
يسوف	ي س و ف
مدع	م د ع
قرط	ق ر ط
نتعرق	ن ت ع ر ق
خصيب	خ ص ي ب
تنظري	ت ن ظ ر ي
عصفر	ع ص ف ر
تورية	ت و ر ي ة
نستند	ن س ت ن د
يتوه	ي ت و ه
أكربي	أ ك ر ب ي
أتراك	أ ت ر ا ك
تنهون	ت ن ه و ن
ترينين	ت ر ي ن ي ن
عراقي	ع ر ا ق ي
ناح	ن ا ح
سراويل	س ر ا و ي ل
ارحبوا	ا ر ح ب و ا
سووا	س و و ا
ذكران	ذ ك ر ا ن
هيلانة	ه ي ل ا ن ة
تقرنين	ت ق ر ن ي ن
تعلة	ت ع ل ة
حاققتن	ح ا ق ق ت ن
يستأمن	ي س ت أ م ن
مساهمة	م س ا ه م ة
تؤدب	ت ؤ د ب
اختلطتن	ا خ ت ل ط ت ن
يوءسن	ي و ء س ن
تهنئون	ت ه ن ئ و ن
تشاروا	ت ش ا ر و ا
مرونة	م ر و ن ة
سقلات	س ق ل ا ت
يصوبن	ي ص و ب ن
يتماثلوا	ي ت م ا ث ل و ا
غبوا	غ ب و ا
تدافع	ت د ا ف ع
تنشئون	ت ن ش ئ و ن
أرخوا	أ ر خ و ا
يسلط	ي س ل ط
سد	س د
تعبسن	ت ع ب س ن
تتكلمن	ت ت ك ل م ن
بوح	ب و ح
تكعب	ت ك ع ب
قطعن	ق ط ع ن
استيقاظ	ا س ت ي ق ا ظ
نهم	ن ه م
يخبرن	ي خ ب ر ن
ينسحبن	ي ن س ح ب ن
طلبة	ط ل ب ة
لعقة	ل ع ق ة
ذاقت	ذ ا ق ت
اشمأززن	ا ش م أ ز ز ن
تستعرضي	ت س ت ع ر ض ي
دبابير	د ب ا ب ي ر
تمتمن	ت م ت م ن
ساهر	س ا ه ر
تركتم	ت ر ك ت م
توث	ت و ث
تجرنثموا	ت ج ر ن ث م و ا
أنصفوا	أ ن ص ف و ا
مرجت	م ر ج ت
قائظ	ق ا ئ ظ
اسكتي	ا س ك ت ي
شعرتم	ش ع ر ت م
تحرفون	ت ح ر ف و ن
يصيحون	ي ص ي ح و ن
أكاديمي	أ ك ا د ي م ي
قصاب	ق ص ا ب
امرشوا	ا م ر ش و ا
تتهود	ت ت ه و د
ظبي	ظ ب ي
تدمرتم	ت د م ر ت م
بشيرة	ب ش ي ر ة
أهب	أ ه ب
ملاكمة	م ل ا ك م ة
مارسيل	م ا ر س ي ل
حلل	ح ل ل
كمية	ك م ي ة
قرروا	ق ر ر و ا
أصغوا	أ ص غ و ا
تكرمون	ت ك ر م و ن
سرنديب	س ر ن د ي ب
عوينات	ع و ي ن ا ت
تتولون	ت ت و ل و ن
صحبنا	ص ح ب ن ا
سنبوسة	س ن ب و س ة
تستأصلي	ت س ت أ ص ل ي
يحرب	ي ح ر ب
زرزور	ز ر ز و ر
نبيت	ن ب ي ت
يصابحون	ي ص ا ب ح و ن
ازوين	ا ز و ي ن
تمنيتم	ت م ن ي ت م
يستقطرون	ي س ت ق ط ر و ن
ياوندي	ي ا و ن د ي
نجاشي	ن ج ا ش ي
تتبدلوا	ت ت ب د ل و ا
تصيحون	ت ص ي ح و ن
دفأنا	د ف أ ن ا
تستديرين	ت س ت د ي ر ي ن
مرشنا	م ر ش ن ا
أغطي	أ غ ط ي
سياحة	س ي ا ح ة
يرتجى	ي ر ت ج ى
يوتروا	ي و ت ر و ا
دحرجن	د ح ر ج ن
يمتحنون	ي م ت ح ن و ن
تتباءس	ت ت ب ا ء س
تجيرون	ت ج ي ر و ن
يصربوا	ي ص ر ب و ا
مهور	م ه و ر
غررنا	غ ر ر ن ا
استنرتن	ا س ت ن ر ت ن
تسبيح	ت س ب ي ح
تزحمون	ت ز ح م و ن
أقيموا	أ ق ي م و ا
تتخمرون	ت ت خ م ر و ن
أسأمت	أ س أ م ت
جسرنا	ج س ر ن ا
حجرتم	ح ج ر ت م
انفعن	ا ن ف ع ن
استقطبتن	ا س ت ق ط ب ت ن
يخص	ي خ ص
ضخم	ض خ م
سورقتن	س و ر ق ت ن
تثقب	ت ث ق ب
يتحكمن	ي ت ح ك م ن
يتجاملن	ي ت ج ا م ل ن
منخلة	م ن خ ل ة
مشمئز	م ش م ئ ز
مقررون	م ق ر ر و ن
اضلعي	ا ض ل ع ي
خفضوا	خ ف ض و ا
تترددن	ت ت ر د د ن
أرت	أ ر ت
يبؤسن	ي ب ؤ س ن
أبتسم	أ ب ت س م
حفرت	ح ف ر ت
تلتمسون	ت ل ت م س و ن
يتزين	ي ت ز ي ن
تقمير	ت ق م ي ر
تستضيئين	ت س ت ض ي ئ ي ن
كاثوليكيات	ك ا ث و ل ي ك ي ا ت
نتنصت	ن ت ن ص ت
اشتجرتن	ا ش ت ج ر ت ن
كلوة	ك ل و ة
إفلاس	إ ف ل ا س
تذاع	ت ذ ا ع
مارستن	م ا ر س ت ن
تراقبي	ت ر ا ق ب ي
تبلد	ت ب ل د
مؤاجرة	م ؤ ا ج ر ة
تروي	ت ر و ي
نتجر	ن ت ج ر
خداج	خ د ا ج
يستوقفون	ي س ت و ق ف و ن
تملؤوا	ت م ل ؤ و ا
رقد	ر ق د
يضطرر	ي ض ط ر ر
شامس	ش ا م س
أيل	أ ي ل
تتسمين	ت ت س م ي ن
تعلمت	ت ع ل م ت
بولوا	ب و ل و ا
هجاء	ه ج ا ء
ماسست	م ا س س ت
ديمقراطي	د ي م ق ر ا ط ي
تدمون	ت د م و ن
سلي	س ل ي
أهملن	أ ه م ل ن
تصنفين	ت ص ن ف ي ن
تقربوا	ت ق ر ب و ا
باحثوا	ب ا ح ث و ا
باذرنجبوية	ب ا ذ ر ن ج ب و ي ة
كسوة	ك س و ة
تنقص	ت ن ق ص
يتفاضلن	ي ت ف ا ض ل ن
يصوم	ي ص و م
تتجنبي	ت ت ج ن ب ي
تقتلين	ت ق ت ل ي ن
نوقظ	ن و ق ظ
يستوفوا	ي س ت و ف و ا
تطلقوا	ت ط ل ق و ا
أسام	أ س ا م
تقتتلي	ت ق ت ت ل ي
التاث	ا ل ت ا ث
ممارس	م م ا ر س
تتكافئين	ت ت ك ا ف ئ ي ن
تجرتن	ت ج ر ت ن
منيع	م ن ي ع
عدمت	ع د م ت
تطفئن	ت ط ف ئ ن
أدينا	أ د ي ن ا
ون	و ن
لوقوا	ل و ق و ا
أنجزت	أ ن ج ز ت
تهملون	ت ه م ل و ن
يئستم	ي ئ س ت م
بقبق	ب ق ب ق
نحتنا	ن ح ت ن ا
אסם	א ס ם
خنصر	خ ن ص ر
جووروا	ج و و ر و ا
حطام	ح ط ا م
أهدفوا	أ ه د ف و ا
جبيل	ج ب ي ل
مخبول	م خ ب و ل
طوعت	ط و ع ت
سمونا	س م و ن ا
يدين	ي د ي ن
زبرجد	ز ب ر ج د
افرقي	ا ف ر ق ي
سوكنت	س و ك ن ت
تبوحث	ت ب و ح ث
تتأممون	ت ت أ م م و ن
يتهودوا	ي ت ه و د و ا
أنتيكخانة	أ ن ت ي ك خ ا ن ة
صنوف	ص ن و ف
تعمين	ت ع م ي ن
شربن	ش ر ب ن
تستأجر	ت س ت أ ج ر
ركضتم	ر ك ض ت م
ندل	ن د ل
كمام	ك م ا م
الأفغان	ا ل أ ف غ ا ن
يحاوطن	ي ح ا و ط ن
تسرة	ت س ر ة
تأجروا	ت أ ج ر و ا
تفجري	ت ف ج ر ي
تستلهمن	ت س ت ل ه م ن
اصربن	ا ص ر ب ن
خامرنا	خ ا م ر ن ا
نوفس	ن و ف س
بذل	ب ذ ل
تجتمعوا	ت ج ت م ع و ا
تحاسبتن	ت ح ا س ب ت ن
برلمانات	ب ر ل م ا ن ا ت
نشأوا	ن ش أ و ا
מצר	מ צ ר
عوقبن	ع و ق ب ن
تندون	ت ن د و ن
مرصد	م ر ص د
افتعلتن	ا ف ت ع ل ت ن
تبولوا	ت ب و ل و ا
نمش	ن م ش
تزبيد	ت ز ب ي د
مصاب	م ص ا ب
شلجم	ش ل ج م
موهبة	م و ه ب ة
إهليلج	إ ه ل ي ل ج
اجهدوا	ا ج ه د و ا
تزدانين	ت ز د ا ن ي ن
نصح	ن ص ح
بكرت	ب ك ر ت
تأصل	ت أ ص ل
تشهرون	ت ش ه ر و ن
تفلحي	ت ف ل ح ي
تليقون	ت ل ي ق و ن
قبرت	ق ب ر ت
ثمر	ث م ر
تتخشبوا	ت ت خ ش ب و ا
اقتضينا	ا ق ت ض ي ن ا
تعهدي	ت ع ه د ي
نشرب	ن ش ر ب
تتضايقوا	ت ت ض ا ي ق و ا
تكعبين	ت ك ع ب ي ن
مكتسب	م ك ت س ب
شاجرت	ش ا ج ر ت
سحتم	س ح ت م
يعددوا	ي ع د د و ا
طيار	ط ي ا ر
تنسية	ت ن س ي ة
نلام	ن ل ا م
حرقي	ح ر ق ي
تهبروا	ت ه ب ر و ا
يبرقع	ي ب ر ق ع
سووين	س و و ي ن
أرخن	أ ر خ ن
اربطي	ا ر ب ط ي
أشقاء	أ ش ق ا ء
زوجت	ز و ج ت
أوف	أ و ف
استعباد	ا س ت ع ب ا د
أولتن	أ و ل ت ن
ابحروا	ا ب ح ر و ا
اشمس	ا ش م س
ربوتم	ر ب و ت م
وفقوا	و ف ق و ا
استقروا	ا س ت ق ر و ا
أنعظتن	أ ن ع ظ ت ن
روفقن	ر و ف ق ن
استصباح	ا س ت ص ب ا ح
تدين	ت د ي ن
تتحادثن	ت ت ح ا د ث ن
أطبخ	أ ط ب خ
تصورون	ت ص و ر و ن
تجتهدوا	ت ج ت ه د و ا
إشفى	إ ش ف ى
نذع	ن ذ ع
يعربوا	ي ع ر ب و ا
إريتري	إ ر ي ت ر ي
تنافست	ت ن ا ف س ت
همزات	ه م ز ا ت
تتواضعوا	ت ت و ا ض ع و ا
مملوك	م م ل و ك
خصوصية	خ ص و ص ي ة
زغتن	ز غ ت ن
غرغرت	غ ر غ ر ت
أرهبنا	أ ر ه ب ن ا
اردفن	ا ر د ف ن
أوهام	أ و ه ا م
كتمتم	ك ت م ت م
تتواتروا	ت ت و ا ت ر و ا
يحادثن	ي ح ا د ث ن
اغوال	ا غ و ا ل
أطفأتم	أ ط ف أ ت م
باريوم	ب ا ر ي و م
جردة	ج ر د ة
تلوني	ت ل و ن ي
غيهب	غ ي ه ب
أومر	أ و م ر
نسبت	ن س ب ت
لكمة	ل ك م ة
قسموا	ق س م و ا
عبدن	ع ب د ن
نوسب	ن و س ب
شيوعي	ش ي و ع ي
دواخن	د و ا خ ن
تثقفي	ت ث ق ف ي
حرث	ح ر ث
يتنبؤوا	ي ت ن ب ؤ و ا
نعقد	ن ع ق د
أطلن	أ ط ل ن
بيدق	ب ي د ق
انخفض	ا ن خ ف ض
نزهة	ن ز ه ة
أماس	أ م ا س
علمنا	ع ل م ن ا
هبط	ه ب ط
أجلاد	أ ج ل ا د
تستأجري	ت س ت أ ج ر ي
أرشدتم	أ ر ش د ت م
أستن	أ س ت ن
نوفرنا	ن و ف ر ن ا
قارضن	ق ا ر ض ن
أحضرن	أ ح ض ر ن
تسحير	ت س ح ي ر
يوافي	ي و ا ف ي
ليلة	ل ي ل ة
زراوند	ز ر ا و ن د
أسأمتن	أ س أ م ت ن
يحمل	ي ح م ل
نتقطر	ن ت ق ط ر
تجبري	ت ج ب ر ي
نوراني	ن و ر ا ن ي
أحالوا	أ ح ا ل و ا
يحتشدون	ي ح ت ش د و ن
عجينة	ع ج ي ن ة
تملق	ت م ل ق
قبائلي	ق ب ا ئ ل ي
فرميون	ف ر م ي و ن
حني	ح ن ي
يحطوا	ي ح ط و ا
جاوزنا	ج ا و ز ن ا
يزغن	ي ز غ ن
متوالي	م ت و ا ل ي
اسعل	ا س ع ل
همة	ه م ة
يفاجئ	ي ف ا ج ئ
سعلوا	س ع ل و ا
تنكففن	ت ن ك ف ف ن
يتحشد	ي ت ح ش د
ندد	ن د د
سليكون	س ل ي ك و ن
مرينة	م ر ي ن ة
نشادر	ن ش ا د ر
تخاطبن	ت خ ا ط ب ن
تحببتم	ت ح ب ب ت م
يهنأ	ي ه ن أ
تثاءب	ت ث ا ء ب
يقتنعوا	ي ق ت ن ع و ا
باريس	ب ا ر ي س
تتمذهب	ت ت م ذ ه ب
سيران	س ي ر ا ن
صعبن	ص ع ب ن
نال	ن ا ل
شوجرنا	ش و ج ر ن ا
نف	ن ف
تزدهرين	ت ز د ه ر ي ن
محصوا	م ح ص و ا
هان	ه ا ن
عنكبوت	ع ن ك ب و ت
يرتجون	ي ر ت ج و ن
أنف	أ ن ف
تثمرن	ت ث م ر ن
تدرجن	ت د ر ج ن
جهزوا	ج ه ز و ا
يحبلوا	ي ح ب ل و ا
بوتينية	ب و ت ي ن ي ة
ثقلنا	ث ق ل ن ا
أمطر	أ م ط ر
أجملت	أ ج م ل ت
أموا	أ م و ا
حاموا	ح ا م و ا
مسفوح	م س ف و ح
يخمرون	ي خ م ر و ن
نوويتم	ن و و ي ت م
ايتممتم	ا ي ت م م ت م
مؤاخذ	م ؤ ا خ ذ
معاينة	م ع ا ي ن ة
تتفتحي	ت ت ف ت ح ي
تبلغين	ت ب ل غ ي ن
اورع	ا و ر ع
انتهوا	ا ن ت ه و ا
اسعلي	ا س ع ل ي
بطأن	ب ط أ ن
تصرفي	ت ص ر ف ي
كردي	ك ر د ي
ضؤن	ض ؤ ن
أشاوس	أ ش ا و س
يصادروا	ي ص ا د ر و ا
كلبنا	ك ل ب ن ا
قروا	ق ر و ا
يستحملن	ي س ت ح م ل ن
تحفوا	ت ح ف و ا
يزخرفون	ي ز خ ر ف و ن
مظلمة	م ظ ل م ة
جدراء	ج د ر ا ء
يخططن	ي خ ط ط ن
اعدلوا	ا ع د ل و ا
جنائني	ج ن ا ئ ن ي
نذهب	ن ذ ه ب
يموهوا	ي م و ه و ا
تخر	ت خ ر
تشربي	ت ش ر ب ي
تصارعي	ت ص ا ر ع ي
يغرمن	ي غ ر م ن
انفذوا	ا ن ف ذ و ا
طلتن	ط ل ت ن
تراييق	ت ر ا ي ي ق
تتبسمون	ت ت ب س م و ن
فالج	ف ا ل ج
باسيليوس	ب ا س ي ل ي و س
استجرت	ا س ت ج ر ت
يابس	ي ا ب س
استمررن	ا س ت م ر ر ن
تنكتبون	ت ن ك ت ب و ن
تستنبأن	ت س ت ن ب أ ن
استهجان	ا س ت ه ج ا ن
تقاعس	ت ق ا ع س
أتهود	أ ت ه و د
صبان	ص ب ا ن
خرشوف	خ ر ش و ف
حسدوا	ح س د و ا
تسوئي	ت س و ئ ي
ايتممتن	ا ي ت م م ت ن
تخضارون	ت خ ض ا ر و ن
دموا	د م و ا
تعاضد	ت ع ا ض د
يوقتون	ي و ق ت و ن
تتجنسون	ت ت ج ن س و ن
توضعون	ت و ض ع و ن
أستعد	أ س ت ع د
كأسات	ك أ س ا ت
يشرون	ي ش ر و ن
شوقت	ش و ق ت
تشخص	ت ش خ ص
ادري	ا د ر ي
مناهج	م ن ا ه ج
ارب	ا ر ب
أودى	أ و د ى
تقتل	ت ق ت ل
انفخن	ا ن ف خ ن
تسقطون	ت س ق ط و ن
سر	س ر
أقررنا	أ ق ر ر ن ا
لطاخ	ل ط ا خ
جزح	ج ز ح
تتطرفين	ت ت ط ر ف ي ن
نجاب	ن ج ا ب
كسوف	ك س و ف
صدفت	ص د ف ت
استعلمتم	ا س ت ع ل م ت م
مومسة	م و م س ة
استحسان	ا س ت ح س ا ن
خططتم	خ ط ط ت م
أتغدى	أ ت غ د ى
أثم	أ ث م
تستظهر	ت س ت ظ ه ر
تلافيف	ت ل ا ف ي ف
خرطموا	خ ر ط م و ا
أتدمر	أ ت د م ر
ازدحمن	ا ز د ح م ن
يتكأ	ي ت ك أ
ايمن	ا ي م ن
بثور	ب ث و ر
خذن	خ ذ ن
أجملنا	أ ج م ل ن ا
تخذلون	ت خ ذ ل و ن
أتلون	أ ت ل و ن
معصم	م ع ص م
تواطؤ	ت و ا ط ؤ
تنجي	ت ن ج ي
نهض	ن ه ض
حاوط	ح ا و ط
خرفة	خ ر ف ة
ينعقدون	ي ن ع ق د و ن
تعكسي	ت ع ك س ي
دفقتن	د ف ق ت ن
ترتعد	ت ر ت ع د
عزبن	ع ز ب ن
أطفح	أ ط ف ح
قبلتم	ق ب ل ت م
طلقن	ط ل ق ن
تجربة	ت ج ر ب ة
مشيمة	م ش ي م ة
دحوتن	د ح و ت ن
تسقون	ت س ق و ن
قورضن	ق و ر ض ن
إيليريا	إ ي ل ي ر ي ا
أرمل	أ ر م ل
تبركون	ت ب ر ك و ن
يتحكم	ي ت ح ك م
تحافظوا	ت ح ا ف ظ و ا
لحمات	ل ح م ا ت
نطارح	ن ط ا ر ح
اصربي	ا ص ر ب ي
لقبتن	ل ق ب ت ن
بديعي	ب د ي ع ي
افجري	ا ف ج ر ي
هادي	ه ا د ي
قطا	ق ط ا
أجناس	أ ج ن ا س
تشبحي	ت ش ب ح ي
تمي	ت م ي
رؤوف	ر ؤ و ف
أبهمي	أ ب ه م ي
تتكافؤون	ت ت ك ا ف ؤ و ن
نرجى	ن ر ج ى
طبت	ط ب ت
تهنئين	ت ه ن ئ ي ن
ياي	ي ا ي
أدبب	أ د ب ب
إنحال	إ ن ح ا ل
طباخون	ط ب ا خ و ن
تتذكرون	ت ت ذ ك ر و ن
أكلاف	أ ك ل ا ف
فاخرة	ف ا خ ر ة
ركعة	ر ك ع ة
انزوين	ا ن ز و ي ن
اضحك	ا ض ح ك
عمال	ع م ا ل
ثير	ث ي ر
صفوتن	ص ف و ت ن
أحاول	أ ح ا و ل
أطفأوا	أ ط ف أ و ا
إيطاليا	إ ي ط ا ل ي ا
آتمر	آ ت م ر
يحافظن	ي ح ا ف ظ ن
يبحثن	ي ب ح ث ن
أندى	أ ن د ى
خرور	خ ر و ر
حديدية	ح د ي د ي ة
تديني	ت د ي ن ي
أهدب	أ ه د ب
اركض	ا ر ك ض
نقول	ن ق و ل
سمير	س م ي ر
حللوا	ح ل ل و ا
دقاق	د ق ا ق
أنكص	أ ن ك ص
يتلاقون	ي ت ل ا ق و ن
سألت	س أ ل ت
هربتن	ه ر ب ت ن
بندقية	ب ن د ق ي ة
نفقط	ن ف ق ط
افرقوا	ا ف ر ق و ا
أنبأوا	أ ن ب أ و ا
تهمة	ت ه م ة
تتصبروا	ت ت ص ب ر و ا
أعبد	أ ع ب د
دغبوس	د غ ب و س
عشقتن	ع ش ق ت ن
عبرية	ع ب ر ي ة
نستمن	ن س ت م ن
أطربتن	أ ط ر ب ت ن
حججنا	ح ج ج ن ا
يمتثل	ي م ت ث ل
لغز	ل غ ز
يقتضب	ي ق ت ض ب
قضيت	ق ض ي ت
يتجبر	ي ت ج ب ر
تقذفون	ت ق ذ ف و ن
أقفلوا	أ ق ف ل و ا
روجعتن	ر و ج ع ت ن
تغديتم	ت غ د ي ت م
بركري	ب ر ك ر ي
تأسيس	ت أ س ي س
شنودة	ش ن و د ة
حيوات	ح ي و ا ت
بدلنا	ب د ل ن ا
استجني	ا س ت ج ن ي
يؤدى	ي ؤ د ى
سلكي	س ل ك ي
نسلط	ن س ل ط
إيليا	إ ي ل ي ا
راسن	ر ا س ن
إنس	إ ن س
اثنونين	ا ث ن و ن ي ن
تأبي	ت أ ب ي
تداولي	ت د ا و ل ي
لاقيت	ل ا ق ي ت
يحضن	ي ح ض ن
اقسسن	ا ق س س ن
مانتيكا	م ا ن ت ي ك ا
لاعبي	ل ا ع ب ي
ابتأستن	ا ب ت أ س ت ن
اشتركن	ا ش ت ر ك ن
اشتغلن	ا ش ت غ ل ن
غدر	غ د ر
خلطن	خ ل ط ن
حدن	ح د ن
تجبرتن	ت ج ب ر ت ن
ابلع	ا ب ل ع
حب	ح ب
سيسبان	س ي س ب ا ن
גׄיל	ג ׄ י ל
تكونتم	ت ك و ن ت م
إنجليزي	إ ن ج ل ي ز ي
اطمأنوا	ا ط م أ ن و ا
أنمنا	أ ن م ن ا
مادية	م ا د ي ة
تنعقدون	ت ن ع ق د و ن
يمضي	ي م ض ي
أشكلي	أ ش ك ل ي
طازة	ط ا ز ة
أضعن	أ ض ع ن
مستقبل	م س ت ق ب ل
أرأس	أ ر أ س
اسبقن	ا س ب ق ن
أيان	أ ي ا ن
تنكفف	ت ن ك ف ف
أتفاضل	أ ت ف ا ض ل
تنعظوا	ت ن ع ظ و ا
خليتن	خ ل ي ت ن
تستيقظون	ت س ت ي ق ظ و ن
تسمني	ت س م ن ي
أخاذ	أ خ ا ذ
زام	ز ا م
سبقنا	س ب ق ن ا
מחבה	מ ח ב ה
شكت	ش ك ت
أطلسي	أ ط ل س ي
حماق	ح م ا ق
تقفلن	ت ق ف ل ن
تقون	ت ق و ن
صنعنا	ص ن ع ن ا
يلتهم	ي ل ت ه م
طفوا	ط ف و ا
أفعال	أ ف ع ا ل
ࢽ	ࢽ
تواقعون	ت و ا ق ع و ن
تخلفين	ت خ ل ف ي ن
هجد	ه ج د
افتقرتم	ا ف ت ق ر ت م
يبع	ي ب ع
استقبحت	ا س ت ق ب ح ت
مغتسل	م غ ت س ل
يشطط	ي ش ط ط
نخلف	ن خ ل ف
أضفتن	أ ض ف ت ن
تسامع	ت س ا م ع
تحكموا	ت ح ك م و ا
خندروس	خ ن د ر و س
كبرن	ك ب ر ن
يعقمن	ي ع ق م ن
الحبش	ا ل ح ب ش
تنعمل	ت ن ع م ل
تصدرنا	ت ص د ر ن ا
اثأر	ا ث أ ر
إيرانيون	إ ي ر ا ن ي و ن
سويداء	س و ي د ا ء
تصنف	ت ص ن ف
اخضررنا	ا خ ض ر ر ن ا
تنكحون	ت ن ك ح و ن
شاهل	ش ا ه ل
وفيتن	و ف ي ت ن
أحيلي	أ ح ي ل ي
تقرضوا	ت ق ر ض و ا
تشفقون	ت ش ف ق و ن
تتأملي	ت ت أ م ل ي
استلمن	ا س ت ل م ن
نقرد	ن ق ر د
حصدتن	ح ص د ت ن
أكلب	أ ك ل ب
خوارزمية	خ و ا ر ز م ي ة
يقد	ي ق د
ماثل	م ا ث ل
حسين	ح س ي ن
تعكس	ت ع ك س
ايملي	ا ي م ل ي
ظللنا	ظ ل ل ن ا
قيعان	ق ي ع ا ن
مقتضب	م ق ت ض ب
ذهبيون	ذ ه ب ي و ن
براني	ب ر ا ن ي
ربان	ر ب ا ن
استائي	ا س ت ا ئ ي
أتهدف	أ ت ه د ف
طوعتن	ط و ع ت ن
تنضر	ت ن ض ر
يؤسس	ي ؤ س س
قدسوا	ق د س و ا
آلات	آ ل ا ت
ثنيت	ث ن ي ت
يتطارحوا	ي ت ط ا ر ح و ا
نباحث	ن ب ا ح ث
هدت	ه د ت
أنفع	أ ن ف ع
امضوا	ا م ض و ا
يبلاجون	ي ب ل ا ج و ن
توطئين	ت و ط ئ ي ن
تتخابروا	ت ت خ ا ب ر و ا
يستأ	ي س ت أ
احتاط	ا ح ت ا ط
غلام	غ ل ا م
ضيعتن	ض ي ع ت ن
اصطليتم	ا ص ط ل ي ت م
يتساءلوا	ي ت س ا ء ل و ا
تماهي	ت م ا ه ي
احشري	ا ح ش ر ي
تصيدي	ت ص ي د ي
أصغر	أ ص غ ر
يسوعي	ي س و ع ي
أثد	أ ث د
تصيحين	ت ص ي ح ي ن
قن	ق ن
يهلكوا	ي ه ل ك و ا
اشمئزوا	ا ش م ئ ز و ا
مسلون	م س ل و ن
تدخلي	ت د خ ل ي
انفردنا	ا ن ف ر د ن ا
تخمرنا	ت خ م ر ن ا
محوتن	م ح و ت ن
أغرى	أ غ ر ى
شغلي	ش غ ل ي
اغلقن	ا غ ل ق ن
وفوا	و ف و ا
يعرفون	ي ع ر ف و ن
تحوجي	ت ح و ج ي
سئلتن	س ئ ل ت ن
أسررنا	أ س ر ر ن ا
تنفخي	ت ن ف خ ي
يشاء	ي ش ا ء
تستمسك	ت س ت م س ك
أأل	أ أ ل
تباعوا	ت ب ا ع و ا
أذنتم	أ ذ ن ت م
بذ	ب ذ
بربرية	ب ر ب ر ي ة
أصدروا	أ ص د ر و ا
يسعى	ي س ع ى
توجد	ت و ج د
جيران	ج ي ر ا ن
وصفاء	و ص ف ا ء
تؤمل	ت ؤ م ل
تتقول	ت ت ق و ل
لحاء	ل ح ا ء
شخصية	ش خ ص ي ة
اقدد	ا ق د د
حنف	ح ن ف
ينعملوا	ي ن ع م ل و ا
كرباج	ك ر ب ا ج
اشتجرت	ا ش ت ج ر ت
تخشوشبون	ت خ ش و ش ب و ن
نرزق	ن ر ز ق
يدوى	ي د و ى
اكشفي	ا ك ش ف ي
تقتلون	ت ق ت ل و ن
امحق	ا م ح ق
غمة	غ م ة
تستأمنين	ت س ت أ م ن ي ن
تدرسي	ت د ر س ي
مازح	م ا ز ح
تجهدي	ت ج ه د ي
إلغاء	إ ل غ ا ء
تتبعتن	ت ت ب ع ت ن
أكرمتم	أ ك ر م ت م
ترأس	ت ر أ س
تتبعين	ت ت ب ع ي ن
مغفرة	م غ ف ر ة
يستلموا	ي س ت ل م و ا
تنجبرين	ت ن ج ب ر ي ن
جومل	ج و م ل
أبوح	أ ب و ح
توفقي	ت و ف ق ي
ظوهرن	ظ و ه ر ن
اشتري	ا ش ت ر ي
خوفت	خ و ف ت
عرج	ع ر ج
ثدياء	ث د ي ا ء
سراجة	س ر ا ج ة
فكروا	ف ك ر و ا
شايء	ش ا ي ء
يحرنفزوا	ي ح ر ن ف ز و ا
تشاءمت	ت ش ا ء م ت
أقاد	أ ق ا د
يمالون	ي م ا ل و ن
يعرق	ي ع ر ق
تحبر	ت ح ب ر
أزل	أ ز ل
قط	ق ط
تقعن	ت ق ع ن
ناقشت	ن ا ق ش ت
طورحن	ط و ر ح ن
تخروطي	ت خ ر و ط ي
ثقالة	ث ق ا ل ة
رصاف	ر ص ا ف
هدرج	ه د ر ج
انقلب	ا ن ق ل ب
ابنين	ا ب ن ي ن
صبرنا	ص ب ر ن ا
يصار	ي ص ا ر
أبصرت	أ ب ص ر ت
مسسنا	م س س ن ا
يموتوا	ي م و ت و ا
يتغد	ي ت غ د
اخترعتن	ا خ ت ر ع ت ن
كونا	ك و ن ا
أتقول	أ ت ق و ل
تجملتم	ت ج م ل ت م
هذرتن	ه ذ ر ت ن
تنتسبين	ت ن ت س ب ي ن
يوجهوا	ي و ج ه و ا
روحانيون	ر و ح ا ن ي و ن
ظلل	ظ ل ل
واقعتم	و ا ق ع ت م
تغلقون	ت غ ل ق و ن
تواعد	ت و ا ع د
تعاقبون	ت ع ا ق ب و ن
تؤصلن	ت ؤ ص ل ن
نذلعب	ن ذ ل ع ب
تجامعون	ت ج ا م ع و ن
تستقالوا	ت س ت ق ا ل و ا
تخامري	ت خ ا م ر ي
مساواة	م س ا و ا ة
تحتشد	ت ح ت ش د
جوزن	ج و ز ن
يوءسوا	ي و ء س و ا
أضفت	أ ض ف ت
أذكر	أ ذ ك ر
اكتحلت	ا ك ت ح ل ت
قسبرة	ق س ب ر ة
تعلقن	ت ع ل ق ن
نبطل	ن ب ط ل
يطاولون	ي ط ا و ل و ن
اشعلي	ا ش ع ل ي
تستعيذين	ت س ت ع ي ذ ي ن
اعور	ا ع و ر
زند	ز ن د
اتكئ	ا ت ك ئ
بدل	ب د ل
دفأت	د ف أ ت
اخسروا	ا خ س ر و ا
سري	س ر ي
ملكتن	م ل ك ت ن
تولد	ت و ل د
ترحمي	ت ر ح م ي
ادرسي	ا د ر س ي
نيتروجين	ن ي ت ر و ج ي ن
يشتجر	ي ش ت ج ر
لدن	ل د ن
صخيد	ص خ ي د
أوامر	أ و ا م ر
تدففين	ت د ف ف ي ن
التمستم	ا ل ت م س ت م
تفاجؤون	ت ف ا ج ؤ و ن
مخيط	م خ ي ط
تنحت	ت ن ح ت
تتشاءمن	ت ت ش ا ء م ن
يسعل	ي س ع ل
تجيبون	ت ج ي ب و ن
حقيق	ح ق ي ق
نعنع	ن ع ن ع
ترفي	ت ر ف ي
استمنينا	ا س ت م ن ي ن ا
انصرفنا	ا ن ص ر ف ن ا
غربن	غ ر ب ن
تسولين	ت س و ل ي ن
يغلي	ي غ ل ي
تضرغطين	ت ض ر غ ط ي ن
تنزه	ت ن ز ه
تتشجرن	ت ت ش ج ر ن
بوليفيا	ب و ل ي ف ي ا
جوبرن	ج و ب ر ن
تجنى	ت ج ن ى
فلق	ف ل ق
تمامة	ت م ا م ة
يبكروا	ي ب ك ر و ا
تجلعبي	ت ج ل ع ب ي
ينعظون	ي ن ع ظ و ن
يسرقن	ي س ر ق ن
أكالم	أ ك ا ل م
تستعددن	ت س ت ع د د ن
محاسبة	م ح ا س ب ة
يغطوا	ي غ ط و ا
تتسامع	ت ت س ا م ع
أحرف	أ ح ر ف
تجرت	ت ج ر ت
خنب	خ ن ب
يستنسرن	ي س ت ن س ر ن
رقصوا	ر ق ص و ا
يوقفوا	ي و ق ف و ا
أعطيتن	أ ع ط ي ت ن
مؤبد	م ؤ ب د
تعدوا	ت ع د و ا
نبات	ن ب ا ت
سقطتن	س ق ط ت ن
حامول	ح ا م و ل
استكثرن	ا س ت ك ث ر ن
استمعت	ا س ت م ع ت
نجسد	ن ج س د
ثقبن	ث ق ب ن
استثنيتم	ا س ت ث ن ي ت م
غزلان	غ ز ل ا ن
أجرنثم	أ ج ر ن ث م
يماه	ي م ا ه
يلدن	ي ل د ن
تهبطين	ت ه ب ط ي ن
يموجوا	ي م و ج و ا
تحويل	ت ح و ي ل
مطرتم	م ط ر ت م
منوي	م ن و ي
تحوطون	ت ح و ط و ن
يجلسوا	ي ج ل س و ا
أسول	أ س و ل
تسرعن	ت س ر ع ن
نؤامر	ن ؤ ا م ر
ثوم	ث و م
أحمارر	أ ح م ا ر ر
استقرئ	ا س ت ق ر ئ
مستديرة	م س ت د ي ر ة
تشكري	ت ش ك ر ي
ولدي	و ل د ي
أضأتن	أ ض أ ت ن
اطبعن	ا ط ب ع ن
ارعدي	ا ر ع د ي
تخفوا	ت خ ف و ا
تجاعوا	ت ج ا ع و ا
صبيحة	ص ب ي ح ة
فرجة	ف ر ج ة
يثيرون	ي ث ي ر و ن
صت	ص ت
مصي	م ص ي
غليتن	غ ل ي ت ن
أكياس	أ ك ي ا س
مكوث	م ك و ث
يهودون	ي ه و د و ن
بكوا	ب ك و ا
قوطعوا	ق و ط ع و ا
تحفرون	ت ح ف ر و ن
تنقرئين	ت ن ق ر ئ ي ن
ترهبون	ت ر ه ب و ن
مباركة	م ب ا ر ك ة
تتمذهبن	ت ت م ذ ه ب ن
روجعنا	ر و ج ع ن ا
تصابي	ت ص ا ب ي
يلاحظوا	ي ل ا ح ظ و ا
مطعم	م ط ع م
مسح	م س ح
انحملنا	ا ن ح م ل ن ا
ابتدؤوا	ا ب ت د ؤ و ا
اسندي	ا س ن د ي
أفطر	أ ف ط ر
ارفعوا	ا ر ف ع و ا
رادف	ر ا د ف
سألوا	س أ ل و ا
خولفوا	خ و ل ف و ا
تغنين	ت غ ن ي ن
تستقلي	ت س ت ق ل ي
ضوددنا	ض و د د ن ا
خطوة	خ ط و ة
نطيب	ن ط ي ب
أنيم	أ ن ي م
يشفق	ي ش ف ق
قددتن	ق د د ت ن
تفتحن	ت ف ت ح ن
حدأة	ح د أ ة
يرتفعوا	ي ر ت ف ع و ا
واقف	و ا ق ف
أستصبح	أ س ت ص ب ح
شمعنا	ش م ع ن ا
استرداد	ا س ت ر د ا د
نبسر	ن ب س ر
يدحوا	ي د ح و ا
رجح	ر ج ح
احرقوا	ا ح ر ق و ا
انشغلي	ا ن ش غ ل ي
جيز	ج ي ز
أتمم	أ ت م م
بطيخة	ب ط ي خ ة
تسالمون	ت س ا ل م و ن
تفهمن	ت ف ه م ن
اصفرار	ا ص ف ر ا ر
اخدشوا	ا خ د ش و ا
تطاوعين	ت ط ا و ع ي ن
أسلكت	أ س ل ك ت
صنفي	ص ن ف ي
امرني	ا م ر ن ي
اصطبرتن	ا ص ط ب ر ت ن
بائن	ب ا ئ ن
يرقبون	ي ر ق ب و ن
أهواء	أ ه و ا ء
ستيفن	س ت ي ف ن
انجبرتن	ا ن ج ب ر ت ن
نتبالد	ن ت ب ا ل د
تخبري	ت خ ب ر ي
أذهب	أ ذ ه ب
أمازيغي	أ م ا ز ي غ ي
ابتناء	ا ب ت ن ا ء
نتواقف	ن ت و ا ق ف
روفعتن	ر و ف ع ت ن
برتقانيون	ب ر ت ق ا ن ي و ن
تصعدي	ت ص ع د ي
أعكس	أ ع ك س
تتطاول	ت ت ط ا و ل
ممنهج	م م ن ه ج
الطهراني	ا ل ط ه ر ا ن ي
تؤوي	ت ؤ و ي
تحبون	ت ح ب و ن
عننتن	ع ن ن ت ن
استأني	ا س ت أ ن ي
دورق	د و ر ق
علاقات	ع ل ا ق ا ت
تعيدي	ت ع ي د ي
تناري	ت ن ا ر ي
تقتضوا	ت ق ت ض و ا
حقوا	ح ق و ا
سوررنا	س و ر ر ن ا
حكايات	ح ك ا ي ا ت
سندن	س ن د ن
يخبزوا	ي خ ب ز و ا
لومسن	ل و م س ن
زحلتم	ز ح ل ت م
إجاصة	إ ج ا ص ة
اللهم	ا ل ل ه م
حزنوا	ح ز ن و ا
اشكروا	ا ش ك ر و ا
تؤرخي	ت ؤ ر خ ي
أمحى	أ م ح ى
انظموا	ا ن ظ م و ا
أرحن	أ ر ح ن
يحنئوا	ي ح ن ئ و ا
شدياق	ش د ي ا ق
شرعي	ش ر ع ي
أبتدئ	أ ب ت د ئ
يقصرون	ي ق ص ر و ن
شبب	ش ب ب
تدمنون	ت د م ن و ن
رواصيل	ر و ا ص ي ل
وراشين	و ر ا ش ي ن
يكسرون	ي ك س ر و ن
اعمين	ا ع م ي ن
نطول	ن ط و ل
نواسير	ن و ا س ي ر
تقربين	ت ق ر ب ي ن
اقدمن	ا ق د م ن
بيفام	ب ي ف ا م
استكثرت	ا س ت ك ث ر ت
חכמה	ח כ מ ה
يتحادثوا	ي ت ح ا د ث و ا
أبقنا	أ ب ق ن ا
يختتنوا	ي خ ت ت ن و ا
ادعينا	ا د ع ي ن ا
أنجم	أ ن ج م
اجترام	ا ج ت ر ا م
شتوة	ش ت و ة
تتصلون	ت ت ص ل و ن
ابكري	ا ب ك ر ي
تعترفوا	ت ع ت ر ف و ا
حوجلة	ح و ج ل ة
انتوينا	ا ن ت و ي ن ا
يذنبوا	ي ذ ن ب و ا
ذاكرتم	ذ ا ك ر ت م
تساررين	ت س ا ر ر ي ن
تحتانية	ت ح ت ا ن ي ة
تفرقت	ت ف ر ق ت
زبون	ز ب و ن
أحوى	أ ح و ى
انسلي	ا ن س ل ي
مثيرون	م ث ي ر و ن
هال	ه ا ل
ذكرنا	ذ ك ر ن ا
مشجع	م ش ج ع
مصمم	م ص م م
ننفجر	ن ن ف ج ر
اكبري	ا ك ب ر ي
مريض	م ر ي ض
اغتلام	ا غ ت ل ا م
يظنوا	ي ظ ن و ا
تتزوجوا	ت ت ز و ج و ا
ايسرن	ا ي س ر ن
نبتسم	ن ب ت س م
عبست	ع ب س ت
نورع	ن و ر ع
أعطل	أ ع ط ل
إيتاء	إ ي ت ا ء
دفق	د ف ق
غليل	غ ل ي ل
استميت	ا س ت م ي ت
تعطري	ت ع ط ر ي
يتواضع	ي ت و ا ض ع
انزلي	ا ن ز ل ي
تحاولوا	ت ح ا و ل و ا
اكلبوا	ا ك ل ب و ا
احفلي	ا ح ف ل ي
سدم	س د م
يطأون	ي ط أ و ن
نحفل	ن ح ف ل
يؤاخذون	ي ؤ ا خ ذ و ن
يتماسك	ي ت م ا س ك
زدتم	ز د ت م
يونان	ي و ن ا ن
أحقاف	أ ح ق ا ف
يفروا	ي ف ر و ا
إكراه	إ ك ر ا ه
تستكتبوا	ت س ت ك ت ب و ا
يرتعدون	ي ر ت ع د و ن
فوذنج	ف و ذ ن ج
يجتهدوا	ي ج ت ه د و ا
أؤمل	أ ؤ م ل
تصرفوا	ت ص ر ف و ا
مضايق	م ض ا ي ق
باقية	ب ا ق ي ة
أزعر	أ ز ع ر
سيلينيوم	س ي ل ي ن ي و م
حفرنا	ح ف ر ن ا
تسائلين	ت س ا ئ ل ي ن
قطرت	ق ط ر ت
أتم	أ ت م
نتقابل	ن ت ق ا ب ل
المجر	ا ل م ج ر
تزردي	ت ز ر د ي
ضريم	ض ر ي م
تتثاءبين	ت ت ث ا ء ب ي ن
اقوين	ا ق و ي ن
كاثوليك	ك ا ث و ل ي ك
ارعد	ا ر ع د
أجلاء	أ ج ل ا ء
أنضب	أ ن ض ب
تتحاسبين	ت ت ح ا س ب ي ن
يشمئزوا	ي ش م ئ ز و ا
ثقلت	ث ق ل ت
تأخرتم	ت أ خ ر ت م
اسق	ا س ق
بلغتن	ب ل غ ت ن
سياحات	س ي ا ح ا ت
قرضوا	ق ر ض و ا
ننهى	ن ن ه ى
أرياح	أ ر ي ا ح
بيرو	ب ي ر و
صافية	ص ا ف ي ة
ألاق	أ ل ا ق
مرفق	م ر ف ق
سرخس	س ر خ س
مسطح	م س ط ح
ابتعن	ا ب ت ع ن
أقفاء	أ ق ف ا ء
تنتظموا	ت ن ت ظ م و ا
تتمثلوا	ت ت م ث ل و ا
قمرنا	ق م ر ن ا
تحاملنا	ت ح ا م ل ن ا
سرعى	س ر ع ى
إهانة	إ ه ا ن ة
يتكون	ي ت ك و ن
نجرح	ن ج ر ح
بابين	ب ا ب ي ن
ضوجع	ض و ج ع
أنصتي	أ ن ص ت ي
مداومة	م د ا و م ة
استحضري	ا س ت ح ض ر ي
تزحلق	ت ز ح ل ق
طفئوا	ط ف ئ و ا
تعدن	ت ع د ن
بهر	ب ه ر
يكور	ي ك و ر
سافرن	س ا ف ر ن
تريحون	ت ر ي ح و ن
ملأن	م ل أ ن
يفرشون	ي ف ر ش و ن
خطاف	خ ط ا ف
بؤسن	ب ؤ س ن
أخضلن	أ خ ض ل ن
يعتنى	ي ع ت ن ى
حوول	ح و و ل
بقم	ب ق م
بنفسجية	ب ن ف س ج ي ة
مسؤولة	م س ؤ و ل ة
ألمس	أ ل م س
آدمية	آ د م ي ة
نقصتن	ن ق ص ت ن
يماثلوا	ي م ا ث ل و ا
يسهلن	ي س ه ل ن
بطليوس	ب ط ل ي و س
يحتلم	ي ح ت ل م
وشوم	و ش و م
أخفيتم	أ خ ف ي ت م
اشكري	ا ش ك ر ي
تقريرية	ت ق ر ي ر ي ة
تفقر	ت ف ق ر
سرتن	س ر ت ن
غلوق	غ ل و ق
يقفلوا	ي ق ف ل و ا
تهلكن	ت ه ل ك ن
دروج	د ر و ج
أخضل	أ خ ض ل
رحموا	ر ح م و ا
يزووا	ي ز و و ا
تذوكروا	ت ذ و ك ر و ا
يبشر	ي ب ش ر
نقصن	ن ق ص ن
مهمون	م ه م و ن
اخبز	ا خ ب ز
تجزون	ت ج ز و ن
أفقرنا	أ ف ق ر ن ا
استسق	ا س ت س ق
احتجب	ا ح ت ج ب
طفل	ط ف ل
انفعالية	ا ن ف ع ا ل ي ة
بصروا	ب ص ر و ا
تشتهروا	ت ش ت ه ر و ا
نمذهب	ن م ذ ه ب
يبسطون	ي ب س ط و ن
يفقطون	ي ف ق ط و ن
استثنى	ا س ت ث ن ى
مخ	م خ
اقبرن	ا ق ب ر ن
ساءلتم	س ا ء ل ت م
يرززوا	ي ر ز ز و ا
نقاعة	ن ق ا ع ة
جانستم	ج ا ن س ت م
زهروا	ز ه ر و ا
تقبض	ت ق ب ض
وفرت	و ف ر ت
هصر	ه ص ر
وترت	و ت ر ت
يضوئوا	ي ض و ئ و ا
الاثنان	ا ل ا ث ن ا ن
ذهنيون	ذ ه ن ي و ن
أكاثر	أ ك ا ث ر
استمررنا	ا س ت م ر ر ن ا
نباع	ن ب ا ع
اقبلي	ا ق ب ل ي
كراز	ك ر ا ز
أدخنة	أ د خ ن ة
امطر	ا م ط ر
أفلام	أ ف ل ا م
يمم	ي م م
تدحرجين	ت د ح ر ج ي ن
تستمر	ت س ت م ر
كافور	ك ا ف و ر
أوتينا	أ و ت ي ن ا
مثلثة	م ث ل ث ة
تقشعرون	ت ق ش ع ر و ن
قايستن	ق ا ي س ت ن
تخرمصي	ت خ ر م ص ي
تتهربين	ت ت ه ر ب ي ن
مسعور	م س ع و ر
عبب	ع ب ب
تفهموا	ت ف ه م و ا
تساؤوا	ت س ا ؤ و ا
أجيروا	أ ج ي ر و ا
قددنا	ق د د ن ا
علييات	ع ل ي ي ا ت
جوعى	ج و ع ى
مثنون	م ث ن و ن
يجازون	ي ج ا ز و ن
انظمي	ا ن ظ م ي
يستقرئون	ي س ت ق ر ئ و ن
تنشطي	ت ن ش ط ي
تبطؤون	ت ب ط ؤ و ن
تسائون	ت س ا ئ و ن
تتلامسين	ت ت ل ا م س ي ن
احتراس	ا ح ت ر ا س
تؤملت	ت ؤ م ل ت
شقق	ش ق ق
مرهف	م ر ه ف
حوققوا	ح و ق ق و ا
تقابلي	ت ق ا ب ل ي
مزاج	م ز ا ج
ريثما	ر ي ث م ا
يمطر	ي م ط ر
يقصبون	ي ق ص ب و ن
يميت	ي م ي ت
أزد	أ ز د
يغلقوا	ي غ ل ق و ا
نلي	ن ل ي
أزرقان	أ ز ر ق ا ن
روسختج	ر و س خ ت ج
دواسة	د و ا س ة
تتواتري	ت ت و ا ت ر ي
نتجارر	ن ت ج ا ر ر
تنبأتن	ت ن ب أ ت ن
تتكاتبن	ت ت ك ا ت ب ن
أشجر	أ ش ج ر
اشتراء	ا ش ت ر ا ء
أشهدنا	أ ش ه د ن ا
يبطأوا	ي ب ط أ و ا
تفجرنا	ت ف ج ر ن ا
سحرتن	س ح ر ت ن
نتعاون	ن ت ع ا و ن
تساقوا	ت س ا ق و ا
إستوديو	إ س ت و د ي و
ناقور	ن ا ق و ر
تتدخلون	ت ت د خ ل و ن
اعشقوا	ا ع ش ق و ا
تاريخي	ت ا ر ي خ ي
يوقتوا	ي و ق ت و ا
يبيعون	ي ب ي ع و ن
زغن	ز غ ن
اتحدنا	ا ت ح د ن ا
صوماليون	ص و م ا ل ي و ن
ادللن	ا د ل ل ن
تنيمون	ت ن ي م و ن
باحثنا	ب ا ح ث ن ا
زخرفات	ز خ ر ف ا ت
ازددت	ا ز د د ت
تتقطرون	ت ت ق ط ر و ن
أعنن	أ ع ن ن
اخشوشن	ا خ ش و ش ن
تستنيروا	ت س ت ن ي ر و ا
مطحنة	م ط ح ن ة
ينكس	ي ن ك س
أشوق	أ ش و ق
استلموا	ا س ت ل م و ا
احدث	ا ح د ث
جبلنا	ج ب ل ن ا
ذئبة	ذ ئ ب ة
اجهرن	ا ج ه ر ن
يمارسوا	ي م ا ر س و ا
تديري	ت د ي ر ي
قورح	ق و ر ح
توكأ	ت و ك أ
تألو	ت أ ل و
تستديروا	ت س ت د ي ر و ا
فقه	ف ق ه
انزويتم	ا ن ز و ي ت م
يذاعون	ي ذ ا ع و ن
ارووا	ا ر و و ا
يتهتلرون	ي ت ه ت ل ر و ن
تسوف	ت س و ف
تناووا	ت ن ا و و ا
أخف	أ خ ف
عرفت	ع ر ف ت
تموجن	ت م و ج ن
تقبلين	ت ق ب ل ي ن
نبخ	ن ب خ
حكمتم	ح ك م ت م
ايمني	ا ي م ن ي
تقطعون	ت ق ط ع و ن
أنقل	أ ن ق ل
تخسروا	ت خ س ر و ا
جان	ج ا ن
تقشعررن	ت ق ش ع ر ر ن
تحاققن	ت ح ا ق ق ن
زحام	ز ح ا م
نحيل	ن ح ي ل
تفقدوا	ت ف ق د و ا
تنقلب	ت ن ق ل ب
أتكئ	أ ت ك ئ
تؤسرون	ت ؤ س ر و ن
موروني	م و ر و ن ي
تعشيقة	ت ع ش ي ق ة
تتجملن	ت ت ج م ل ن
يتحببن	ي ت ح ب ب ن
استكثرتن	ا س ت ك ث ر ت ن
تكالمن	ت ك ا ل م ن
يعدم	ي ع د م
يرجحنوا	ي ر ج ح ن و ا
أزوى	أ ز و ى
تشتجري	ت ش ت ج ر ي
ضاددتم	ض ا د د ت م
نتحرف	ن ت ح ر ف
ليمونة	ل ي م و ن ة
كبكب	ك ب ك ب
صلحوا	ص ل ح و ا
اقربن	ا ق ر ب ن
يحاموا	ي ح ا م و ا
مريحة	م ر ي ح ة
اشتططتن	ا ش ت ط ط ت ن
فقرتن	ف ق ر ت ن
رومي	ر و م ي
اقتتلن	ا ق ت ت ل ن
يستأجر	ي س ت أ ج ر
شرقراق	ش ر ق ر ا ق
فرش	ف ر ش
تكلفي	ت ك ل ف ي
ريتشارد	ر ي ت ش ا ر د
ضويقتن	ض و ي ق ت ن
إيذان	إ ي ذ ا ن
يؤذن	ي ؤ ذ ن
تكتربون	ت ك ت ر ب و ن
وهل	و ه ل
حراص	ح ر ا ص
قصب	ق ص ب
إقنيز	إ ق ن ي ز
نرف	ن ر ف
أباحث	أ ب ا ح ث
تتشاغلي	ت ت ش ا غ ل ي
تحنئين	ت ح ن ئ ي ن
شلالات	ش ل ا ل ا ت
ترافقون	ت ر ا ف ق و ن
اجمد	ا ج م د
تدومي	ت د و م ي
توفق	ت و ف ق
تتهتلري	ت ت ه ت ل ر ي
تطوعتن	ت ط و ع ت ن
اضطر	ا ض ط ر
استدفاء	ا س ت د ف ا ء
تستعربن	ت س ت ع ر ب ن
تضلعوا	ت ض ل ع و ا
تتعفنين	ت ت ع ف ن ي ن
يتحوط	ي ت ح و ط
يمشوا	ي م ش و ا
تحمى	ت ح م ى
يكسبن	ي ك س ب ن
تطاع	ت ط ا ع
أعشار	أ ع ش ا ر
اقتربن	ا ق ت ر ب ن
يبدؤوا	ي ب د ؤ و ا
نتحابب	ن ت ح ا ب ب
تتزلزلوا	ت ت ز ل ز ل و ا
محتقر	م ح ت ق ر
خصيتم	خ ص ي ت م
يهرب	ي ه ر ب
تنجبري	ت ن ج ب ر ي
استدرار	ا س ت د ر ا ر
اقدروا	ا ق د ر و ا
أمات	أ م ا ت
يأبق	ي أ ب ق
سرقين	س ر ق ي ن
تستعرفي	ت س ت ع ر ف ي
شركت	ش ر ك ت
امتلاك	ا م ت ل ا ك
أقمتن	أ ق م ت ن
ترببي	ت ر ب ب ي
تداني	ت د ا ن ي
تفتكرين	ت ف ت ك ر ي ن
نجي	ن ج ي
يسموا	ي س م و ا
يبك	ي ب ك
نمرج	ن م ر ج
أسرق	أ س ر ق
تماسكوا	ت م ا س ك و ا
تضلعين	ت ض ل ع ي ن
أشرفي	أ ش ر ف ي
ألحقتن	أ ل ح ق ت ن
تنفرون	ت ن ف ر و ن
بشكير	ب ش ك ي ر
بصقن	ب ص ق ن
أعنف	أ ع ن ف
حسي	ح س ي
استظهرت	ا س ت ظ ه ر ت
يضرغططن	ي ض ر غ ط ط ن
إدريس	إ د ر ي س
شريتم	ش ر ي ت م
تمدون	ت م د و ن
أجرؤ	أ ج ر ؤ
يتوقفون	ي ت و ق ف و ن
تشتطي	ت ش ت ط ي
خبرتن	خ ب ر ت ن
ضرس	ض ر س
رقاب	ر ق ا ب
تجبين	ت ج ب ي ن
حفيدة	ح ف ي د ة
يستقطب	ي س ت ق ط ب
استأنيتم	ا س ت أ ن ي ت م
جملن	ج م ل ن
شربنا	ش ر ب ن ا
صحبة	ص ح ب ة
تدفع	ت د ف ع
اشرب	ا ش ر ب
دبابة	د ب ا ب ة
ارتعدتن	ا ر ت ع د ت ن
نتنافر	ن ت ن ا ف ر
تشخيصي	ت ش خ ي ص ي
قايين	ق ا ي ي ن
أرنؤد	أ ر ن ؤ د
زعلانة	ز ع ل ا ن ة
إطفاء	إ ط ف ا ء
جووز	ج و و ز
انكففنا	ا ن ك ف ف ن ا
تزيغون	ت ز ي غ و ن
يتراددون	ي ت ر ا د د و ن
تقلقي	ت ق ل ق ي
توقعون	ت و ق ع و ن
تمشون	ت م ش و ن
صدغ	ص د غ
أقف	أ ق ف
كرسي	ك ر س ي
تغلبي	ت غ ل ب ي
تشيطين	ت ش ي ط ي ن
قحط	ق ح ط
ندن	ن د ن
تدبروا	ت د ب ر و ا
تطلعين	ت ط ل ع ي ن
نتكحل	ن ت ك ح ل
اخمر	ا خ م ر
أسفنيك	أ س ف ن ي ك
أثبط	أ ث ب ط
يستظهرون	ي س ت ظ ه ر و ن
ناوين	ن ا و ي ن
قومرنا	ق و م ر ن ا
لاهوتي	ل ا ه و ت ي
تفتحون	ت ف ت ح و ن
يزدوجون	ي ز د و ج و ن
مكثن	م ك ث ن
تفتتحين	ت ف ت ت ح ي ن
جومعنا	ج و م ع ن ا
تزخرفتم	ت ز خ ر ف ت م
كربتم	ك ر ب ت م
تقدمين	ت ق د م ي ن
انتجب	ا ن ت ج ب
قطنتن	ق ط ن ت ن
أسندوا	أ س ن د و ا
كربوا	ك ر ب و ا
يستندن	ي س ت ن د ن
اغلي	ا غ ل ي
عذبتن	ع ذ ب ت ن
تنطفئي	ت ن ط ف ئ ي
لانثانوم	ل ا ن ث ا ن و م
كعبات	ك ع ب ا ت
تنشئن	ت ن ش ئ ن
اوهلن	ا و ه ل ن
تسوقتن	ت س و ق ت ن
ندعم	ن د ع م
يثارون	ي ث ا ر و ن
تستشهدين	ت س ت ش ه د ي ن
تبكرين	ت ب ك ر ي ن
انفعلتن	ا ن ف ع ل ت ن
ووليت	و و ل ي ت
تتلونين	ت ت ل و ن ي ن
برانس	ب ر ا ن س
نسول	ن س و ل
اغررن	ا غ ر ر ن
تهجر	ت ه ج ر
بكي	ب ك ي
حاول	ح ا و ل
أموج	أ م و ج
نجدي	ن ج د ي
تسحروا	ت س ح ر و ا
موضوعيون	م و ض و ع ي و ن
قدمان	ق د م ا ن
ملائكيون	م ل ا ئ ك ي و ن
اظلم	ا ظ ل م
يمتلكوا	ي م ت ل ك و ا
حفلت	ح ف ل ت
يكفى	ي ك ف ى
مغمى	م غ م ى
موسستم	م و س س ت م
يستولوا	ي س ت و ل و ا
مذ	م ذ
تتوترين	ت ت و ت ر ي ن
صورعن	ص و ر ع ن
محامون	م ح ا م و ن
تديرون	ت د ي ر و ن
شوهاء	ش و ه ا ء
نتزخرف	ن ت ز خ ر ف
رأسوا	ر أ س و ا
ی	ی
دامت	د ا م ت
يوسوسن	ي و س و س ن
حوفظنا	ح و ف ظ ن ا
يكتربون	ي ك ت ر ب و ن
أغلط	أ غ ل ط
تثرثروا	ت ث ر ث ر و ا
مطرة	م ط ر ة
توسمين	ت و س م ي ن
تمكثين	ت م ك ث ي ن
نونبر	ن و ن ب ر
قاتلوا	ق ا ت ل و ا
تتفارقوا	ت ت ف ا ر ق و ا
زاف	ز ا ف
رغيفة	ر غ ي ف ة
ثورات	ث و ر ا ت
اعلقن	ا ع ل ق ن
يتكلمن	ي ت ك ل م ن
يجزوا	ي ج ز و ا
استلقي	ا س ت ل ق ي
تدمموا	ت د م م و ا
أستجر	أ س ت ج ر
مستثنى	م س ت ث ن ى
تتجمع	ت ت ج م ع
يكذبوا	ي ك ذ ب و ا
تتأزم	ت ت أ ز م
باري	ب ا ر ي
ننمو	ن ن م و
أخذ	أ خ ذ
يفرجون	ي ف ر ج و ن
نتبلد	ن ت ب ل د
نشترى	ن ش ت ر ى
أصغ	أ ص غ
تختمر	ت خ ت م ر
افتكر	ا ف ت ك ر
طيفورية	ط ي ف و ر ي ة
يخروطن	ي خ ر و ط ن
يستقال	ي س ت ق ا ل
تحفون	ت ح ف و ن
تباءست	ت ب ا ء س ت
وزة	و ز ة
استمع	ا س ت م ع
موازين	م و ا ز ي ن
تتزيني	ت ت ز ي ن ي
تبر	ت ب ر
بالون	ب ا ل و ن
أتضوأ	أ ت ض و أ
صمن	ص م ن
تتحسني	ت ت ح س ن ي
تهبرن	ت ه ب ر ن
يتدمرون	ي ت د م ر و ن
انتهينا	ا ن ت ه ي ن ا
تشرحوا	ت ش ر ح و ا
كسري	ك س ر ي
شبينة	ش ب ي ن ة
كنارة	ك ن ا ر ة
طويل	ط و ي ل
يتعامل	ي ت ع ا م ل
شجاعة	ش ج ا ع ة
فلك	ف ل ك
أبنى	أ ب ن ى
تسررون	ت س ر ر و ن
خلاعي	خ ل ا ع ي
يتراجع	ي ت ر ا ج ع
تقدري	ت ق د ر ي
يحج	ي ح ج
طباق	ط ب ا ق
تلفنتم	ت ل ف ن ت م
ودوع	و د و ع
اعن	ا ع ن
اندون	ا ن د و ن
زيوت	ز ي و ت
مزية	م ز ي ة
بلغاري	ب ل غ ا ر ي
يتغرغر	ي ت غ ر غ ر
تتسامعين	ت ت س ا م ع ي ن
سدس	س د س
ابتسار	ا ب ت س ا ر
تذوكرت	ت ذ و ك ر ت
تتضوأن	ت ت ض و أ ن
تسعدوا	ت س ع د و ا
ترثعنوا	ت ر ث ع ن و ا
تبدوا	ت ب د و ا
تستنسري	ت س ت ن س ر ي
تبحث	ت ب ح ث
اسعوا	ا س ع و ا
ينطرحوا	ي ن ط ر ح و ا
اكتحلي	ا ك ت ح ل ي
تزعمون	ت ز ع م و ن
يتأكلوا	ي ت أ ك ل و ا
يركض	ي ر ك ض
نبيون	ن ب ي و ن
خارجيون	خ ا ر ج ي و ن
يطلقون	ي ط ل ق و ن
نقدية	ن ق د ي ة
سني	س ن ي
حرقن	ح ر ق ن
زبيبة	ز ب ي ب ة
شاهدن	ش ا ه د ن
تزبرين	ت ز ب ر ي ن
خصب	خ ص ب
ناولتم	ن ا و ل ت م
أبس	أ ب س
يضلعون	ي ض ل ع و ن
تتزخرفن	ت ت ز خ ر ف ن
فخام	ف خ ا م
تفتقروا	ت ف ت ق ر و ا
اثنت	ا ث ن ت
خلاصة	خ ل ا ص ة
أتوكل	أ ت و ك ل
يكهربوا	ي ك ه ر ب و ا
أثنى	أ ث ن ى
يقظت	ي ق ظ ت
يجع	ي ج ع
يزدوج	ي ز د و ج
تعشين	ت ع ش ي ن
ورعنا	و ر ع ن ا
عمه	ع م ه
غنيتن	غ ن ي ت ن
يتشاركن	ي ت ش ا ر ك ن
دستوريون	د س ت و ر ي و ن
بدأنا	ب د أ ن ا
سخطنا	س خ ط ن ا
قرفصاء	ق ر ف ص ا ء
خرق	خ ر ق
نلف	ن ل ف
افردوا	ا ف ر د و ا
سيقت	س ي ق ت
اخلقن	ا خ ل ق ن
أتعمد	أ ت ع م د
أصرخ	أ ص ر خ
اضطربي	ا ض ط ر ب ي
اعدمي	ا ع د م ي
نتحادث	ن ت ح ا د ث
سرروا	س ر ر و ا
تقدمن	ت ق د م ن
دمغ	د م غ
فجرتم	ف ج ر ت م
تعترفن	ت ع ت ر ف ن
جناب	ج ن ا ب
رتب	ر ت ب
صتأ	ص ت أ
تتعاوني	ت ت ع ا و ن ي
تمصر	ت م ص ر
استهزأتم	ا س ت ه ز أ ت م
تتمثلين	ت ت م ث ل ي ن
إنجليز	إ ن ج ل ي ز
عرف	ع ر ف
سلماء	س ل م ا ء
حرية	ح ر ي ة
تبصري	ت ب ص ر ي
نجب	ن ج ب
اخرجوا	ا خ ر ج و ا
قلقنا	ق ل ق ن ا
أتقنتن	أ ت ق ن ت ن
صعقوا	ص ع ق و ا
تقص	ت ق ص
تداور	ت د ا و ر
يخمر	ي خ م ر
يجبن	ي ج ب ن
عجيلة	ع ج ي ل ة
التفتوا	ا ل ت ف ت و ا
وغد	و غ د
تستلهم	ت س ت ل ه م
يحوطون	ي ح و ط و ن
نألو	ن أ ل و
أعفو	أ ع ف و
تضربن	ت ض ر ب ن
تحمرين	ت ح م ر ي ن
دراجة	د ر ا ج ة
تتضخم	ت ت ض خ م
تذنبي	ت ذ ن ب ي
قوومنا	ق و و م ن ا
قدرن	ق د ر ن
قومن	ق و م ن
رففنا	ر ف ف ن ا
يحربون	ي ح ر ب و ن
نتحو	ن ت ح و
فتكر	ف ت ك ر
تخبرين	ت خ ب ر ي ن
تتهودون	ت ت ه و د و ن
اقتططت	ا ق ت ط ط ت
تألل	ت أ ل ل
تتخابر	ت ت خ ا ب ر
تغطية	ت غ ط ي ة
يجلعببن	ي ج ل ع ب ب ن
يجهرون	ي ج ه ر و ن
تكرب	ت ك ر ب
تسهلي	ت س ه ل ي
عملتن	ع م ل ت ن
ازدردي	ا ز د ر د ي
يسعدون	ي س ع د و ن
نتخبر	ن ت خ ب ر
تغلبوا	ت غ ل ب و ا
زئير	ز ئ ي ر
تطفون	ت ط ف و ن
استأصلي	ا س ت أ ص ل ي
أصيح	أ ص ي ح
تأصيل	ت أ ص ي ل
جببنا	ج ب ب ن ا
سندس	س ن د س
تخلل	ت خ ل ل
مزدحمون	م ز د ح م و ن
اشمسوا	ا ش م س و ا
أوتروا	أ و ت ر و ا
تنبسطين	ت ن ب س ط ي ن
وقيت	و ق ي ت
شرعية	ش ر ع ي ة
صوبتن	ص و ب ت ن
قايسن	ق ا ي س ن
تتفاعلن	ت ت ف ا ع ل ن
رغائف	ر غ ا ئ ف
أغسل	أ غ س ل
تزوجتم	ت ز و ج ت م
اسعد	ا س ع د
تتحشدين	ت ت ح ش د ي ن
عثي	ع ث ي
تمدد	ت م د د
خطمتن	خ ط م ت ن
تصفرون	ت ص ف ر و ن
محلة	م ح ل ة
نوف	ن و ف
ارهبن	ا ر ه ب ن
تتجنب	ت ت ج ن ب
دفعتم	د ف ع ت م
يستطيعوا	ي س ت ط ي ع و ا
ترعين	ت ر ع ي ن
حططنا	ح ط ط ن ا
آتشيوت	آ ت ش ي و ت
يقسوا	ي ق س و ا
بحرت	ب ح ر ت
باحت	ب ا ح ت
تقولتن	ت ق و ل ت ن
يجمدوا	ي ج م د و ا
تضيفوا	ت ض ي ف و ا
تشمسي	ت ش م س ي
تلهمتم	ت ل ه م ت م
نفن	ن ف ن
أجهر	أ ج ه ر
صدمات	ص د م ا ت
جوبرت	ج و ب ر ت
يعيروا	ي ع ي ر و ا
تترادوا	ت ت ر ا د و ا
يلتبنون	ي ل ت ب ن و ن
ساط	س ا ط
كابوس	ك ا ب و س
أصفرنا	أ ص ف ر ن ا
تخوشين	ت خ و ش ي ن
يرسموا	ي ر س م و ا
تزهرون	ت ز ه ر و ن
شع	ش ع
جريمة	ج ر ي م ة
يأصلن	ي أ ص ل ن
ارتجيت	ا ر ت ج ي ت
تلفي	ت ل ف ي
مصصنا	م ص ص ن ا
أحج	أ ح ج
أتبادل	أ ت ب ا د ل
إفراغ	إ ف ر ا غ
طاه	ط ا ه
تعلوا	ت ع ل و ا
فرصاد	ف ر ص ا د
ليزر	ل ي ز ر
تجاهلوا	ت ج ا ه ل و ا
قهقهي	ق ه ق ه ي
تحرري	ت ح ر ر ي
تفلق	ت ف ل ق
ارتحنا	ا ر ت ح ن ا
وفد	و ف د
أجبرن	أ ج ب ر ن
بخير	ب خ ي ر
تمثلوا	ت م ث ل و ا
أرومية	أ ر و م ي ة
تتزينين	ت ت ز ي ن ي ن
سطام	س ط ا م
أصغرن	أ ص غ ر ن
تمدين	ت م د ي ن
وقى	و ق ى
بكينا	ب ك ي ن ا
تستكتبون	ت س ت ك ت ب و ن
ثمانية	ث م ا ن ي ة
يتحفظ	ي ت ح ف ظ
ستنبر	س ت ن ب ر
ماهة	م ا ه ة
يستطلن	ي س ت ط ل ن
خاطئة	خ ا ط ئ ة
أتعبتن	أ ت ع ب ت ن
هببتن	ه ب ب ت ن
توقفتن	ت و ق ف ت ن
ارشدن	ا ر ش د ن
تتشاءمين	ت ت ش ا ء م ي ن
وجهن	و ج ه ن
إمارة	إ م ا ر ة
تتباءسي	ت ت ب ا ء س ي
نؤت	ن ؤ ت
تتلو	ت ت ل و
مشراط	م ش ر ا ط
تسقى	ت س ق ى
أحسي	أ ح س ي
أولنا	أ و ل ن ا
تترفعن	ت ت ر ف ع ن
غربال	غ ر ب ا ل
اعوروا	ا ع و ر و ا
أخلى	أ خ ل ى
تنجوا	ت ن ج و ا
تسليك	ت س ل ي ك
تتأممين	ت ت أ م م ي ن
تظهري	ت ظ ه ر ي
تهينوا	ت ه ي ن و ا
ثلاثمئة	ث ل ا ث م ئ ة
عطلة	ع ط ل ة
يزوجن	ي ز و ج ن
صرختم	ص ر خ ت م
وقيتن	و ق ي ت ن
يجامعن	ي ج ا م ع ن
تحدودبون	ت ح د و د ب و ن
استحممنا	ا س ت ح م م ن ا
أحببت	أ ح ب ب ت
تتعارفوا	ت ت ع ا ر ف و ا
תסביח	ת ס ב י ח
دورت	د و ر ت
ۛ	ۛ
ترتب	ت ر ت ب
ثبطوا	ث ب ط و ا
ازرقاق	ا ز ر ق ا ق
كريم	ك ر ي م
توزنون	ت و ز ن و ن
أرزز	أ ر ز ز
يمجدوا	ي م ج د و ا
تفصيلات	ت ف ص ي ل ا ت
تصف	ت ص ف
حمام	ح م ا م
طحلب	ط ح ل ب
يأملوا	ي أ م ل و ا
درينا	د ر ي ن ا
رقصت	ر ق ص ت
أعيري	أ ع ي ر ي
رجب	ر ج ب
حمزة	ح م ز ة
حديديون	ح د ي د ي و ن
برنس	ب ر ن س
برعم	ب ر ع م
مؤقتة	م ؤ ق ت ة
تحبلوا	ت ح ب ل و ا
طيهوج	ط ي ه و ج
استقطبن	ا س ت ق ط ب ن
خندق	خ ن د ق
نيسان	ن ي س ا ن
معتل	م ع ت ل
أخبرتن	أ خ ب ر ت ن
تحاسبون	ت ح ا س ب و ن
يحتاطون	ي ح ت ا ط و ن
يستديروا	ي س ت د ي ر و ا
افتتحوا	ا ف ت ت ح و ا
قاطعي	ق ا ط ع ي
تعامى	ت ع ا م ى
صلينا	ص ل ي ن ا
فاعلة	ف ا ع ل ة
تجهزن	ت ج ه ز ن
ابتأست	ا ب ت أ س ت
يتوال	ي ت و ا ل
تشركون	ت ش ر ك و ن
يستكشفن	ي س ت ك ش ف ن
يهبطون	ي ه ب ط و ن
ماثلن	م ا ث ل ن
خومر	خ و م ر
تذهبين	ت ذ ه ب ي ن
زردخانة	ز ر د خ ا ن ة
شبحت	ش ب ح ت
سداة	س د ا ة
توقظوا	ت و ق ظ و ا
قذة	ق ذ ة
اختزل	ا خ ت ز ل
تحددن	ت ح د د ن
ناهز	ن ا ه ز
س	س
جلاب	ج ل ا ب
ترقدن	ت ر ق د ن
صحراوات	ص ح ر ا و ا ت
شكلتم	ش ك ل ت م
ذررن	ذ ر ر ن
ينفصلن	ي ن ف ص ل ن
يلتهموا	ي ل ت ه م و ا
بحرتن	ب ح ر ت ن
يتوحدن	ي ت و ح د ن
مغبة	م غ ب ة
وصل	و ص ل
صددن	ص د د ن
تعتادوا	ت ع ت ا د و ا
تقسم	ت ق س م
يطفقن	ي ط ف ق ن
تبرجون	ت ب ر ج و ن
معجزة	م ع ج ز ة
نوقى	ن و ق ى
اقتصادي	ا ق ت ص ا د ي
تناد	ت ن ا د
تؤخذون	ت ؤ خ ذ و ن
يكبسوا	ي ك ب س و ا
رضة	ر ض ة
تحاببوا	ت ح ا ب ب و ا
تهلكة	ت ه ل ك ة
قراع	ق ر ا ع
خفضنا	خ ف ض ن ا
تحرنشفون	ت ح ر ن ش ف و ن
اوجهوا	ا و ج ه و ا
أقوياء	أ ق و ي ا ء
أخضوضر	أ خ ض و ض ر
نحتسب	ن ح ت س ب
تجولتن	ت ج و ل ت ن
سارقوا	س ا ر ق و ا
أرضون	أ ر ض و ن
ثقبة	ث ق ب ة
قمرتم	ق م ر ت م
يصررن	ي ص ر ر ن
انبسطتم	ا ن ب س ط ت م
أباجور	أ ب ا ج و ر
ينقضين	ي ن ق ض ي ن
يحتطن	ي ح ت ط ن
يرتبكون	ي ر ت ب ك و ن
تجاوزون	ت ج ا و ز و ن
يموم	ي م و م
يحتشدوا	ي ح ت ش د و ا
بشروش	ب ش ر و ش
شبيه	ش ب ي ه
تسالم	ت س ا ل م
نجدة	ن ج د ة
تصعيب	ت ص ع ي ب
شين	ش ي ن
تتواجد	ت ت و ا ج د
مسمر	م س م ر
تستقطبوا	ت س ت ق ط ب و ا
استشهدنا	ا س ت ش ه د ن ا
فوضوية	ف و ض و ي ة
تستعدون	ت س ت ع د و ن
كاهل	ك ا ه ل
تنقرضن	ت ن ق ر ض ن
تتقطروا	ت ت ق ط ر و ا
زكوات	ز ك و ا ت
تهرب	ت ه ر ب
تحيطوا	ت ح ي ط و ا
بيرة	ب ي ر ة
حاولتم	ح ا و ل ت م
أصدرن	أ ص د ر ن
استنبأتن	ا س ت ن ب أ ت ن
يسلنطعون	ي س ل ن ط ع و ن
يدويون	ي د و ي و ن
داية	د ا ي ة
اعطسن	ا ع ط س ن
يتكبروا	ي ت ك ب ر و ا
تسلقت	ت س ل ق ت
يدفئ	ي د ف ئ
تثقيب	ت ث ق ي ب
سرعنا	س ر ع ن ا
لائكي	ل ا ئ ك ي
فرنب	ف ر ن ب
استيقاف	ا س ت ي ق ا ف
نوفق	ن و ف ق
تطاوعوا	ت ط ا و ع و ا
ليبي	ل ي ب ي
تجرئين	ت ج ر ئ ي ن
تخضعون	ت خ ض ع و ن
يمنعن	ي م ن ع ن
هول	ه و ل
تشيط	ت ش ي ط
كوثرنا	ك و ث ر ن ا
يستقيل	ي س ت ق ي ل
يعنين	ي ع ن ي ن
روجع	ر و ج ع
آجرتن	آ ج ر ت ن
توعدي	ت و ع د ي
يحملن	ي ح م ل ن
خلي	خ ل ي
أصليتن	أ ص ل ي ت ن
تصدقون	ت ص د ق و ن
أنتصر	أ ن ت ص ر
تدوم	ت د و م
أيداهو	أ ي د ا ه و
مبكر	م ب ك ر
حسبتن	ح س ب ت ن
تتقامرن	ت ت ق ا م ر ن
يغنوا	ي غ ن و ا
ساو	س ا و
مرقاق	م ر ق ا ق
تأقلم	ت أ ق ل م
اظنن	ا ظ ن ن
نتصدر	ن ت ص د ر
مددن	م د د ن
استعددنا	ا س ت ع د د ن ا
يتعارف	ي ت ع ا ر ف
ينيموا	ي ن ي م و ا
تتراددون	ت ت ر ا د د و ن
مماس	م م ا س
ترفعي	ت ر ف ع ي
يميلوا	ي م ي ل و ا
تدخيل	ت د خ ي ل
إندونيسي	إ ن د و ن ي س ي
رجفة	ر ج ف ة
سلميون	س ل م ي و ن
تباركي	ت ب ا ر ك ي
تستتابين	ت س ت ت ا ب ي ن
أسالم	أ س ا ل م
مماثلة	م م ا ث ل ة
تستحقوا	ت س ت ح ق و ا
تتماثلي	ت ت م ا ث ل ي
واقعة	و ا ق ع ة
مشكل	م ش ك ل
تدفين	ت د ف ي ن
جمجمة	ج م ج م ة
تتقامرين	ت ت ق ا م ر ي ن
نادلة	ن ا د ل ة
تحببن	ت ح ب ب ن
ينار	ي ن ا ر
يطرب	ي ط ر ب
تسنى	ت س ن ى
تتشرفي	ت ت ش ر ف ي
تستقطر	ت س ت ق ط ر
شيطتم	ش ي ط ت م
تثار	ت ث ا ر
نعبر	ن ع ب ر
تكملوا	ت ك م ل و ا
يرضون	ي ر ض و ن
امتلكتم	ا م ت ل ك ت م
أسخطتن	أ س خ ط ت ن
اكفرن	ا ك ف ر ن
يموج	ي م و ج
تمسكين	ت م س ك ي ن
طواجن	ط و ا ج ن
يغلمون	ي غ ل م و ن
ثامن	ث ا م ن
عدوة	ع د و ة
ينيكوا	ي ن ي ك و ا
لاغب	ل ا غ ب
مرتبكون	م ر ت ب ك و ن
نفعل	ن ف ع ل
خطا	خ ط ا
تنفذوا	ت ن ف ذ و ا
يكافأن	ي ك ا ف أ ن
يصغى	ي ص غ ى
ننشر	ن ن ش ر
هدوء	ه د و ء
ترافعون	ت ر ا ف ع و ن
مجالسة	م ج ا ل س ة
يستجنون	ي س ت ج ن و ن
يرخوا	ي ر خ و ا
اخفضي	ا خ ف ض ي
تدبون	ت د ب و ن
اجروا	ا ج ر و ا
قود	ق و د
سميتن	س م ي ت ن
عطسن	ع ط س ن
احدودبوا	ا ح د و د ب و ا
أسندن	أ س ن د ن
سويت	س و ي ت
تشوق	ت ش و ق
قطعنا	ق ط ع ن ا
ابلدي	ا ب ل د ي
اظلمي	ا ظ ل م ي
ووقعوا	و و ق ع و ا
بيتت	ب ي ت ت
شورك	ش و ر ك
ترفض	ت ر ف ض
شركتن	ش ر ك ت ن
يفطرون	ي ف ط ر و ن
نشبح	ن ش ب ح
اجتهدوا	ا ج ت ه د و ا
نتواجد	ن ت و ا ج د
يتفقن	ي ت ف ق ن
تستحمل	ت س ت ح م ل
مترجمون	م ت ر ج م و ن
خولفن	خ و ل ف ن
خليصة	خ ل ي ص ة
نموتن	ن م و ت ن
ثقفنا	ث ق ف ن ا
نكبس	ن ك ب س
مرجونة	م ر ج و ن ة
فاجأ	ف ا ج أ
نافورة	ن ا ف و ر ة
تسريتن	ت س ر ي ت ن
اصطفاء	ا ص ط ف ا ء
اصطلى	ا ص ط ل ى
تضوأتن	ت ض و أ ت ن
مسرعون	م س ر ع و ن
شوركوا	ش و ر ك و ا
تماسسن	ت م ا س س ن
إعمار	إ ع م ا ر
سفرجلة	س ف ر ج ل ة
هون	ه و ن
أنطرح	أ ن ط ر ح
جس	ج س
اخفضن	ا خ ف ض ن
صابورة	ص ا ب و ر ة
نتيسر	ن ت ي س ر
تبعثين	ت ب ع ث ي ن
هيولي	ه ي و ل ي
راتب	ر ا ت ب
يحاضرن	ي ح ا ض ر ن
برقنا	ب ر ق ن ا
تحبرن	ت ح ب ر ن
أوقفتم	أ و ق ف ت م
هبطتم	ه ب ط ت م
ركن	ر ك ن
يدفوا	ي د ف و ا
تتغرغري	ت ت غ ر غ ر ي
أوثرتم	أ و ث ر ت م
تستأنين	ت س ت أ ن ي ن
تمتازين	ت م ت ا ز ي ن
يكلفوا	ي ك ل ف و ا
جرحتن	ج ر ح ت ن
تأثير	ت أ ث ي ر
صرصر	ص ر ص ر
عمرة	ع م ر ة
تجرئي	ت ج ر ئ ي
يستردد	ي س ت ر د د
يمحو	ي م ح و
يتخامر	ي ت خ ا م ر
جراءة	ج ر ا ء ة
أبار	أ ب ا ر
كثرة	ك ث ر ة
جرجر	ج ر ج ر
تحكو	ت ح ك و
هند	ه ن د
تشتهري	ت ش ت ه ر ي
زلابية	ز ل ا ب ي ة
تؤصلوا	ت ؤ ص ل و ا
إحفاظ	إ ح ف ا ظ
ترشدون	ت ر ش د و ن
خالية	خ ا ل ي ة
حددوا	ح د د و ا
قيدوم	ق ي د و م
سكاكين	س ك ا ك ي ن
يحبور	ي ح ب و ر
نقير	ن ق ي ر
يستحون	ي س ت ح و ن
زنفيلجة	ز ن ف ي ل ج ة
يرتحن	ي ر ت ح ن
كمنة	ك م ن ة
تبأسن	ت ب أ س ن
تبسمتن	ت ب س م ت ن
تتهدفون	ت ت ه د ف و ن
اخدري	ا خ د ر ي
علقتم	ع ل ق ت م
نزدان	ن ز د ا ن
حفي	ح ف ي
اطلقن	ا ط ل ق ن
ايملوا	ا ي م ل و ا
تسخط	ت س خ ط
أميت	أ م ي ت
أصفهان	أ ص ف ه ا ن
إدبار	إ د ب ا ر
يؤدون	ي ؤ د و ن
يوهبن	ي و ه ب ن
قهقهة	ق ه ق ه ة
تجلدن	ت ج ل د ن
اغلقي	ا غ ل ق ي
أطربنا	أ ط ر ب ن ا
اتخذي	ا ت خ ذ ي
تهمي	ت ه م ي
عويص	ع و ي ص
متوفون	م ت و ف و ن
۝	۝
تولت	ت و ل ت
توعوي	ت و ع و ي
تباح	ت ب ا ح
تمتمة	ت م ت م ة
قاموا	ق ا م و ا
عروس	ع ر و س
تواترن	ت و ا ت ر ن
يغربن	ي غ ر ب ن
ووتروا	و و ت ر و ا
يستهزئوا	ي س ت ه ز ئ و ا
كنز	ك ن ز
تعفنتم	ت ع ف ن ت م
يمينية	ي م ي ن ي ة
ظاهرت	ظ ا ه ر ت
اكتتبي	ا ك ت ت ب ي
استؤصلتن	ا س ت ؤ ص ل ت ن
أسستم	أ س س ت م
تنكتب	ت ن ك ت ب
كلك	ك ل ك
تنفي	ت ن ف ي
يليقوا	ي ل ي ق و ا
جوبرتن	ج و ب ر ت ن
قابلتم	ق ا ب ل ت م
قعن	ق ع ن
تحلقين	ت ح ل ق ي ن
انطرحن	ا ن ط ر ح ن
دربت	د ر ب ت
جلخ	ج ل خ
هيج	ه ي ج
يباحثن	ي ب ا ح ث ن
انفصلي	ا ن ف ص ل ي
يعاقب	ي ع ا ق ب
راسخت	ر ا س خ ت
ذاكرن	ذ ا ك ر ن
تتحببين	ت ت ح ب ب ي ن
تكثر	ت ك ث ر
إجازة	إ ج ا ز ة
خامرتم	خ ا م ر ت م
دومان	د و م ا ن
ترافع	ت ر ا ف ع
ضعف	ض ع ف
يوصفوا	ي و ص ف و ا
عاتق	ع ا ت ق
نظارة	ن ظ ا ر ة
لاقي	ل ا ق ي
تدافعي	ت د ا ف ع ي
يخلط	ي خ ل ط
يستخبرون	ي س ت خ ب ر و ن
تواتروا	ت و ا ت ر و ا
اشكلي	ا ش ك ل ي
آذريون	آ ذ ر ي و ن
برباريس	ب ر ب ا ر ي س
ظاء	ظ ا ء
عوملنا	ع و م ل ن ا
تجاهلي	ت ج ا ه ل ي
والدون	و ا ل د و ن
سلطت	س ل ط ت
يتحادث	ي ت ح ا د ث
يستتيبون	ي س ت ت ي ب و ن
تؤلمون	ت ؤ ل م و ن
يستلهمن	ي س ت ل ه م ن
أضئ	أ ض ئ
تحفظوا	ت ح ف ظ و ا
بغي	ب غ ي
تنفخين	ت ن ف خ ي ن
شلح	ش ل ح
تحسي	ت ح س ي
فاشي	ف ا ش ي
يراددون	ي ر ا د د و ن
يؤمن	ي ؤ م ن
تتفارقين	ت ت ف ا ر ق ي ن
تباحثين	ت ب ا ح ث ي ن
وتار	و ت ا ر
نياحة	ن ي ا ح ة
نوادي	ن و ا د ي
تخلقوا	ت خ ل ق و ا
عجلتم	ع ج ل ت م
فرشوا	ف ر ش و ا
قعدتن	ق ع د ت ن
حوسب	ح و س ب
تحاوطن	ت ح ا و ط ن
نياط	ن ي ا ط
تدعمن	ت د ع م ن
انشغاف	ا ن ش غ ا ف
اقترحوا	ا ق ت ر ح و ا
سهلي	س ه ل ي
تسبكروا	ت س ب ك ر و ا
أسلمن	أ س ل م ن
تسترجلي	ت س ت ر ج ل ي
يحسدن	ي ح س د ن
يتنجموا	ي ت ن ج م و ا
تطمأنن	ت ط م أ ن ن
نصعد	ن ص ع د
يمصون	ي م ص و ن
استأذن	ا س ت أ ذ ن
فودنج	ف و د ن ج
اجزوا	ا ج ز و ا
غرلة	غ ر ل ة
صخ	ص خ
اضعفن	ا ض ع ف ن
تهتموا	ت ه ت م و ا
ثئرت	ث ئ ر ت
تخطوا	ت خ ط و ا
حكيمات	ح ك ي م ا ت
تثمل	ت ث م ل
ابيضي	ا ب ي ض ي
يخصي	ي خ ص ي
متأخرون	م ت أ خ ر و ن
قزوين	ق ز و ي ن
اذكار	ا ذ ك ا ر
سيطر	س ي ط ر
يضوؤون	ي ض و ؤ و ن
تبرقعن	ت ب ر ق ع ن
ننتفخ	ن ن ت ف خ
مكاء	م ك ا ء
فراخ	ف ر ا خ
يركبوا	ي ر ك ب و ا
مجوهرات	م ج و ه ر ا ت
حس	ح س
فرضنا	ف ر ض ن ا
استفهمنا	ا س ت ف ه م ن ا
هز	ه ز
رقاد	ر ق ا د
وجدن	و ج د ن
رجينا	ر ج ي ن ا
عيشة	ع ي ش ة
ساررن	س ا ر ر ن
ينضممن	ي ن ض م م ن
سرقة	س ر ق ة
اثملوا	ا ث م ل و ا
أدبرنا	أ د ب ر ن ا
تتبولي	ت ت ب و ل ي
كويكب	ك و ي ك ب
روقبن	ر و ق ب ن
أللتن	أ ل ل ت ن
يستديرون	ي س ت د ي ر و ن
صون	ص و ن
تثنوني	ت ث ن و ن ي
يماهون	ي م ا ه و ن
كرسنة	ك ر س ن ة
تخدمين	ت خ د م ي ن
ازدوج	ا ز د و ج
شط	ش ط
فلسفة	ف ل س ف ة
تؤلهوا	ت ؤ ل ه و ا
رجينة	ر ج ي ن ة
نعرة	ن ع ر ة
تمرجين	ت م ر ج ي ن
تعوجين	ت ع و ج ي ن
حضروا	ح ض ر و ا
أبردة	أ ب ر د ة
اخزنوا	ا خ ز ن و ا
أعمق	أ ع م ق
تتفجرون	ت ت ف ج ر و ن
أوثرت	أ و ث ر ت
تنصتين	ت ن ص ت ي ن
أبنا	أ ب ن ا
نضايق	ن ض ا ي ق
نتر	ن ت ر
خطيرة	خ ط ي ر ة
يدورن	ي د و ر ن
أسترد	أ س ت ر د
افتعلت	ا ف ت ع ل ت
فانية	ف ا ن ي ة
تراجعون	ت ر ا ج ع و ن
ساخط	س ا خ ط
يتشاءمن	ي ت ش ا ء م ن
تحفل	ت ح ف ل
جيف	ج ي ف
نغضب	ن غ ض ب
تخطون	ت خ ط و ن
يقالون	ي ق ا ل و ن
اقسموا	ا ق س م و ا
نوولوا	ن و و ل و ا
تستقتلين	ت س ت ق ت ل ي ن
تطربوا	ت ط ر ب و ا
يضطربن	ي ض ط ر ب ن
ينحمل	ي ن ح م ل
لاغية	ل ا غ ي ة
اندس	ا ن د س
مميثا	م م ي ث ا
يخلطن	ي خ ل ط ن
غفير	غ ف ي ر
انقرضت	ا ن ق ر ض ت
اتلل	ا ت ل ل
بدلا	ب د ل ا
غرين	غ ر ي ن
إربيان	إ ر ب ي ا ن
أستلم	أ س ت ل م
بانوا	ب ا ن و ا
تفاضلتم	ت ف ا ض ل ت م
عاونا	ع ا و ن ا
ألقيتن	أ ل ق ي ت ن
كيان	ك ي ا ن
صحبتن	ص ح ب ت ن
عال	ع ا ل
عوونوا	ع و و ن و ا
تعتادين	ت ع ت ا د ي ن
تجزي	ت ج ز ي
أطربي	أ ط ر ب ي
عرفنا	ع ر ف ن ا
تحين	ت ح ي ن
سطم	س ط م
اسخط	ا س خ ط
دوروا	د و ر و ا
تراكم	ت ر ا ك م
دراماتيكي	د ر ا م ا ت ي ك ي
تفقسي	ت ف ق س ي
اخروطوا	ا خ ر و ط و ا
استنجاء	ا س ت ن ج ا ء
أرجع	أ ر ج ع
تستسلم	ت س ت س ل م
أجلعبب	أ ج ل ع ب ب
تقرئي	ت ق ر ئ ي
تخضاروا	ت خ ض ا ر و ا
تشتملوا	ت ش ت م ل و ا
عارضة	ع ا ر ض ة
مسلول	م س ل و ل
أنون	أ ن و ن
شربتم	ش ر ب ت م
تجادل	ت ج ا د ل
تمرنوا	ت م ر ن و ا
ينبؤوا	ي ن ب ؤ و ا
أذهبتم	أ ذ ه ب ت م
تناسبت	ت ن ا س ب ت
أتوحد	أ ت و ح د
تعورن	ت ع و ر ن
تصفرن	ت ص ف ر ن
يستولى	ي س ت و ل ى
باحثي	ب ا ح ث ي
تهبطن	ت ه ب ط ن
تمرينات	ت م ر ي ن ا ت
تستتيبين	ت س ت ت ي ب ي ن
تنافسنا	ت ن ا ف س ن ا
يتطاول	ي ت ط ا و ل
توقينا	ت و ق ي ن ا
تجاوزين	ت ج ا و ز ي ن
ووترتن	و و ت ر ت ن
أشفاق	أ ش ف ا ق
أواسط	أ و ا س ط
غلمتن	غ ل م ت ن
طعنتم	ط ع ن ت م
أتأمر	أ ت أ م ر
زمنية	ز م ن ي ة
زرق	ز ر ق
تنقصن	ت ن ق ص ن
منفحة	م ن ف ح ة
نجذر	ن ج ذ ر
تبركي	ت ب ر ك ي
تحصدون	ت ح ص د و ن
راجشاهي	ر ا ج ش ا ه ي
يعلق	ي ع ل ق
يمتلك	ي م ت ل ك
تنزفون	ت ن ز ف و ن
يتبن	ي ت ب ن
إرباك	إ ر ب ا ك
اغفري	ا غ ف ر ي
سلس	س ل س
أمنية	أ م ن ي ة
تتخذي	ت ت خ ذ ي
تغفري	ت غ ف ر ي
اطرب	ا ط ر ب
زادوا	ز ا د و ا
جنيف	ج ن ي ف
عمومية	ع م و م ي ة
ينوى	ي ن و ى
استصبحتم	ا س ت ص ب ح ت م
تستهزأوا	ت س ت ه ز أ و ا
خافض	خ ا ف ض
عفون	ع ف و ن
نماس	ن م ا س
بطئن	ب ط ئ ن
يثنون	ي ث ن و ن
تبحثوا	ت ب ح ث و ا
حيطوا	ح ي ط و ا
تيقظ	ت ي ق ظ
يحرنجمون	ي ح ر ن ج م و ن
تجملت	ت ج م ل ت
اتضاع	ا ت ض ا ع
نوسبوا	ن و س ب و ا
اشتركنا	ا ش ت ر ك ن ا
تأخذون	ت أ خ ذ و ن
يوعظوا	ي و ع ظ و ا
حدثوا	ح د ث و ا
لاوعي	ل ا و ع ي
يعذبوا	ي ع ذ ب و ا
اعتقدتن	ا ع ت ق د ت ن
مزدحمة	م ز د ح م ة
تدفؤوا	ت د ف ؤ و ا
أزرد	أ ز ر د
ابتسرت	ا ب ت س ر ت
نستصبح	ن س ت ص ب ح
الدنمرك	ا ل د ن م ر ك
قسسن	ق س س ن
الشاش	ا ل ش ا ش
اسلنطاح	ا س ل ن ط ا ح
أسارق	أ س ا ر ق
اصطدأ	ا ص ط د أ
يستنفرون	ي س ت ن ف ر و ن
عاون	ع ا و ن
اسمن	ا س م ن
يفهم	ي ف ه م
تتهتلرن	ت ت ه ت ل ر ن
يقلمون	ي ق ل م و ن
أشهدن	أ ش ه د ن
تنفقي	ت ن ف ق ي
توكدين	ت و ك د ي ن
أماتت	أ م ا ت ت
يفرجن	ي ف ر ج ن
بلحة	ب ل ح ة
تشطون	ت ش ط و ن
تنون	ت ن و ن
زركشتن	ز ر ك ش ت ن
تتشرفوا	ت ت ش ر ف و ا
ينجزن	ي ن ج ز ن
يخدشوا	ي خ د ش و ا
يبطئن	ي ب ط ئ ن
يمرجن	ي م ر ج ن
يسائلون	ي س ا ئ ل و ن
يجرنثمون	ي ج ر ن ث م و ن
تتقامر	ت ت ق ا م ر
ترخي	ت ر خ ي
فضلوا	ف ض ل و ا
تصن	ت ص ن
أفرش	أ ف ر ش
استوردي	ا س ت و ر د ي
بسطتم	ب س ط ت م
تمض	ت م ض
نافع	ن ا ف ع
وجد	و ج د
تتحادث	ت ت ح ا د ث
شوكة	ش و ك ة
ممثلة	م م ث ل ة
قاومن	ق ا و م ن
طرطور	ط ر ط و ر
يتيم	ي ت ي م
استسلمنا	ا س ت س ل م ن ا
تبوا	ت ب و ا
شعاب	ش ع ا ب
تعيس	ت ع ي س
نخاسة	ن خ ا س ة
نذاق	ن ذ ا ق
نجبل	ن ج ب ل
أعذب	أ ع ذ ب
ثواب	ث و ا ب
صبغ	ص ب غ
رشد	ر ش د
نمينا	ن م ي ن ا
تخلفن	ت خ ل ف ن
مصصت	م ص ص ت
يضعفن	ي ض ع ف ن
طاوع	ط ا و ع
تتعجرفين	ت ت ع ج ر ف ي ن
كمان	ك م ا ن
يخولن	ي خ و ل ن
تجوف	ت ج و ف
وردت	و ر د ت
هيجا	ه ي ج ا
خلوا	خ ل و ا
أجرن	أ ج ر ن
مطرت	م ط ر ت
جوفوا	ج و ف و ا
أبدأ	أ ب د أ
نتل	ن ت ل
ميول	م ي و ل
ترددتن	ت ر د د ت ن
شموا	ش م و ا
شمسية	ش م س ي ة
استنير	ا س ت ن ي ر
ماهوا	م ا ه و ا
سحرن	س ح ر ن
يخفى	ي خ ف ى
يمتثلن	ي م ت ث ل ن
جاهلون	ج ا ه ل و ن
يحمون	ي ح م و ن
يستقرئوا	ي س ت ق ر ئ و ا
نحف	ن ح ف
خضراوات	خ ض ر ا و ا ت
تفقرين	ت ف ق ر ي ن
تحطوا	ت ح ط و ا
يدمون	ي د م و ن
أحبك	أ ح ب ك
تبدلوا	ت ب د ل و ا
تستمعن	ت س ت م ع ن
كسروا	ك س ر و ا
شمسي	ش م س ي
سورر	س و ر ر
نبرق	ن ب ر ق
يحلقوا	ي ح ل ق و ا
سبل	س ب ل
أضافوا	أ ض ا ف و ا
نفقنا	ن ف ق ن ا
يحي	ي ح ي
يتمثل	ي ت م ث ل
تحيز	ت ح ي ز
بشرنا	ب ش ر ن ا
ينقصوا	ي ن ق ص و ا
يدح	ي د ح
جهزتن	ج ه ز ت ن
تقوا	ت ق و ا
مننتم	م ن ن ت م
أهلتم	أ ه ل ت م
واليت	و ا ل ي ت
تتسوقن	ت ت س و ق ن
تنجم	ت ن ج م
تستوفى	ت س ت و ف ى
تتحسبن	ت ت ح س ب ن
تتهيئين	ت ت ه ي ئ ي ن
ريصار	ر ي ص ا ر
ترفعنا	ت ر ف ع ن ا
قند	ق ن د
يزرقون	ي ز ر ق و ن
نقص	ن ق ص
كيد	ك ي د
ندافع	ن د ا ف ع
سلخت	س ل خ ت
يبرك	ي ب ر ك
حضرتم	ح ض ر ت م
لومسوا	ل و م س و ا
لهى	ل ه ى
عداوة	ع د ا و ة
عبق	ع ب ق
رضوان	ر ض و ا ن
دائرة	د ا ئ ر ة
اصطبن	ا ص ط ب ن
يشاروا	ي ش ا ر و ا
غلطتم	غ ل ط ت م
فقدتن	ف ق د ت ن
يرعون	ي ر ع و ن
عفص	ع ف ص
ترنح	ت ر ن ح
أبتن	أ ب ت ن
أقرباء	أ ق ر ب ا ء
تحتربن	ت ح ت ر ب ن
يتعارفوا	ي ت ع ا ر ف و ا
نراد	ن ر ا د
تتخابرين	ت ت خ ا ب ر ي ن
يصطلى	ي ص ط ل ى
انتقموا	ا ن ت ق م و ا
جع	ج ع
يعضض	ي ع ض ض
انخفاض	ا ن خ ف ا ض
بددة	ب د د ة
يتفقوا	ي ت ف ق و ا
سقيتم	س ق ي ت م
تجوز	ت ج و ز
يتبولن	ي ت ب و ل ن
يخامرن	ي خ ا م ر ن
أراضي	أ ر ا ض ي
يرسمن	ي ر س م ن
خصاص	خ ص ا ص
رفعتم	ر ف ع ت م
وجبت	و ج ب ت
بيح	ب ي ح
أشعرتم	أ ش ع ر ت م
يستذكروا	ي س ت ذ ك ر و ا
استعددتم	ا س ت ع د د ت م
تشع	ت ش ع
قطعي	ق ط ع ي
تواصلن	ت و ا ص ل ن
ابتسمي	ا ب ت س م ي
تتنحلن	ت ت ن ح ل ن
تغربن	ت غ ر ب ن
زبرتن	ز ب ر ت ن
اخدش	ا خ د ش
يستعملوا	ي س ت ع م ل و ا
أدمنت	أ د م ن ت
وجب	و ج ب
تحتلمين	ت ح ت ل م ي ن
تحدثت	ت ح د ث ت
قسطاس	ق س ط ا س
نمساويون	ن م س ا و ي و ن
أحطنا	أ ح ط ن ا
ردفت	ر د ف ت
شاعرات	ش ا ع ر ا ت
تواترون	ت و ا ت ر و ن
مدخن	م د خ ن
يسل	ي س ل
اجهد	ا ج ه د
بزاقة	ب ز ا ق ة
تبنوا	ت ب ن و ا
نوترون	ن و ت ر و ن
لطش	ل ط ش
تمضغي	ت م ض غ ي
ضادي	ض ا د ي
تزخرف	ت ز خ ر ف
احولي	ا ح و ل ي
أناغالس	أ ن ا غ ا ل س
أكلة	أ ك ل ة
مدفعية	م د ف ع ي ة
استتر	ا س ت ت ر
أوان	أ و ا ن
غلين	غ ل ي ن
يتأمروا	ي ت أ م ر و ا
تقطبوا	ت ق ط ب و ا
طلن	ط ل ن
يؤاجرن	ي ؤ ا ج ر ن
صربيا	ص ر ب ي ا
ليبيون	ل ي ب ي و ن
عش	ع ش
نتخمر	ن ت خ م ر
وافين	و ا ف ي ن
اصفرر	ا ص ف ر ر
نتحاسب	ن ت ح ا س ب
توطأن	ت و ط أ ن
قمح	ق م ح
يقهقهوا	ي ق ه ق ه و ا
يقررن	ي ق ر ر ن
اسكتلندي	ا س ك ت ل ن د ي
يدفنوا	ي د ف ن و ا
تماسوا	ت م ا س و ا
تعربي	ت ع ر ب ي
حفوا	ح ف و ا
ناعم	ن ا ع م
أتعرب	أ ت ع ر ب
تورثين	ت و ر ث ي ن
مطاولة	م ط ا و ل ة
استسلمي	ا س ت س ل م ي
تحزنوا	ت ح ز ن و ا
تسبكررن	ت س ب ك ر ر ن
تلال	ت ل ا ل
كلبتان	ك ل ب ت ا ن
جلالة	ج ل ا ل ة
تعددي	ت ع د د ي
يوفي	ي و ف ي
وجدتم	و ج د ت م
تذلعبب	ت ذ ل ع ب ب
مشربة	م ش ر ب ة
صفارة	ص ف ا ر ة
تخلطن	ت خ ل ط ن
أدخلي	أ د خ ل ي
استحرمتن	ا س ت ح ر م ت ن
فرفخ	ف ر ف خ
اقرضوا	ا ق ر ض و ا
قلدت	ق ل د ت
تطبع	ت ط ب ع
عيادة	ع ي ا د ة
تستحى	ت س ت ح ى
تمتثل	ت م ت ث ل
ناري	ن ا ر ي
يجاررون	ي ج ا ر ر و ن
اخترقوا	ا خ ت ر ق و ا
انزوى	ا ن ز و ى
كدر	ك د ر
قاص	ق ا ص
أصغري	أ ص غ ر ي
جبيز	ج ب ي ز
صب	ص ب
أعمرت	أ ع م ر ت
كاشم	ك ا ش م
فوز	ف و ز
تجرحن	ت ج ر ح ن
استيء	ا س ت ي ء
طفئن	ط ف ئ ن
متوحد	م ت و ح د
تعمرون	ت ع م ر و ن
تطولون	ت ط و ل و ن
خلاق	خ ل ا ق
شفاف	ش ف ا ف
اهجمي	ا ه ج م ي
قلاء	ق ل ا ء
استمتاع	ا س ت م ت ا ع
عرس	ع ر س
تنتوي	ت ن ت و ي
جليات	ج ل ي ا ت
أناة	أ ن ا ة
وجدان	و ج د ا ن
آثرن	آ ث ر ن
غمرت	غ م ر ت
تنتحلون	ت ن ت ح ل و ن
تثبرن	ت ث ب ر ن
عوراء	ع و ر ا ء
أضعتن	أ ض ع ت ن
حاجز	ح ا ج ز
لعل	ل ع ل
نرتدي	ن ر ت د ي
صحبت	ص ح ب ت
تزدهري	ت ز د ه ر ي
أترادد	أ ت ر ا د د
يجابروا	ي ج ا ب ر و ا
يتسلى	ي ت س ل ى
ثئر	ث ئ ر
كريفون	ك ر ي ف و ن
نمساوية	ن م س ا و ي ة
ترعة	ت ر ع ة
كهروضوئي	ك ه ر و ض و ئ ي
تثأر	ت ث أ ر
مثلن	م ث ل ن
انعظ	ا ن ع ظ
اشروا	ا ش ر و ا
توافقنا	ت و ا ف ق ن ا
تشكى	ت ش ك ى
يحتوين	ي ح ت و ي ن
اقبحن	ا ق ب ح ن
حرثتن	ح ر ث ت ن
خاطبي	خ ا ط ب ي
اذكرتم	ا ذ ك ر ت م
استخبر	ا س ت خ ب ر
خديج	خ د ي ج
نلغي	ن ل غ ي
تلفزيونات	ت ل ف ز ي و ن ا ت
روحية	ر و ح ي ة
مارست	م ا ر س ت
ننتوي	ن ن ت و ي
يصححون	ي ص ح ح و ن
والي	و ا ل ي
يغتلمن	ي غ ت ل م ن
ثقبتم	ث ق ب ت م
نكثر	ن ك ث ر
وتري	و ت ر ي
أرختم	أ ر خ ت م
السنبلة	ا ل س ن ب ل ة
يباسون	ي ب ا س و ن
اضرطوا	ا ض ر ط و ا
يقاتلوا	ي ق ا ت ل و ا
أوفوا	أ و ف و ا
نعظتن	ن ع ظ ت ن
شيكاغو	ش ي ك ا غ و
يؤبدون	ي ؤ ب د و ن
تراجعوا	ت ر ا ج ع و ا
أجنبية	أ ج ن ب ي ة
أصابع	أ ص ا ب ع
اسندن	ا س ن د ن
صيفة	ص ي ف ة
تتعاكسون	ت ت ع ا ك س و ن
عوروا	ع و ر و ا
تصدفوا	ت ص د ف و ا
يركزن	ي ر ك ز ن
مداح	م د ا ح
قعي	ق ع ي
ايتممن	ا ي ت م م ن
كتبن	ك ت ب ن
إسراف	إ س ر ا ف
كاثرنا	ك ا ث ر ن ا
تخضلون	ت خ ض ل و ن
يصلحوا	ي ص ل ح و ا
فالودق	ف ا ل و د ق
شاذ	ش ا ذ
بطؤنا	ب ط ؤ ن ا
شكال	ش ك ا ل
تشتملن	ت ش ت م ل ن
تهاجم	ت ه ا ج م
مخرز	م خ ر ز
طواية	ط و ا ي ة
يعمقن	ي ع م ق ن
نقحر	ن ق ح ر
نيقظ	ن ي ق ظ
ابتهال	ا ب ت ه ا ل
يحلون	ي ح ل و ن
ترام	ت ر ا م
تزورون	ت ز و ر و ن
مكرتن	م ك ر ت ن
تغرون	ت غ ر و ن
أحفظتم	أ ح ف ظ ت م
تبرزون	ت ب ر ز و ن
هويس	ه و ي س
تنذير	ت ن ذ ي ر
مستنبت	م س ت ن ب ت
مورست	م و ر س ت
تراددن	ت ر ا د د ن
ركزي	ر ك ز ي
تحاسبوا	ت ح ا س ب و ا
بينيث	ب ي ن ي ث
يهنأون	ي ه ن أ و ن
نابلسي	ن ا ب ل س ي
ابلدن	ا ب ل د ن
تميت	ت م ي ت
تتباءسوا	ت ت ب ا ء س و ا
تتجمعوا	ت ت ج م ع و ا
تتدمري	ت ت د م ر ي
جلنار	ج ل ن ا ر
يلفي	ي ل ف ي
ابتسمن	ا ب ت س م ن
أكرهنا	أ ك ر ه ن ا
مواطن	م و ا ط ن
قوتلن	ق و ت ل ن
حفة	ح ف ة
عبو	ع ب و
اذكري	ا ذ ك ر ي
صعدن	ص ع د ن
نغلل	ن غ ل ل
تقطبنا	ت ق ط ب ن ا
كركدن	ك ر ك د ن
تجلسن	ت ج ل س ن
يستنفروا	ي س ت ن ف ر و ا
تعرق	ت ع ر ق
تستقبحين	ت س ت ق ب ح ي ن
أزوج	أ ز و ج
اقربي	ا ق ر ب ي
تصرعن	ت ص ر ع ن
تتجنبوا	ت ت ج ن ب و ا
تتقامروا	ت ت ق ا م ر و ا
تحاربتم	ت ح ا ر ب ت م
زيف	ز ي ف
حام	ح ا م
تقبحين	ت ق ب ح ي ن
مستمرون	م س ت م ر و ن
دمشق	د م ش ق
قدستم	ق د س ت م
راددنا	ر ا د د ن ا
قورضتم	ق و ر ض ت م
تتمسكي	ت ت م س ك ي
شمي	ش م ي
بصقتن	ب ص ق ت ن
رجعت	ر ج ع ت
شرطيون	ش ر ط ي و ن
يقرؤوا	ي ق ر ؤ و ا
تختتني	ت خ ت ت ن ي
كفيتن	ك ف ي ت ن
تميل	ت م ي ل
ارجي	ا ر ج ي
ضبط	ض ب ط
يتأكد	ي ت أ ك د
طووعت	ط و و ع ت
نتق	ن ت ق
أمنا	أ م ن ا
تزرن	ت ز ر ن
جزيئي	ج ز ي ئ ي
صعدوا	ص ع د و ا
قثطرة	ق ث ط ر ة
طبيبة	ط ب ي ب ة
ظلي	ظ ل ي
جوالق	ج و ا ل ق
نغفر	ن غ ف ر
اكلب	ا ك ل ب
يفرحوا	ي ف ر ح و ا
أحقوا	أ ح ق و ا
يتسامعوا	ي ت س ا م ع و ا
تطفئي	ت ط ف ئ ي
تسررن	ت س ر ر ن
يخرنطم	ي خ ر ن ط م
مكثتم	م ك ث ت م
أنشأن	أ ن ش أ ن
أتحاب	أ ت ح ا ب
تصنيف	ت ص ن ي ف
تضايقوا	ت ض ا ي ق و ا
شكيتم	ش ك ي ت م
زؤام	ز ؤ ا م
يوكد	ي و ك د
ابتهاج	ا ب ت ه ا ج
تبلعي	ت ب ل ع ي
أمصر	أ م ص ر
تطويل	ت ط و ي ل
صوبحتن	ص و ب ح ت ن
زكي	ز ك ي
ليقة	ل ي ق ة
تتزوجين	ت ت ز و ج ي ن
يحيلوا	ي ح ي ل و ا
لوثت	ل و ث ت
اقدرن	ا ق د ر ن
اقتطف	ا ق ت ط ف
بيه	ب ي ه
انمي	ا ن م ي
ينهوا	ي ن ه و ا
بيض	ب ي ض
تصنعون	ت ص ن ع و ن
انسحب	ا ن س ح ب
اكتحال	ا ك ت ح ا ل
تتزوى	ت ت ز و ى
أخرمص	أ خ ر م ص
ينفرد	ي ن ف ر د
أستبدل	أ س ت ب د ل
غواصة	غ و ا ص ة
قرئتم	ق ر ئ ت م
نزبد	ن ز ب د
صفير	ص ف ي ر
يخضلون	ي خ ض ل و ن
تعاملتم	ت ع ا م ل ت م
قابلت	ق ا ب ل ت
أنهيتم	أ ن ه ي ت م
يؤدبون	ي ؤ د ب و ن
تاهوا	ت ا ه و ا
اصرخ	ا ص ر خ
قفال	ق ف ا ل
اغتياب	ا غ ت ي ا ب
تصمدين	ت ص م د ي ن
أدف	أ د ف
جوف	ج و ف
يقدرن	ي ق د ر ن
يجاوز	ي ج ا و ز
يخانون	ي خ ا ن و ن
أرتبك	أ ر ت ب ك
تصعقوا	ت ص ع ق و ا
أقمتم	أ ق م ت م
منجنيق	م ن ج ن ي ق
ذكرن	ذ ك ر ن
مأدبة	م أ د ب ة
أسست	أ س س ت
شاءت	ش ا ء ت
ارتبكنا	ا ر ت ب ك ن ا
يتوكدون	ي ت و ك د و ن
تلميذات	ت ل م ي ذ ا ت
يعرقن	ي ع ر ق ن
مدمن	م د م ن
ملاتيوس	م ل ا ت ي و س
شرائط	ش ر ا ئ ط
تعنوا	ت ع ن و ا
ردهة	ر د ه ة
نكد	ن ك د
شيص	ش ي ص
يجاور	ي ج ا و ر
اتركن	ا ت ر ك ن
بالينا	ب ا ل ي ن ا
مشاع	م ش ا ع
تحرنجمن	ت ح ر ن ج م ن
ازدادت	ا ز د ا د ت
خرجن	خ ر ج ن
صد	ص د
تواجدوا	ت و ا ج د و ا
تحاملوا	ت ح ا م ل و ا
يحشروا	ي ح ش ر و ا
إسفيذاج	إ س ف ي ذ ا ج
جووزوا	ج و و ز و ا
تؤدبوا	ت ؤ د ب و ا
تسرب	ت س ر ب
اكرمن	ا ك ر م ن
تدينوا	ت د ي ن و ا
حاربي	ح ا ر ب ي
تتباركن	ت ت ب ا ر ك ن
تتمصروا	ت ت م ص ر و ا
يقايسن	ي ق ا ي س ن
خوخة	خ و خ ة
سجستان	س ج س ت ا ن
تقديس	ت ق د ي س
تشخبط	ت ش خ ب ط
باه	ب ا ه
مزلقة	م ز ل ق ة
أنرنا	أ ن ر ن ا
ترزي	ت ر ز ي
نستوف	ن س ت و ف
اخرمصي	ا خ ر م ص ي
فقطتن	ف ق ط ت ن
ض	ض
يمتازون	ي م ت ا ز و ن
أسرعتم	أ س ر ع ت م
اقدر	ا ق د ر
مشكاة	م ش ك ا ة
تهددي	ت ه د د ي
يهنؤون	ي ه ن ؤ و ن
بادرة	ب ا د ر ة
صبروا	ص ب ر و ا
سالونيك	س ا ل و ن ي ك
توسوسون	ت و س و س و ن
يول	ي و ل
تعصرين	ت ع ص ر ي ن
تباكى	ت ب ا ك ى
فاعلية	ف ا ع ل ي ة
يقايس	ي ق ا ي س
اخترنا	ا خ ت ر ن ا
كهربوا	ك ه ر ب و ا
ننطفئ	ن ن ط ف ئ
نزعوا	ن ز ع و ا
يبتع	ي ب ت ع
تخضعوا	ت خ ض ع و ا
هودج	ه و د ج
تسلل	ت س ل ل
أضايف	أ ض ا ي ف
تدلين	ت د ل ي ن
كنزة	ك ن ز ة
دنوتم	د ن و ت م
خلاب	خ ل ا ب
تتنصتين	ت ت ن ص ت ي ن
أريحا	أ ر ي ح ا
ييئسوا	ي ي ئ س و ا
تؤاكلون	ت ؤ ا ك ل و ن
مقيل	م ق ي ل
دببن	د ب ب ن
سمار	س م ا ر
يتجبرن	ي ت ج ب ر ن
شوفان	ش و ف ا ن
كهربي	ك ه ر ب ي
سلوا	س ل و ا
تخشبون	ت خ ش ب و ن
أدنى	أ د ن ى
طرشي	ط ر ش ي
رسمتن	ر س م ت ن
تدلوا	ت د ل و ا
أتضخم	أ ت ض خ م
تباحي	ت ب ا ح ي
مزحنا	م ز ح ن ا
أعوج	أ ع و ج
يباشروا	ي ب ا ش ر و ا
نكستن	ن ك س ت ن
أشيروا	أ ش ي ر و ا
خابور	خ ا ب و ر
مسوا	م س و ا
تتبادل	ت ت ب ا د ل
صنعوا	ص ن ع و ا
دافع	د ا ف ع
شيئوا	ش ي ئ و ا
يخترعوا	ي خ ت ر ع و ا
أثلاث	أ ث ل ا ث
أصبحتم	أ ص ب ح ت م
مجنونة	م ج ن و ن ة
هنئ	ه ن ئ
نهار	ن ه ا ر
تجهل	ت ج ه ل
يضر	ي ض ر
عبرن	ع ب ر ن
أوساط	أ و س ا ط
تعارفي	ت ع ا ر ف ي
راقص	ر ا ق ص
ينكربون	ي ن ك ر ب و ن
يقبروا	ي ق ب ر و ا
نحي	ن ح ي
المسن	ا ل م س ن
تحاققي	ت ح ا ق ق ي
مسافة	م س ا ف ة
معاملة	م ع ا م ل ة
نسيل	ن س ي ل
ألفبائيون	أ ل ف ب ا ئ ي و ن
كرواتي	ك ر و ا ت ي
ابكرن	ا ب ك ر ن
نناوى	ن ن ا و ى
تغتصب	ت غ ت ص ب
زبدوا	ز ب د و ا
تسبغوا	ت س ب غ و ا
اثقبن	ا ث ق ب ن
وقتي	و ق ت ي
نجذ	ن ج ذ
نتعجب	ن ت ع ج ب
شرغوف	ش ر غ و ف
يستقرضن	ي س ت ق ر ض ن
راقب	ر ا ق ب
ننفي	ن ن ف ي
تحففن	ت ح ف ف ن
يتواضعن	ي ت و ا ض ع ن
يتقارضون	ي ت ق ا ر ض و ن
عباس	ع ب ا س
تهذر	ت ه ذ ر
يستأجروا	ي س ت أ ج ر و ا
שאהד	ש א ה ד
توصلوا	ت و ص ل و ا
يتضادوا	ي ت ض ا د و ا
تقارضي	ت ق ا ر ض ي
تستسرون	ت س ت س ر و ن
نتحمل	ن ت ح م ل
تعبد	ت ع ب د
تنكربي	ت ن ك ر ب ي
كهان	ك ه ا ن
ورل	و ر ل
علمية	ع ل م ي ة
يصيح	ي ص ي ح
أنعظ	أ ن ع ظ
ضعي	ض ع ي
يعجمون	ي ع ج م و ن
أخطم	أ خ ط م
حفلي	ح ف ل ي
يتزوجن	ي ت ز و ج ن
زحمتن	ز ح م ت ن
زرقطونا	ز ر ق ط و ن ا
بهاء	ب ه ا ء
انذروا	ا ن ذ ر و ا
عبدي	ع ب د ي
ارتجلتن	ا ر ت ج ل ت ن
أحصى	أ ح ص ى
شاقول	ش ا ق و ل
نومت	ن و م ت
دلب	د ل ب
نشرف	ن ش ر ف
تتسلقن	ت ت س ل ق ن
عارضيون	ع ا ر ض ي و ن
اغتصبت	ا غ ت ص ب ت
قادمات	ق ا د م ا ت
تحرنجم	ت ح ر ن ج م
كنائس	ك ن ا ئ س
تنعكسين	ت ن ع ك س ي ن
كساحة	ك س ا ح ة
تدفئين	ت د ف ئ ي ن
ابصقي	ا ب ص ق ي
رببنا	ر ب ب ن ا
انتحلتن	ا ن ت ح ل ت ن
تلتبنين	ت ل ت ب ن ي ن
محتلمة	م ح ت ل م ة
طعنت	ط ع ن ت
أولينا	أ و ل ي ن ا
تودع	ت و د ع
اندساس	ا ن د س ا س
أطلس	أ ط ل س
شونيز	ش و ن ي ز
تحدودبوا	ت ح د و د ب و ا
إفادة	إ ف ا د ة
يتثاءب	ي ت ث ا ء ب
يحبلن	ي ح ب ل ن
ترمين	ت ر م ي ن
توف	ت و ف
انقرضن	ا ن ق ر ض ن
اخدشن	ا خ د ش ن
ضوددتن	ض و د د ت ن
رجستم	ر ج س ت م
جردل	ج ر د ل
نابض	ن ا ب ض
تعجرفن	ت ع ج ر ف ن
تنورنا	ت ن و ر ن ا
تدورتن	ت د و ر ت ن
سرار	س ر ا ر
مصريون	م ص ر ي و ن
يسوءوا	ي س و ء و ا
أحكام	أ ح ك ا م
انشط	ا ن ش ط
تهريب	ت ه ر ي ب
تحيلوا	ت ح ي ل و ا
اشتاق	ا ش ت ا ق
جنست	ج ن س ت
توعظي	ت و ع ظ ي
أجنن	أ ج ن ن
يصلوا	ي ص ل و ا
نسؤ	ن س ؤ
اخشوشبوا	ا خ ش و ش ب و ا
يباعوا	ي ب ا ع و ا
تبالغين	ت ب ا ل غ ي ن
تماشى	ت م ا ش ى
تماسكتن	ت م ا س ك ت ن
ظوهروا	ظ و ه ر و ا
امحص	ا م ح ص
دحوت	د ح و ت
مدحلة	م د ح ل ة
اشتركت	ا ش ت ر ك ت
قابلتن	ق ا ب ل ت ن
غررت	غ ر ر ت
مستثنون	م س ت ث ن و ن
نؤتم	ن ؤ ت م
يفسقوا	ي ف س ق و ا
يوسمن	ي و س م ن
تحنأون	ت ح ن أ و ن
عبرة	ع ب ر ة
رئيتم	ر ئ ي ت م
فردوس	ف ر د و س
ساووا	س ا و و ا
اعفجي	ا ع ف ج ي
مملة	م م ل ة
عوملن	ع و م ل ن
صنت	ص ن ت
مسائية	م س ا ئ ي ة
سباع	س ب ا ع
تتحووا	ت ت ح و و ا
اعدلن	ا ع د ل ن
ضروب	ض ر و ب
نداوة	ن د ا و ة
طلقت	ط ل ق ت
احتاطوا	ا ح ت ا ط و ا
أحكت	أ ح ك ت
تتواجدون	ت ت و ا ج د و ن
صرق	ص ر ق
اضمحلال	ا ض م ح ل ا ل
دندن	د ن د ن
استيطان	ا س ت ي ط ا ن
ملآنة	م ل آ ن ة
استرزاق	ا س ت ر ز ا ق
والع	و ا ل ع
مدثر	م د ث ر
ترق	ت ر ق
الخرطوم	ا ل خ ر ط و م
أحرمت	أ ح ر م ت
قنبر	ق ن ب ر
هزيز	ه ز ي ز
قهقهتن	ق ه ق ه ت ن
نزول	ن ز و ل
اشمسي	ا ش م س ي
يحمى	ي ح م ى
تتطاولين	ت ت ط ا و ل ي ن
يولوا	ي و ل و ا
يزرق	ي ز ر ق
ييئس	ي ي ئ س
يقيس	ي ق ي س
شيوعيون	ش ي و ع ي و ن
نستمتع	ن س ت م ت ع
جاروا	ج ا ر و ا
تعمدوا	ت ع م د و ا
استرحتن	ا س ت ر ح ت ن
جرحي	ج ر ح ي
تتساوين	ت ت س ا و ي ن
تحوسب	ت ح و س ب
تعبانة	ت ع ب ا ن ة
ايتممت	ا ي ت م م ت
تماسكت	ت م ا س ك ت
اعترف	ا ع ت ر ف
يتماسكوا	ي ت م ا س ك و ا
أخذي	أ خ ذ ي
أقض	أ ق ض
تضايقي	ت ض ا ي ق ي
متكبر	م ت ك ب ر
تسبغلي	ت س ب غ ل ي
نسبح	ن س ب ح
تمتمتم	ت م ت م ت م
يهبر	ي ه ب ر
استسمح	ا س ت س م ح
غرنوق	غ ر ن و ق
تفهمون	ت ف ه م و ن
اخضعي	ا خ ض ع ي
شركن	ش ر ك ن
اشططن	ا ش ط ط ن
يعدمون	ي ع د م و ن
كعبة	ك ع ب ة
تهلين	ت ه ل ي ن
غدة	غ د ة
تشاغلوا	ت ش ا غ ل و ا
استسرت	ا س ت س ر ت
تؤاكلن	ت ؤ ا ك ل ن
لواث	ل و ا ث
تبدلتن	ت ب د ل ت ن
مشي	م ش ي
يشكلن	ي ش ك ل ن
يستجيروا	ي س ت ج ي ر و ا
لحى	ل ح ى
سوفياتيون	س و ف ي ا ت ي و ن
يسرعن	ي س ر ع ن
سديد	س د ي د
ينسحب	ي ن س ح ب
احططن	ا ح ط ط ن
ثابري	ث ا ب ر ي
انقضيتن	ا ن ق ض ي ت ن
يضأن	ي ض أ ن
انعملوا	ا ن ع م ل و ا
يستحممن	ي س ت ح م م ن
يستحيوا	ي س ت ح ي و ا
تؤاجروا	ت ؤ ا ج ر و ا
يخالطن	ي خ ا ل ط ن
تقرضون	ت ق ر ض و ن
جوزتن	ج و ز ت ن
قلتن	ق ل ت ن
جعفيل	ج ع ف ي ل
أهول	أ ه و ل
ارجعوا	ا ر ج ع و ا
يحيل	ي ح ي ل
تجملن	ت ج م ل ن
حبرج	ح ب ر ج
ارتديت	ا ر ت د ي ت
تستعربوا	ت س ت ع ر ب و ا
جونستن	ج و ن س ت ن
أنسى	أ ن س ى
أقفلتم	أ ق ف ل ت م
تخرمصص	ت خ ر م ص ص
خوش	خ و ش
تخدري	ت خ د ر ي
نوحد	ن و ح د
تزيني	ت ز ي ن ي
استعلام	ا س ت ع ل ا م
ينكتب	ي ن ك ت ب
تشموا	ت ش م و ا
يشرطون	ي ش ر ط و ن
استشراق	ا س ت ش ر ا ق
ذهبنا	ذ ه ب ن ا
ولى	و ل ى
جحور	ج ح و ر
أمطروا	أ م ط ر و ا
قصعة	ق ص ع ة
باغت	ب ا غ ت
اتباع	ا ت ب ا ع
ادبروا	ا د ب ر و ا
ليمي	ل ي م ي
غيظ	غ ي ظ
بتولية	ب ت و ل ي ة
شهاد	ش ه ا د
ليساء	ل ي س ا ء
نونت	ن و ن ت
صدوا	ص د و ا
هزمتن	ه ز م ت ن
اقتضيت	ا ق ت ض ي ت
تداولتم	ت د ا و ل ت م
أدحي	أ د ح ي
صئك	ص ئ ك
اطلعوا	ا ط ل ع و ا
أصفى	أ ص ف ى
اترك	ا ت ر ك
استعفى	ا س ت ع ف ى
أوفق	أ و ف ق
تستهزأن	ت س ت ه ز أ ن
ناف	ن ا ف
نظمي	ن ظ م ي
تحتشدن	ت ح ت ش د ن
تونسيون	ت و ن س ي و ن
تغرمون	ت غ ر م و ن
ورد	و ر د
طنجيرة	ط ن ج ي ر ة
يمارسن	ي م ا ر س ن
مترهل	م ت ر ه ل
نصير	ن ص ي ر
تجهلين	ت ج ه ل ي ن
فهرسة	ف ه ر س ة
تهتلروا	ت ه ت ل ر و ا
سجدتن	س ج د ت ن
تزوجين	ت ز و ج ي ن
يتساند	ي ت س ا ن د
مخاطب	م خ ا ط ب
تستقتلون	ت س ت ق ت ل و ن
تمرض	ت م ر ض
اخرنطموا	ا خ ر ن ط م و ا
مطاو	م ط ا و
خلوة	خ ل و ة
صححتن	ص ح ح ت ن
أحمل	أ ح م ل
ابرجي	ا ب ر ج ي
قنديل	ق ن د ي ل
يشط	ي ش ط
نتقيأ	ن ت ق ي أ
تهجمن	ت ه ج م ن
غلالة	غ ل ا ل ة
سعدتم	س ع د ت م
تحتملين	ت ح ت م ل ي ن
عضضتن	ع ض ض ت ن
آثرتم	آ ث ر ت م
جسر	ج س ر
قفلنا	ق ف ل ن ا
يعمرون	ي ع م ر و ن
تضطربين	ت ض ط ر ب ي ن
موتن	م و ت ن
يتزخرفوا	ي ت ز خ ر ف و ا
نتلل	ن ت ل ل
تتدمرن	ت ت د م ر ن
أولون	أ و ل و ن
غيرة	غ ي ر ة
مشغرة	م ش غ ر ة
ملامح	م ل ا م ح
حلقان	ح ل ق ا ن
أترجل	أ ت ر ج ل
بوريت	ب و ر ي ت
أحر	أ ح ر
ايتمر	ا ي ت م ر
نوتي	ن و ت ي
علا	ع ل ا
استؤصلوا	ا س ت ؤ ص ل و ا
صبح	ص ب ح
أنقذتم	أ ن ق ذ ت م
نوقشوا	ن و ق ش و ا
إرادي	إ ر ا د ي
سهوة	س ه و ة
اتخم	ا ت خ م
نشرى	ن ش ر ى
تتفجرن	ت ت ف ج ر ن
رجيت	ر ج ي ت
اصبحن	ا ص ب ح ن
سراديب	س ر ا د ي ب
تسوئين	ت س و ئ ي ن
ميراث	م ي ر ا ث
اباحية	ا ب ا ح ي ة
خابرتم	خ ا ب ر ت م
وافقتم	و ا ف ق ت م
يحملوا	ي ح م ل و ا
جمانة	ج م ا ن ة
اتكئوا	ا ت ك ئ و ا
يقترضن	ي ق ت ر ض ن
تزردون	ت ز ر د و ن
تهاجمين	ت ه ا ج م ي ن
فدرالية	ف د ر ا ل ي ة
جرعتم	ج ر ع ت م
انفعوا	ا ن ف ع و ا
تمرقع	ت م ر ق ع
اعطلوا	ا ع ط ل و ا
أخية	أ خ ي ة
تيسرن	ت ي س ر ن
ترثون	ت ر ث و ن
ضؤنا	ض ؤ ن ا
اقسمن	ا ق س م ن
استذكروا	ا س ت ذ ك ر و ا
مارسوا	م ا ر س و ا
استظهرتم	ا س ت ظ ه ر ت م
تسببن	ت س ب ب ن
اشتط	ا ش ت ط
أنجو	أ ن ج و
أحيلت	أ ح ي ل ت
تأبق	ت أ ب ق
رحلة	ر ح ل ة
يسببوا	ي س ب ب و ا
يفرح	ي ف ر ح
تتوكدون	ت ت و ك د و ن
موعدة	م و ع د ة
يلقين	ي ل ق ي ن
أفاضل	أ ف ا ض ل
يصرخون	ي ص ر خ و ن
أوجرتن	أ و ج ر ت ن
استحسنتن	ا س ت ح س ن ت ن
اسحر	ا س ح ر
لبنى	ل ب ن ى
تسقي	ت س ق ي
آذن	آ ذ ن
نذرتم	ن ذ ر ت م
أحييت	أ ح ي ي ت
تحابب	ت ح ا ب ب
مشرع	م ش ر ع
قروسطي	ق ر و س ط ي
قشتالة	ق ش ت ا ل ة
عطلي	ع ط ل ي
يتسمعن	ي ت س م ع ن
تطاولن	ت ط ا و ل ن
مرزاب	م ر ز ا ب
تفتحت	ت ف ت ح ت
تجمدين	ت ج م د ي ن
أسمينا	أ س م ي ن ا
تقتبلون	ت ق ت ب ل و ن
تتجنبن	ت ت ج ن ب ن
ناس	ن ا س
رششنا	ر ش ش ن ا
وجدوا	و ج د و ا
نزية	ن ز ي ة
فرشت	ف ر ش ت
حضار	ح ض ا ر
تتهودي	ت ت ه و د ي
مضغتم	م ض غ ت م
شكرن	ش ك ر ن
شيلي	ش ي ل ي
أديب	أ د ي ب
هوى	ه و ى
نستخبر	ن س ت خ ب ر
يستكرهن	ي س ت ك ر ه ن
ينهون	ي ن ه و ن
مشكور	م ش ك و ر
دربكات	د ر ب ك ا ت
غلفن	غ ل ف ن
تودعين	ت و د ع ي ن
يشككن	ي ش ك ك ن
يستبدلوا	ي س ت ب د ل و ا
يلوثوا	ي ل و ث و ا
آبيس	آ ب ي س
تفتعلين	ت ف ت ع ل ي ن
شكلي	ش ك ل ي
أفطس	أ ف ط س
تمضغ	ت م ض غ
تروحن	ت ر و ح ن
بكرج	ب ك ر ج
شهرية	ش ه ر ي ة
علوا	ع ل و ا
شخوص	ش خ و ص
تذبحن	ت ذ ب ح ن
احضنوا	ا ح ض ن و ا
مراسلة	م ر ا س ل ة
يحشدن	ي ح ش د ن
خلقيون	خ ل ق ي و ن
نصرن	ن ص ر ن
رفيف	ر ف ي ف
تفرضون	ت ف ر ض و ن
خلبي	خ ل ب ي
اعوجج	ا ع و ج ج
زوفا	ز و ف ا
قيافة	ق ي ا ف ة
استراحوا	ا س ت ر ا ح و ا
بوم	ب و م
زادت	ز ا د ت
نتحسن	ن ت ح س ن
أظلمتن	أ ظ ل م ت ن
طبلوا	ط ب ل و ا
تبتوا	ت ب ت و ا
ثنتين	ث ن ت ي ن
حسستن	ح س س ت ن
أرضينا	أ ر ض ي ن ا
درسن	د ر س ن
فسقية	ف س ق ي ة
تشريط	ت ش ر ي ط
جسدوا	ج س د و ا
مخامرة	م خ ا م ر ة
أعرت	أ ع ر ت
تقررتم	ت ق ر ر ت م
أوقظوا	أ و ق ظ و ا
أصروا	أ ص ر و ا
أحطط	أ ح ط ط
تتجر	ت ت ج ر
اذكرتن	ا ذ ك ر ت ن
تمذهبتم	ت م ذ ه ب ت م
עפרית	ע פ ר י ת
صلوات	ص ل و ا ت
تستأمنوا	ت س ت أ م ن و ا
عقعق	ع ق ع ق
صرع	ص ر ع
جاررن	ج ا ر ر ن
اكشف	ا ك ش ف
أسلحة	أ س ل ح ة
يبسطوا	ي ب س ط و ا
نحاوط	ن ح ا و ط
كليم	ك ل ي م
دفئن	د ف ئ ن
تستعبدن	ت س ت ع ب د ن
أعرج	أ ع ر ج
أناخ	أ ن ا خ
محمدة	م ح م د ة
تؤممين	ت ؤ م م ي ن
زوجي	ز و ج ي
ترتيل	ت ر ت ي ل
مالت	م ا ل ت
ثفر	ث ف ر
سلباح	س ل ب ا ح
يضاجعن	ي ض ا ج ع ن
حسبن	ح س ب ن
يتوافقوا	ي ت و ا ف ق و ا
محيطات	م ح ي ط ا ت
جسرتن	ج س ر ت ن
استعربنا	ا س ت ع ر ب ن ا
بصل	ب ص ل
تستذكرون	ت س ت ذ ك ر و ن
ألغين	أ ل غ ي ن
تعلقتن	ت ع ل ق ت ن
غرغر	غ ر غ ر
روع	ر و ع
حشم	ح ش م
واضح	و ا ض ح
تنبأنا	ت ن ب أ ن ا
اشجعي	ا ش ج ع ي
يتذكرن	ي ت ذ ك ر ن
تجهروا	ت ج ه ر و ا
نحتم	ن ح ت م
يصنفون	ي ص ن ف و ن
سائل	س ا ئ ل
تتبعنا	ت ت ب ع ن ا
تستحضروا	ت س ت ح ض ر و ا
تؤهل	ت ؤ ه ل
أمسكتم	أ م س ك ت م
عجمية	ع ج م ي ة
يقتبل	ي ق ت ب ل
ابتسمتم	ا ب ت س م ت م
تفقسن	ت ف ق س ن
اشفقوا	ا ش ف ق و ا
ييسرن	ي ي س ر ن
يسرنا	ي س ر ن ا
يعزبون	ي ع ز ب و ن
تتهدفوا	ت ت ه د ف و ا
يستمرر	ي س ت م ر ر
ندار	ن د ا ر
قدنا	ق د ن ا
يتوكلوا	ي ت و ك ل و ا
استمررت	ا س ت م ر ر ت
تخولي	ت خ و ل ي
أدل	أ د ل
تتفاضلي	ت ت ف ا ض ل ي
تشتركوا	ت ش ت ر ك و ا
تقصبي	ت ق ص ب ي
مآزق	م آ ز ق
يناروا	ي ن ا ر و ا
ادعيت	ا د ع ي ت
عربوا	ع ر ب و ا
دونمة	د و ن م ة
تستقطب	ت س ت ق ط ب
بصم	ب ص م
يعبدوا	ي ع ب د و ا
وسوسوا	و س و س و ا
تخدرن	ت خ د ر ن
يستمسكوا	ي س ت م س ك و ا
ابتاعي	ا ب ت ا ع ي
تأنى	ت أ ن ى
نل	ن ل
جددت	ج د د ت
تقابلت	ت ق ا ب ل ت
جعبة	ج ع ب ة
تعدمين	ت ع د م ي ن
تصوروا	ت ص و ر و ا
أرهبي	أ ر ه ب ي
ميجنة	م ي ج ن ة
نشرتم	ن ش ر ت م
يقاطعن	ي ق ا ط ع ن
امتثلتن	ا م ت ث ل ت ن
نذبح	ن ذ ب ح
اشرط	ا ش ر ط
يستذكرن	ي س ت ذ ك ر ن
أضفن	أ ض ف ن
أثبر	أ ث ب ر
شخصيون	ش خ ص ي و ن
أوعد	أ و ع د
نمد	ن م د
شاغر	ش ا غ ر
دباغ	د ب ا غ
تنجين	ت ن ج ي ن
ننس	ن ن س
غروى	غ ر و ى
صدرتم	ص د ر ت م
ضؤتم	ض ؤ ت م
أكرهن	أ ك ر ه ن
إسبان	إ س ب ا ن
أودعنا	أ و د ع ن ا
تتقررون	ت ت ق ر ر و ن
تشغفوا	ت ش غ ف و ا
تتحوطي	ت ت ح و ط ي
بطؤ	ب ط ؤ
تحق	ت ح ق
يترافعون	ي ت ر ا ف ع و ن
اقتنعوا	ا ق ت ن ع و ا
استؤني	ا س ت ؤ ن ي
متزمت	م ت ز م ت
ثابرتم	ث ا ب ر ت م
حوولنا	ح و و ل ن ا
احدودبن	ا ح د و د ب ن
انتسبتن	ا ن ت س ب ت ن
تركتن	ت ر ك ت ن
قربى	ق ر ب ى
فاجرة	ف ا ج ر ة
يرزوا	ي ر ز و ا
نتم	ن ت م
نستحم	ن س ت ح م
يدفق	ي د ف ق
تبسرون	ت ب س ر و ن
تجعلن	ت ج ع ل ن
عاميون	ع ا م ي و ن
تستحموا	ت س ت ح م و ا
فهد	ف ه د
يشمس	ي ش م س
ينادين	ي ن ا د ي ن
يمرج	ي م ر ج
أستسر	أ س ت س ر
أبلعت	أ ب ل ع ت
ابنة	ا ب ن ة
نافرتم	ن ا ف ر ت م
صحية	ص ح ي ة
انفدن	ا ن ف د ن
تنقرئوا	ت ن ق ر ئ و ا
تشرعن	ت ش ر ع ن
ترعد	ت ر ع د
تحتوين	ت ح ت و ي ن
عنوا	ع ن و ا
تنصفوا	ت ن ص ف و ا
اهجموا	ا ه ج م و ا
سقي	س ق ي
احرنجمت	ا ح ر ن ج م ت
تصومون	ت ص و م و ن
يتوقوا	ي ت و ق و ا
ترنجان	ت ر ن ج ا ن
تزدوجوا	ت ز د و ج و ا
رففن	ر ف ف ن
مخضار	م خ ض ا ر
تسلخن	ت س ل خ ن
جمد	ج م د
מלך	מ ל ך
تفرون	ت ف ر و ن
ننوم	ن ن و م
رفعن	ر ف ع ن
تفصلي	ت ف ص ل ي
مهذار	م ه ذ ا ر
صليتن	ص ل ي ت ن
حي	ح ي
قامروا	ق ا م ر و ا
تخطفون	ت خ ط ف و ن
الحارث	ا ل ح ا ر ث
دورن	د و ر ن
سممت	س م م ت
افطرن	ا ف ط ر ن
تفحص	ت ف ح ص
ضرورية	ض ر و ر ي ة
استهان	ا س ت ه ا ن
ترفوا	ت ر ف و ا
درنا	د ر ن ا
أظهرنا	أ ظ ه ر ن ا
قاليقلا	ق ا ل ي ق ل ا
دونتم	د و ن ت م
نثأر	ن ث أ ر
تتأممي	ت ت أ م م ي
الحلفاء	ا ل ح ل ف ا ء
دستج	د س ت ج
سحارة	س ح ا ر ة
أسيتون	أ س ي ت و ن
ثملتم	ث م ل ت م
ملئتن	م ل ئ ت ن
يتدمر	ي ت د م ر
ترفعتم	ت ر ف ع ت م
يهبطن	ي ه ب ط ن
شقيق	ش ق ي ق
أظل	أ ظ ل
نيكي	ن ي ك ي
يعمر	ي ع م ر
قدير	ق د ي ر
خمط	خ م ط
اجتمعتم	ا ج ت م ع ت م
بوتسوانا	ب و ت س و ا ن ا
نسكن	ن س ك ن
تدبب	ت د ب ب
ينعقدوا	ي ن ع ق د و ا
جهرتم	ج ه ر ت م
نعاس	ن ع ا س
يستظهروا	ي س ت ظ ه ر و ا
عجيل	ع ج ي ل
تستمعون	ت س ت م ع و ن
تحربن	ت ح ر ب ن
أشخصت	أ ش خ ص ت
أخيفت	أ خ ي ف ت
تجورون	ت ج و ر و ن
تستسرر	ت س ت س ر ر
استنسبي	ا س ت ن س ب ي
تفسقين	ت ف س ق ي ن
يخدش	ي خ د ش
بستوقة	ب س ت و ق ة
تناخ	ت ن ا خ
تعتد	ت ع ت د
تستعدد	ت س ت ع د د
مرتاحة	م ر ت ا ح ة
بريطانيا	ب ر ي ط ا ن ي ا
تغربين	ت غ ر ب ي ن
تزدادون	ت ز د ا د و ن
تكالبتم	ت ك ا ل ب ت م
تعتقدن	ت ع ت ق د ن
برم	ب ر م
أخرنمس	أ خ ر ن م س
وصيد	و ص ي د
يخزنوا	ي خ ز ن و ا
اتسختم	ا ت س خ ت م
يتلامسون	ي ت ل ا م س و ن
يقعون	ي ق ع و ن
تحوطوا	ت ح و ط و ا
يوقعوا	ي و ق ع و ا
قبلا	ق ب ل ا
يمجدون	ي م ج د و ن
اقبح	ا ق ب ح
مشروعة	م ش ر و ع ة
صربي	ص ر ب ي
خربة	خ ر ب ة
يسروع	ي س ر و ع
وزيم	و ز ي م
هضبة	ه ض ب ة
يتصبروا	ي ت ص ب ر و ا
أيمان	أ ي م ا ن
تترجمي	ت ت ر ج م ي
يبكرن	ي ب ك ر ن
تواصلوا	ت و ا ص ل و ا
حيلت	ح ي ل ت
تحادثوا	ت ح ا د ث و ا
يقضبون	ي ق ض ب و ن
يرجو	ي ر ج و
أذكى	أ ذ ك ى
تنصحين	ت ن ص ح ي ن
أسنى	أ س ن ى
أشير	أ ش ي ر
قاتل	ق ا ت ل
تقولون	ت ق و ل و ن
يرتدد	ي ر ت د د
توترين	ت و ت ر ي ن
استغنى	ا س ت غ ن ى
يتشكرن	ي ت ش ك ر ن
تباحثون	ت ب ا ح ث و ن
أدبوا	أ د ب و ا
تعبيرية	ت ع ب ي ر ي ة
توبعت	ت و ب ع ت
تسقطين	ت س ق ط ي ن
تسلطوا	ت س ل ط و ا
عنصلان	ع ن ص ل ا ن
شامبانيا	ش ا م ب ا ن ي ا
أطاعوا	أ ط ا ع و ا
بشرة	ب ش ر ة
ارقد	ا ر ق د
نبارى	ن ب ا ر ى
يجارون	ي ج ا ر و ن
خمل	خ م ل
قصروا	ق ص ر و ا
طارحوا	ط ا ر ح و ا
دنى	د ن ى
تتبوا	ت ت ب و ا
ترب	ت ر ب
ثيوقراطي	ث ي و ق ر ا ط ي
استأجر	ا س ت أ ج ر
انفعلي	ا ن ف ع ل ي
نتحدث	ن ت ح د ث
تبقى	ت ب ق ى
تعكسن	ت ع ك س ن
دأب	د أ ب
يتحاشون	ي ت ح ا ش و ن
يسبحوا	ي س ب ح و ا
سوآء	س و آ ء
ترشي	ت ر ش ي
ثنايا	ث ن ا ي ا
اقرضي	ا ق ر ض ي
عميم	ع م ي م
أطالت	أ ط ا ل ت
أبراد	أ ب ر ا د
اشمأز	ا ش م أ ز
سميط	س م ي ط
تطوول	ت ط و و ل
نشطتم	ن ش ط ت م
تتقابلون	ت ت ق ا ب ل و ن
تحتفل	ت ح ت ف ل
قطبوا	ق ط ب و ا
تبرغشين	ت ب ر غ ش ي ن
يمسكون	ي م س ك و ن
عتمة	ع ت م ة
معنى	م ع ن ى
مفتوحة	م ف ت و ح ة
قابلة	ق ا ب ل ة
زرزر	ز ر ز ر
احفل	ا ح ف ل
ممرضات	م م ر ض ا ت
شعلتن	ش ع ل ت ن
أوقعي	أ و ق ع ي
تنفعلن	ت ن ف ع ل ن
علمانيون	ع ل م ا ن ي و ن
مئتان	م ئ ت ا ن
تخدرون	ت خ د ر و ن
خبيز	خ ب ي ز
بكر	ب ك ر
اكبسوا	ا ك ب س و ا
أخرس	أ خ ر س
حمقى	ح م ق ى
برجمة	ب ر ج م ة
ألعبن	أ ل ع ب ن
يصدون	ي ص د و ن
حودثن	ح و د ث ن
بيضة	ب ي ض ة
غفور	غ ف و ر
تقوتل	ت ق و ت ل
يهجروا	ي ه ج ر و ا
تسجني	ت س ج ن ي
يخوشوا	ي خ و ش و ا
قراصيا	ق ر ا ص ي ا
تلقى	ت ل ق ى
فصحت	ف ص ح ت
تولع	ت و ل ع
فقرن	ف ق ر ن
تعفوا	ت ع ف و ا
يصنف	ي ص ن ف
تنصحي	ت ن ص ح ي
معى	م ع ى
اركضن	ا ر ك ض ن
أطعموا	أ ط ع م و ا
يتحسن	ي ت ح س ن
يعدمن	ي ع د م ن
تستمنين	ت س ت م ن ي ن
تفين	ت ف ي ن
توهبوا	ت و ه ب و ا
تنكصي	ت ن ك ص ي
يتنسر	ي ت ن س ر
حوولوا	ح و و ل و ا
يقرروا	ي ق ر ر و ا
أنرت	أ ن ر ت
يستعربن	ي س ت ع ر ب ن
أوترنا	أ و ت ر ن ا
إزاء	إ ز ا ء
يقبل	ي ق ب ل
تقريبا	ت ق ر ي ب ا
رؤية	ر ؤ ي ة
أهالي	أ ه ا ل ي
متر	م ت ر
رسوم	ر س و م
وجل	و ج ل
أسماء	أ س م ا ء
جميل	ج م ي ل
عينت	ع ي ن ت
حاليا	ح ا ل ي ا
يشير	ي ش ي ر
واقع	و ا ق ع
تتمثل	ت ت م ث ل
مصفاة	م ص ف ا ة
يتصدر	ي ت ص د ر
أوقاف	أ و ق ا ف
يرتب	ي ر ت ب
تعطي	ت ع ط ي
غريب	غ ر ي ب
هنغاريا	ه ن غ ا ر ي ا
أجروا	أ ج ر و ا
جورج	ج و ر ج
صعوبة	ص ع و ب ة
إياك	إ ي ا ك
يحسبون	ي ح س ب و ن
تتدخل	ت ت د خ ل
مبارك	م ب ا ر ك
تجري	ت ج ر ي
القنيطرة	ا ل ق ن ي ط ر ة
بطارية	ب ط ا ر ي ة
يدعم	ي د ع م
شيئا	ش ي ئ ا
قراءات	ق ر ا ء ا ت
نهائي	ن ه ا ئ ي
يقفون	ي ق ف و ن
هاواي	ه ا و ا ي
مدرب	م د ر ب
كي	ك ي
عقيدة	ع ق ي د ة
معول	م ع و ل
تعني	ت ع ن ي
ذاكرة	ذ ا ك ر ة
أسبوعي	أ س ب و ع ي
عهد	ع ه د
بار	ب ا ر
سعد	س ع د
سورة	س و ر ة
مشت	م ش ت
برشلونة	ب ر ش ل و ن ة
اخترت	ا خ ت ر ت
عادل	ع ا د ل
روايات	ر و ا ي ا ت
ليبيا	ل ي ب ي ا
سئل	س ئ ل
حدثت	ح د ث ت
فرد	ف ر د
مساعد	م س ا ع د
تجعل	ت ج ع ل
بشري	ب ش ر ي
سما	س م ا
نجع	ن ج ع
نصيب	ن ص ي ب
نموذج	ن م و ذ ج
إضاعة	إ ض ا ع ة
التهاب	ا ل ت ه ا ب
إجراء	إ ج ر ا ء
يضم	ي ض م
نسمح	ن س م ح
ه	ه
رمل	ر م ل
مهارات	م ه ا ر ا ت
تملك	ت م ل ك
بحرينية	ب ح ر ي ن ي ة
ديناميكا	د ي ن ا م ي ك ا
يؤدوا	ي ؤ د و ا
تحكم	ت ح ك م
استعرض	ا س ت ع ر ض
صفة	ص ف ة
يؤثر	ي ؤ ث ر
يسمح	ي س م ح
سرعة	س ر ع ة
برشلونة	ب ر ش ل و ن ة
صعيد	ص ع ي د
مستقل	م س ت ق ل
حاليا	ح ا ل ي ا
بوسطن	ب و س ط ن
مهارات	م ه ا ر ا ت
سعادة	س ع ا د ة
صلاح	ص ل ا ح
نعم	ن ع م
مياه	م ي ا ه
تدور	ت د و ر
نعم	ن ع م
أسرار	أ س ر ا ر
الأرجنتين	ا ل أ ر ج ن ت ي ن
اليابان	ا ل ي ا ب ا ن
بيني	ب ي ن ي
حفلة	ح ف ل ة
تسلم	ت س ل م
بوتين	ب و ت ي ن
إنسان	إ ن س ا ن
تعرفي	ت ع ر ف ي
نستعمل	ن س ت ع م ل
إزاء	إ ز ا ء
تظهر	ت ظ ه ر
اصل	ا ص ل
تعلق	ت ع ل ق
يساعد	ي س ا ع د
رحمة	ر ح م ة
تحدي	ت ح د ي
ليبيا	ل ي ب ي ا
نعم	ن ع م
متوسط	م ت و س ط
منفصلة	م ن ف ص ل ة
اصبح	ا ص ب ح
نور	ن و ر
اختبار	ا خ ت ب ا ر
مشغول	م ش غ و ل
هنالك	ه ن ا ل ك
مصطفى	م ص ط ف ى
يعقوب	ي ع ق و ب
قتل	ق ت ل
ن	ن
تراجع	ت ر ا ج ع
يستطيع	ي س ت ط ي ع
جاءت	ج ا ء ت
تتساءل	ت ت س ا ء ل
وكيل	و ك ي ل
صحة	ص ح ة
تشكل	ت ش ك ل
غزة	غ ز ة
تشرين	ت ش ر ي ن
تحتوي	ت ح ت و ي
بلاد	ب ل ا د
النار	ا ل ن ا ر
يشعر	ي ش ع ر
أوجه	أ و ج ه
خلفية	خ ل ف ي ة
يتظاهرن	ي ت ظ ا ه ر ن
يعذب	ي ع ذ ب
حدود	ح د و د
ألم	أ ل م
تزيد	ت ز ي د
تراجع	ت ر ا ج ع
جهات	ج ه ا ت
قاطرة	ق ا ط ر ة
رضي	ر ض ي
عنف	ع ن ف
سلطان	س ل ط ا ن
يكاد	ي ك ا د
تحلل	ت ح ل ل
تقيم	ت ق ي م
مقر	م ق ر
تعبير	ت ع ب ي ر
بنت	ب ن ت
الدوحة	ا ل د و ح ة
جورج	ج و ر ج
يجيب	ي ج ي ب
استعمال	ا س ت ع م ا ل
يظهر	ي ظ ه ر
مشهد	م ش ه د
تشترك	ت ش ت ر ك
مكافأة	م ك ا ف أ ة
تمت	ت م ت
يتعاملون	ي ت ع ا م ل و ن
تخفيض	ت خ ف ي ض
عروض	ع ر و ض
محصول	م ح ص و ل
خواتم	خ و ا ت م
يغلق	ي غ ل ق
اعتقال	ا ع ت ق ا ل
سلامة	س ل ا م ة
وكيل	و ك ي ل
تتدخل	ت ت د خ ل
توفر	ت و ف ر
مالك	م ا ل ك
تزيين	ت ز ي ي ن
نطاق	ن ط ا ق
جرى	ج ر ى
أوسع	أ و س ع
مثيرة	م ث ي ر ة
أولي	أ و ل ي
ضرورة	ض ر و ر ة
تفعيل	ت ف ع ي ل
قرب	ق ر ب
يؤدي	ي ؤ د ي
محرر	م ح ر ر
حرج	ح ر ج
مسلسلات	م س ل س ل ا ت
كذب	ك ذ ب
مبيت	م ب ي ت
استغرق	ا س ت غ ر ق
حواشي	ح و ا ش ي
ساخنة	س ا خ ن ة
تعبير	ت ع ب ي ر
لساني	ل س ا ن ي
الدوحة	ا ل د و ح ة
معا	م ع ا
ريم	ر ي م
موقف	م و ق ف
جدة	ج د ة
وقود	و ق و د
برمجة	ب ر م ج ة
مقدار	م ق د ا ر
يباع	ي ب ا ع
رائعة	ر ا ئ ع ة
جامع	ج ا م ع
بلد	ب ل د
أمن	أ م ن
أشياء	أ ش ي ا ء
تخيل	ت خ ي ل
ثابت	ث ا ب ت
الحسن	ا ل ح س ن
غد	غ د
أمن	أ م ن
قريش	ق ر ي ش
تمثيل	ت م ث ي ل
محرك	م ح ر ك
أبى	أ ب ى
أستراليا	أ س ت ر ا ل ي ا
مباريات	م ب ا ر ي ا ت
أعلنت	أ ع ل ن ت
قدمت	ق د م ت
جاءت	ج ا ء ت
لاحظتم	ل ا ح ظ ت م
عقلية	ع ق ل ي ة
تطمئن	ت ط م ئ ن
ضغط	ض غ ط
جماهير	ج م ا ه ي ر
موقف	م و ق ف
سلمان	س ل م ا ن
عهد	ع ه د
منظمة	م ن ظ م ة
تتم	ت ت م
نجوم	ن ج و م
يأخذ	ي أ خ ذ
عصر	ع ص ر
لعنة	ل ع ن ة
مكة	م ك ة
فشل	ف ش ل
حدثنا	ح د ث ن ا
مجالات	م ج ا ل ا ت
أستاذ	أ س ت ا ذ
حفظ	ح ف ظ
منتخب	م ن ت خ ب
يفعل	ي ف ع ل
نجد	ن ج د
فشل	ف ش ل
نتوقف	ن ت و ق ف
تضر	ت ض ر
أرضية	أ ر ض ي ة
شعر	ش ع ر
جودة	ج و د ة
در	د ر
ناد	ن ا د
جمعية	ج م ع ي ة
صنع	ص ن ع
مباريات	م ب ا ر ي ا ت
ألوم	أ ل و م
تحس	ت ح س
ضحية	ض ح ي ة
مخصصات	م خ ص ص ا ت
فئة	ف ئ ة
انقل	ا ن ق ل
مرور	م ر و ر
برق	ب ر ق
تخفيض	ت خ ف ي ض
تمهل	ت م ه ل
نطق	ن ط ق
قيس	ق ي س
يسمح	ي س م ح
شامبو	ش ا م ب و
عادل	ع ا د ل
نصيب	ن ص ي ب
يرتدي	ي ر ت د ي
محل	م ح ل
سقف	س ق ف
أربعة	أ ر ب ع ة
أنابيب	أ ن ا ب ي ب
شاكر	ش ا ك ر
يطفى	ي ط ف ى
يقع	ي ق ع
ميناء	م ي ن ا ء
قرية	ق ر ي ة
مستعمل	م س ت ع م ل
لفيف	ل ف ي ف
يضم	ي ض م
عودة	ع و د ة
قائد	ق ا ئ د
استقبل	ا س ت ق ب ل
سحب	س ح ب
مشاكل	م ش ا ك ل
اختبار	ا خ ت ب ا ر
اليونان	ا ل ي و ن ا ن
فكرة	ف ك ر ة
توجه	ت و ج ه
الأردن	ا ل أ ر د ن
هر	ه ر
اعرف	ا ع ر ف
دوت	د و ت
يورو	ي و ر و
فتنة	ف ت ن ة
كلفة	ك ل ف ة
حان	ح ا ن
رأى	ر أ ى
ضغط	ض غ ط
النار	ا ل ن ا ر
احتياج	ا ح ت ي ا ج
ننتظر	ن ن ت ظ ر
يتوقع	ي ت و ق ع
مسرح	م س ر ح
مكتبة	م ك ت ب ة
نساء	ن س ا ء
حدائق	ح د ا ئ ق
عدا	ع د ا
خط	خ ط
أسرة	أ س ر ة
سحر	س ح ر
عمان	ع م ا ن
اختبار	ا خ ت ب ا ر
منى	م ن ى
أبى	أ ب ى
يصمت	ي ص م ت
سقطت	س ق ط ت
إفريقيا	إ ف ر ي ق ي ا
راحة	ر ا ح ة
رغبة	ر غ ب ة
دقائق	د ق ا ئ ق
بقعة	ب ق ع ة
نظري	ن ظ ر ي
جرى	ج ر ى
اتفاق	ا ت ف ا ق
دفع	د ف ع
يحتوى	ي ح ت و ى
ذكرت	ذ ك ر ت
لغات	ل غ ا ت
زبدة	ز ب د ة
أوربا	أ و ر ب ا
طبي	ط ب ي
ثوب	ث و ب
يجمع	ي ج م ع
ماي	م ا ي
تنمية	ت ن م ي ة
سديم	س د ي م
ممتاز	م م ت ا ز
بنت	ب ن ت
احتمالية	ا ح ت م ا ل ي ة
جعلت	ج ع ل ت
تهتم	ت ه ت م
ديفيد	د ي ف ي د
أمراض	أ م ر ا ض
عالي	ع ا ل ي
جمهورية	ج م ه و ر ي ة
تقول	ت ق و ل
فتاة	ف ت ا ة
نحتاج	ن ح ت ا ج
يستخدم	ي س ت خ د م
أدى	أ د ى
لكي	ل ك ي
خليل	خ ل ي ل
طويلة	ط و ي ل ة
جميل	ج م ي ل
تعني	ت ع ن ي
استقبال	ا س ت ق ب ا ل
طال	ط ا ل
عشق	ع ش ق
أربعة	أ ر ب ع ة
سهم	س ه م
هجرة	ه ج ر ة
صحة	ص ح ة
عالي	ع ا ل ي
رش	ر ش
رمادي	ر م ا د ي
بالفعل	ب ا ل ف ع ل
طائرات	ط ا ئ ر ا ت
خليفة	خ ل ي ف ة
اقرئي	ا ق ر ئ ي
كلية	ك ل ي ة
نرى	ن ر ى
تنزيل	ت ن ز ي ل
تكتب	ت ك ت ب
مرض	م ر ض
يختار	ي خ ت ا ر
خبير	خ ب ي ر
لبنانية	ل ب ن ا ن ي ة
حوادث	ح و ا د ث
دفع	د ف ع
عالمية	ع ا ل م ي ة
غانم	غ ا ن م
اختتم	ا خ ت ت م
اصبح	ا ص ب ح
يابان	ي ا ب ا ن
خط	خ ط
بوابة	ب و ا ب ة
وراء	و ر ا ء
اسود	ا س و د
يحتاجون	ي ح ت ا ج و ن
بأس	ب أ س
مصطفى	م ص ط ف ى
رواتب	ر و ا ت ب
فكرة	ف ك ر ة
محب	م ح ب
قادرة	ق ا د ر ة
سبق	س ب ق
نظم	ن ظ م
الأرجنتين	ا ل أ ر ج ن ت ي ن
علماء	ع ل م ا ء
اتفاق	ا ت ف ا ق
عصر	ع ص ر
اعتراض	ا ع ت ر ا ض
شرط	ش ر ط
ذاتية	ذ ا ت ي ة
أيوب	أ ي و ب
الحوت	ا ل ح و ت
ظلت	ظ ل ت
فضي	ف ض ي
ادوين	ا د و ي ن
مقال	م ق ا ل
صراع	ص ر ا ع
تمتد	ت م ت د
خبير	خ ب ي ر
انسحاب	ا ن س ح ا ب
شروق	ش ر و ق
صالة	ص ا ل ة
تستخدمي	ت س ت خ د م ي
اعتبار	ا ع ت ب ا ر
عائلة	ع ا ئ ل ة
خلق	خ ل ق
سليمان	س ل ي م ا ن
خلق	خ ل ق
مدة	م د ة
تحك	ت ح ك
أنتم	أ ن ت م
حاجة	ح ا ج ة
أوروبا	أ و ر و ب ا
فلسطينية	ف ل س ط ي ن ي ة
يتركن	ي ت ر ك ن
يلتفت	ي ل ت ف ت
بعيدة	ب ع ي د ة
أسامة	أ س ا م ة
حقا	ح ق ا
مواليد	م و ا ل ي د
ورقة	و ر ق ة
أواخر	أ و ا خ ر
جلسة	ج ل س ة
بوابة	ب و ا ب ة
كشف	ك ش ف
حدث	ح د ث
يرموا	ي ر م و ا
فلم	ف ل م
مسار	م س ا ر
شعبنا	ش ع ب ن ا
دخلت	د خ ل ت
دقائق	د ق ا ئ ق
تسلية	ت س ل ي ة
ملابس	م ل ا ب س
سلمان	س ل م ا ن
استمر	ا س ت م ر
ات	ا ت
إسماعيل	إ س م ا ع ي ل
صحيحة	ص ح ي ح ة
حدائق	ح د ا ئ ق
ضباط	ض ب ا ط
يستطيع	ي س ت ط ي ع
ورود	و ر و د
التهاب	ا ل ت ه ا ب
نظر	ن ظ ر
واجبات	و ا ج ب ا ت
سرطان	س ر ط ا ن
تفريغ	ت ف ر ي غ
تفعيل	ت ف ع ي ل
عمرو	ع م ر و
سريعة	س ر ي ع ة
كتبت	ك ت ب ت
يساوي	ي س ا و ي
سيما	س ي م ا
نموذج	ن م و ذ ج
منح	م ن ح
نظمت	ن ظ م ت
عظام	ع ظ ا م
توفر	ت و ف ر
انظر	ا ن ظ ر
آذار	آ ذ ا ر
جنسية	ج ن س ي ة
منجم	م ن ج م
مدح	م د ح
كوم	ك و م
قدمت	ق د م ت
تتكاثر	ت ت ك ا ث ر
عقلية	ع ق ل ي ة
قاسم	ق ا س م
فدية	ف د ي ة
اظهر	ا ظ ه ر
آسيوي	آ س ي و ي
قطرات	ق ط ر ا ت
فساتين	ف س ا ت ي ن
تكنولوجيا	ت ك ن و ل و ج ي ا
تدوير	ت د و ي ر
يهدف	ي ه د ف
دقائق	د ق ا ئ ق
يضم	ي ض م
ظهرت	ظ ه ر ت
وعي	و ع ي
حصل	ح ص ل
مرحلة	م ر ح ل ة
ليبيا	ل ي ب ي ا
صلة	ص ل ة
خططت	خ ط ط ت
إيجاد	إ ي ج ا د
تحتوي	ت ح ت و ي
مواضع	م و ا ض ع
خوان	خ و ا ن
بطل	ب ط ل
إصابات	إ ص ا ب ا ت
ذاتية	ذ ا ت ي ة
وجبة	و ج ب ة
حمراء	ح م ر ا ء
إل	إ ل
عروبة	ع ر و ب ة
جامعات	ج ا م ع ا ت
كندا	ك ن د ا
تأتي	ت أ ت ي
حط	ح ط
أفتح	أ ف ت ح
حدد	ح د د
ألا	أ ل ا
مربع	م ر ب ع
خلفاء	خ ل ف ا ء
السويس	ا ل س و ي س
صبري	ص ب ر ي
برد	ب ر د
إبراهيم	إ ب ر ا ه ي م
البحرين	ا ل ب ح ر ي ن
مالي	م ا ل ي
حقيقية	ح ق ي ق ي ة
صحيح	ص ح ي ح
ِ	ِ
تؤكد	ت ؤ ك د
كي	ك ي
تقف	ت ق ف
ضرورة	ض ر و ر ة
سئل	س ئ ل
منبر	م ن ب ر
سورية	س و ر ي ة
محجر	م ح ج ر
تصب	ت ص ب
يظهر	ي ظ ه ر
حدود	ح د و د
صباح	ص ب ا ح
مجفف	م ج ف ف
مليء	م ل ي ء
عربي	ع ر ب ي
أرسلت	أ ر س ل ت
خطة	خ ط ة
تنظم	ت ن ظ م
مفهوم	م ف ه و م
حرارة	ح ر ا ر ة
يختلف	ي خ ت ل ف
متجر	م ت ج ر
يعقوب	ي ع ق و ب
عاصفة	ع ا ص ف ة
صدر	ص د ر
اول	ا و ل
توقف	ت و ق ف
تحذير	ت ح ذ ي ر
يتخذ	ي ت خ ذ
أجزاء	أ ج ز ا ء
احترام	ا ح ت ر ا م
حريق	ح ر ي ق
عواصم	ع و ا ص م
أموال	أ م و ا ل
رغبة	ر غ ب ة
فهم	ف ه م
صرصار	ص ر ص ا ر
رائعة	ر ا ئ ع ة
لوث	ل و ث
الحركة	ا ل ح ر ك ة
تصريح	ت ص ر ي ح
عشق	ع ش ق
بكين	ب ك ي ن
درزن	د ر ز ن
صباح	ص ب ا ح
ننسحب	ن ن س ح ب
بوتين	ب و ت ي ن
جرح	ج ر ح
الأردن	ا ل أ ر د ن
يقوموا	ي ق و م و ا
النار	ا ل ن ا ر
حلو	ح ل و
نقاط	ن ق ا ط
طائرة	ط ا ئ ر ة
خيار	خ ي ا ر
لقاء	ل ق ا ء
العيون	ا ل ع ي و ن
صفعة	ص ف ع ة
بلغت	ب ل غ ت
مقر	م ق ر
عاطفي	ع ا ط ف ي
تختار	ت خ ت ا ر
لقاء	ل ق ا ء
مهرجان	م ه ر ج ا ن
خاض	خ ا ض
مراقبة	م ر ا ق ب ة
مشاكل	م ش ا ك ل
الحركة	ا ل ح ر ك ة
تركية	ت ر ك ي ة
تابع	ت ا ب ع
قرب	ق ر ب
شؤون	ش ؤ و ن
ثمان	ث م ا ن
سوى	س و ى
صلاح	ص ل ا ح
حلقة	ح ل ق ة
حادث	ح ا د ث
مقص	م ق ص
ماي	م ا ي
فصل	ف ص ل
مالك	م ا ل ك
إجراء	إ ج ر ا ء
خريطة	خ ر ي ط ة
تؤكد	ت ؤ ك د
مرات	م ر ا ت
تامة	ت ا م ة
عربية	ع ر ب ي ة
مشهورة	م ش ه و ر ة
خطاب	خ ط ا ب
سياسية	س ي ا س ي ة
شاهد	ش ا ه د
جدول	ج د و ل
فهم	ف ه م
إبراهيم	إ ب ر ا ه ي م
يبدو	ي ب د و
وراء	و ر ا ء
نظر	ن ظ ر
مؤلف	م ؤ ل ف
يصاب	ي ص ا ب
صيغ	ص ي غ
فرنسي	ف ر ن س ي
نقاط	ن ق ا ط
أسقف	أ س ق ف
تمر	ت م ر
قبة	ق ب ة
رقي	ر ق ي
عسكريون	ع س ك ر ي و ن
أمن	أ م ن
جابر	ج ا ب ر
تشتمل	ت ش ت م ل
نطاق	ن ط ا ق
ظلت	ظ ل ت
وجدت	و ج د ت
بشر	ب ش ر
ذهبت	ذ ه ب ت
حتما	ح ت م ا
سابقة	س ا ب ق ة
تعرض	ت ع ر ض
اجري	ا ج ر ي
اقترب	ا ق ت ر ب
عصرية	ع ص ر ي ة
وعليكم	و ع ل ي ك م
أحضان	أ ح ض ا ن
متطوع	م ت ط و ع
تعلن	ت ع ل ن
دخول	د خ و ل
أعرب	أ ع ر ب
أسواق	أ س و ا ق
ينهي	ي ن ه ي
نهب	ن ه ب
سن	س ن
عمد	ع م د
بان	ب ا ن
اول	ا و ل
جدة	ج د ة
زياد	ز ي ا د
تحدد	ت ح د د
تلبية	ت ل ب ي ة
داخلية	د ا خ ل ي ة
حدود	ح د و د
عزلان	ع ز ل ا ن
مصري	م ص ر ي
تذهب	ت ذ ه ب
مجد	م ج د
نجم	ن ج م
عربي	ع ر ب ي
خطأ	خ ط أ
ترجمة	ت ر ج م ة
يفحش	ي ف ح ش
رجع	ر ج ع
منظمة	م ن ظ م ة
وصلت	و ص ل ت
فهم	ف ه م
ممرض	م م ر ض
مفيدة	م ف ي د ة
نذكر	ن ذ ك ر
قتل	ق ت ل
كشف	ك ش ف
صلصة	ص ل ص ة
أوجه	أ و ج ه
ألا	أ ل ا
بلاد	ب ل ا د
حمراء	ح م ر ا ء
نصر	ن ص ر
دم	د م
دموي	د م و ي
خفيف	خ ف ي ف
لكي	ل ك ي
أعتقد	أ ع ت ق د
قديمة	ق د ي م ة
منظمة	م ن ظ م ة
إعلان	إ ع ل ا ن
دبوس	د ب و س
أمن	أ م ن
اقتصاد	ا ق ت ص ا د
مالك	م ا ل ك
إبريل	إ ب ر ي ل
أعلنت	أ ع ل ن ت
منظمة	م ن ظ م ة
أنابيب	أ ن ا ب ي ب
أعلنت	أ ع ل ن ت
إحصاء	إ ح ص ا ء
افرق	ا ف ر ق
محدث	م ح د ث
خط	خ ط
قنبلة	ق ن ب ل ة
اتصل	ا ت ص ل
محايد	م ح ا ي د
ضم	ض م
مراجعة	م ر ا ج ع ة
تحتج	ت ح ت ج
إسبانية	إ س ب ا ن ي ة
يستعمل	ي س ت ع م ل
يمضين	ي م ض ي ن
تشير	ت ش ي ر
جثمان	ج ث م ا ن
يقضوا	ي ق ض و ا
السرطان	ا ل س ر ط ا ن
مظاهر	م ظ ا ه ر
جدوى	ج د و ى
يقل	ي ق ل
ركاب	ر ك ا ب
عني	ع ن ي
تمتلك	ت م ت ل ك
البحرين	ا ل ب ح ر ي ن
أماكن	أ م ا ك ن
وسيلة	و س ي ل ة
وراء	و ر ا ء
قاسم	ق ا س م
ذهب	ذ ه ب
ليبيا	ل ي ب ي ا
علمت	ع ل م ت
اتصال	ا ت ص ا ل
أبناء	أ ب ن ا ء
مات	م ا ت
أعدى	أ ع د ى
أربع	أ ر ب ع
انو	ا ن و
أعرف	أ ع ر ف
جيب	ج ي ب
مهام	م ه ا م
مرسى	م ر س ى
تجدوا	ت ج د و ا
جرافة	ج ر ا ف ة
طه	ط ه
يرجى	ي ر ج ى
جزء	ج ز ء
بلاد	ب ل ا د
ودى	و د ى
مدافع	م د ا ف ع
مين	م ي ن
باسل	ب ا س ل
تكافؤ	ت ك ا ف ؤ
أرسلت	أ ر س ل ت
ليبيا	ل ي ب ي ا
انفجار	ا ن ف ج ا ر
نا	ن ا
سهولة	س ه و ل ة
شرطي	ش ر ط ي
خلدت	خ ل د ت
يضم	ي ض م
يقولون	ي ق و ل و ن
عصير	ع ص ي ر
عنف	ع ن ف
انعقدت	ا ن ع ق د ت
إبريل	إ ب ر ي ل
سقطت	س ق ط ت
مرض	م ر ض
قرآنية	ق ر آ ن ي ة
متوسط	م ت و س ط
بلغت	ب ل غ ت
عرب	ع ر ب
يحل	ي ح ل
مان	م ا ن
يولي	ي و ل ي
ابحث	ا ب ح ث
منصب	م ن ص ب
مراقب	م ر ا ق ب
معيشة	م ع ي ش ة
ثقة	ث ق ة
مطلوب	م ط ل و ب
أتمنى	أ ت م ن ى
البحرين	ا ل ب ح ر ي ن
تمارس	ت م ا ر س
مضيفة	م ض ي ف ة
سرور	س ر و ر
اعتقد	ا ع ت ق د
كون	ك و ن
طهران	ط ه ر ا ن
فني	ف ن ي
مظهر	م ظ ه ر
نسيت	ن س ي ت
مبلغ	م ب ل غ
سقف	س ق ف
يتابع	ي ت ا ب ع
زرقاء	ز ر ق ا ء
ماليزيا	م ا ل ي ز ي ا
أزيد	أ ز ي د
عاصمة	ع ا ص م ة
معطلة	م ع ط ل ة
خفيفة	خ ف ي ف ة
روح	ر و ح
قائد	ق ا ئ د
معقدة	م ع ق د ة
احتراب	ا ح ت ر ا ب
متى	م ت ى
دفع	د ف ع
فرق	ف ر ق
تعرض	ت ع ر ض
كتبت	ك ت ب ت
إليهم	إ ل ي ه م
وزراء	و ز ر ا ء
كبح	ك ب ح
نسيت	ن س ي ت
أظهرت	أ ظ ه ر ت
نسمح	ن س م ح
سوء	س و ء
رجال	ر ج ا ل
ضرورة	ض ر و ر ة
مربع	م ر ب ع
خطأ	خ ط أ
حاليا	ح ا ل ي ا
ضرورة	ض ر و ر ة
منشئ	م ن ش ئ
فرض	ف ر ض
أرجو	أ ر ج و
مشروب	م ش ر و ب
تواصل	ت و ا ص ل
أنبوب	أ ن ب و ب
سجين	س ج ي ن
فرقة	ف ر ق ة
يصرفوا	ي ص ر ف و ا
تظل	ت ظ ل
تكاد	ت ك ا د
صلاح	ص ل ا ح
استعمال	ا س ت ع م ا ل
جزئي	ج ز ئ ي
سماعة	س م ا ع ة
عامر	ع ا م ر
ألا	أ ل ا
معرفة	م ع ر ف ة
عميد	ع م ي د
محركات	م ح ر ك ا ت
اعتقد	ا ع ت ق د
أنحاء	أ ن ح ا ء
مسلسلات	م س ل س ل ا ت
جيب	ج ي ب
اعتمد	ا ع ت م د
مرتين	م ر ت ي ن
نسخ	ن س خ
إقامة	إ ق ا م ة
سرعة	س ر ع ة
إيجاد	إ ي ج ا د
خ	خ
تخدم	ت خ د م
مقر	م ق ر
يطرح	ي ط ر ح
عاصمة	ع ا ص م ة
اتفاقية	ا ت ف ا ق ي ة
قيام	ق ي ا م
أنفق	أ ن ف ق
مقبل	م ق ب ل
يسمح	ي س م ح
خطة	خ ط ة
جميل	ج م ي ل
عنصر	ع ن ص ر
عناوين	ع ن ا و ي ن
مزمن	م ز م ن
ضغط	ض غ ط
رؤساء	ر ؤ س ا ء
نقاش	ن ق ا ش
تحتوي	ت ح ت و ي
رن	ر ن
شركاء	ش ر ك ا ء
منهج	م ن ه ج
عمان	ع م ا ن
جريئة	ج ر ي ئ ة
تخيل	ت خ ي ل
كلية	ك ل ي ة
طار	ط ا ر
يجوز	ي ج و ز
يدري	ي د ر ي
مسكنا	م س ك ن ا
استعمال	ا س ت ع م ا ل
إلخ	إ ل خ
جاذبة	ج ا ذ ب ة
اليابان	ا ل ي ا ب ا ن
شكر	ش ك ر
يغلف	ي غ ل ف
يقو	ي ق و
أدى	أ د ى
رائعة	ر ا ئ ع ة
مشنقة	م ش ن ق ة
يكتب	ي ك ت ب
تخطى	ت خ ط ى
غلاف	غ ل ا ف
خارجية	خ ا ر ج ي ة
إبراهيم	إ ب ر ا ه ي م
تهم	ت ه م
متأخر	م ت أ خ ر
خليفة	خ ل ي ف ة
اقرأ	ا ق ر أ
أين	أ ي ن
تحلل	ت ح ل ل
تؤدي	ت ؤ د ي
إصدار	إ ص د ا ر
صندوق	ص ن د و ق
تدور	ت د و ر
شقيقة	ش ق ي ق ة
نسو	ن س و
غرف	غ ر ف
معاداة	م ع ا د ا ة
استمارة	ا س ت م ا ر ة
يقدم	ي ق د م
أينما	أ ي ن م ا
شهود	ش ه و د
قصدوا	ق ص د و ا
حصة	ح ص ة
يقاوم	ي ق ا و م
دفاع	د ف ا ع
رزق	ر ز ق
سليمة	س ل ي م ة
قبول	ق ب و ل
يستحقون	ي س ت ح ق و ن
ثابتة	ث ا ب ت ة
نتج	ن ت ج
فادي	ف ا د ي
فساتين	ف س ا ت ي ن
سنية	س ن ي ة
فلم	ف ل م
أصوات	أ ص و ا ت
فلم	ف ل م
نور	ن و ر
حدثت	ح د ث ت
مقر	م ق ر
أصدرت	أ ص د ر ت
سيارات	س ي ا ر ا ت
تكرار	ت ك ر ا ر
إلقاء	إ ل ق ا ء
إنما	إ ن م ا
مؤتمرات	م ؤ ت م ر ا ت
يورو	ي و ر و
أفلس	أ ف ل س
المرء	ا ل م ر ء
ذهاب	ذ ه ا ب
مبلغ	م ب ل غ
عماني	ع م ا ن ي
يخذل	ي خ ذ ل
عمان	ع م ا ن
اكذب	ا ك ذ ب
مبعوث	م ب ع و ث
اول	ا و ل
مسلية	م س ل ي ة
أوروبا	أ و ر و ب ا
رضي	ر ض ي
نظر	ن ظ ر
يف	ي ف
قليل	ق ل ي ل
جزء	ج ز ء
مساعدات	م س ا ع د ا ت
جو	ج و
اتخاذ	ا ت خ ا ذ
أسماك	أ س م ا ك
حزر	ح ز ر
تعطي	ت ع ط ي
قفازات	ق ف ا ز ا ت
هامة	ه ا م ة
مجلة	م ج ل ة
إله	إ ل ه
رابطة	ر ا ب ط ة
فلم	ف ل م
معالم	م ع ا ل م
وطنية	و ط ن ي ة
ترحيب	ت ر ح ي ب
اعتقال	ا ع ت ق ا ل
تكتب	ت ك ت ب
أماكن	أ م ا ك ن
إصرار	إ ص ر ا ر
آن	آ ن
صحة	ص ح ة
عز	ع ز
نسيت	ن س ي ت
يضم	ي ض م
سلطان	س ل ط ا ن
رائع	ر ا ئ ع
صمام	ص م ا م
حمامات	ح م ا م ا ت
مياه	م ي ا ه
مترجمة	م ت ر ج م ة
بنا	ب ن ا
طلسم	ط ل س م
يلي	ي ل ي
إنتاج	إ ن ت ا ج
حركات	ح ر ك ا ت
قوم	ق و م
باشا	ب ا ش ا
رأوا	ر أ و ا
طوال	ط و ا ل
يجوز	ي ج و ز
تسويق	ت س و ي ق
تفادي	ت ف ا د ي
واثق	و ا ث ق
حزيران	ح ز ي ر ا ن
تشرين	ت ش ر ي ن
نجوم	ن ج و م
أجمل	أ ج م ل
كون	ك و ن
سراح	س ر ا ح
ترسل	ت ر س ل
يخالف	ي خ ا ل ف
قفل	ق ف ل
سبق	س ب ق
شخصيا	ش خ ص ي ا
تحفظي	ت ح ف ظ ي
منوعة	م ن و ع ة
إياب	إ ي ا ب
حضرتك	ح ض ر ت ك
الأبناء	ا ل أ ب ن ا ء
موقف	م و ق ف
شفط	ش ف ط
جاز	ج ا ز
اتخاذ	ا ت خ ا ذ
ناوي	ن ا و ي
ترسم	ت ر س م
فتنة	ف ت ن ة
محام	م ح ا م
موعد	م و ع د
يجوز	ي ج و ز
جبل	ج ب ل
نظر	ن ظ ر
حاق	ح ا ق
يجري	ي ج ر ي
تراجع	ت ر ا ج ع
تسلق	ت س ل ق
نوقشت	ن و ق ش ت
شبه	ش ب ه
مالك	م ا ل ك
تشرك	ت ش ر ك
حدد	ح د د
مربع	م ر ب ع
حلقة	ح ل ق ة
مهرجان	م ه ر ج ا ن
صفحات	ص ف ح ا ت
تقضي	ت ق ض ي
تحافظ	ت ح ا ف ظ
محكمة	م ح ك م ة
تنشط	ت ن ش ط
ندخل	ن د خ ل
فصل	ف ص ل
شاشة	ش ا ش ة
شاهد	ش ا ه د
يساعد	ي س ا ع د
أنمي	أ ن م ي
تطل	ت ط ل
حضارة	ح ض ا ر ة
فقراء	ف ق ر ا ء
سيل	س ي ل
نجم	ن ج م
ذرية	ذ ر ي ة
أعلنت	أ ع ل ن ت
القاعدة	ا ل ق ا ع د ة
النيل	ا ل ن ي ل
رفضوا	ر ف ض و ا
تعاقد	ت ع ا ق د
حنينا	ح ن ي ن ا
نموذج	ن م و ذ ج
يجيب	ي ج ي ب
ينضم	ي ن ض م
يبلغ	ي ب ل غ
مبلغ	م ب ل غ
تعلن	ت ع ل ن
يعبر	ي ع ب ر
إياه	إ ي ا ه
تعرض	ت ع ر ض
إحباط	إ ح ب ا ط
إصدار	إ ص د ا ر
قيادة	ق ي ا د ة
مار	م ا ر
توظيف	ت و ظ ي ف
كاتب	ك ا ت ب
شوارع	ش و ا ر ع
يشرع	ي ش ر ع
مالك	م ا ل ك
تؤكد	ت ؤ ك د
خصت	خ ص ت
عروض	ع ر و ض
يتحدث	ي ت ح د ث
قتلة	ق ت ل ة
فنية	ف ن ي ة
أصبت	أ ص ب ت
طوال	ط و ا ل
انتشار	ا ن ت ش ا ر
حشد	ح ش د
يقدم	ي ق د م
عمرو	ع م ر و
أوائل	أ و ا ئ ل
فصل	ف ص ل
سهل	س ه ل
برميل	ب ر م ي ل
إماراتي	إ م ا ر ا ت ي
نفر	ن ف ر
سياسة	س ي ا س ة
شاكر	ش ا ك ر
توجيه	ت و ج ي ه
فشل	ف ش ل
النار	ا ل ن ا ر
أجمل	أ ج م ل
حفل	ح ف ل
دولارات	د و ل ا ر ا ت
سكنى	س ك ن ى
منقول	م ن ق و ل
بان	ب ا ن
مقال	م ق ا ل
لسان	ل س ا ن
تسلم	ت س ل م
تجري	ت ج ر ي
نسخ	ن س خ
تجعل	ت ج ع ل
قروض	ق ر و ض
بجل	ب ج ل
أفرض	أ ف ر ض
ربيع	ر ب ي ع
تأمين	ت أ م ي ن
شاشة	ش ا ش ة
غرف	غ ر ف
قدمت	ق د م ت
خرائط	خ ر ا ئ ط
ريشة	ر ي ش ة
زبدة	ز ب د ة
طقس	ط ق س
عيون	ع ي و ن
دوام	د و ا م
خفيفة	خ ف ي ف ة
تشكيل	ت ش ك ي ل
مشاريع	م ش ا ر ي ع
رحمة	ر ح م ة
تجميع	ت ج م ي ع
سيما	س ي م ا
يلي	ي ل ي
خادم	خ ا د م
منى	م ن ى
نسأل	ن س أ ل
علمي	ع ل م ي
زكاة	ز ك ا ة
راشد	ر ا ش د
محكمة	م ح ك م ة
تواصل	ت و ا ص ل
متوسطة	م ت و س ط ة
يختار	ي خ ت ا ر
رياسة	ر ي ا س ة
مسجد	م س ج د
بجد	ب ج د
عمرو	ع م ر و
إ	إ
اثنتين	ا ث ن ت ي ن
مخيم	م خ ي م
رباط	ر ب ا ط
قريبة	ق ر ي ب ة
اكتشف	ا ك ت ش ف
مكتوب	م ك ت و ب
بعيد	ب ع ي د
تتغير	ت ت غ ي ر
تقع	ت ق ع
وطنية	و ط ن ي ة
جل	ج ل
صحي	ص ح ي
نجوت	ن ج و ت
اتفاق	ا ت ف ا ق
غالب	غ ا ل ب
الأمين	ا ل أ م ي ن
يحاولون	ي ح ا و ل و ن
رؤوس	ر ؤ و س
أغلب	أ غ ل ب
قاموس	ق ا م و س
ينشغلون	ي ن ش غ ل و ن
بولس	ب و ل س
أخذت	أ خ ذ ت
النار	ا ل ن ا ر
عل	ع ل
حلقة	ح ل ق ة
بدء	ب د ء
ألا	أ ل ا
امرأة	ا م ر أ ة
تصريح	ت ص ر ي ح
حصة	ح ص ة
تأليف	ت أ ل ي ف
تركنا	ت ر ك ن ا
متميزة	م ت م ي ز ة
مراقبة	م ر ا ق ب ة
يريدون	ي ر ي د و ن
تعني	ت ع ن ي
غريبة	غ ر ي ب ة
نفسي	ن ف س ي
تقنع	ت ق ن ع
نستقبل	ن س ت ق ب ل
تسير	ت س ي ر
توصيل	ت و ص ي ل
عسكرية	ع س ك ر ي ة
حيال	ح ي ا ل
وصفة	و ص ف ة
تأمين	ت أ م ي ن
حجز	ح ج ز
أوبرا	أ و ب ر ا
معاني	م ع ا ن ي
قوائم	ق و ا ئ م
محل	م ح ل
حققت	ح ق ق ت
ذاتية	ذ ا ت ي ة
دفع	د ف ع
يشكل	ي ش ك ل
إبراهيم	إ ب ر ا ه ي م
ملاحظات	م ل ا ح ظ ا ت
عرب	ع ر ب
يستطيع	ي س ت ط ي ع
اقتضت	ا ق ت ض ت
رباط	ر ب ا ط
لوحة	ل و ح ة
ضيق	ض ي ق
يقل	ي ق ل
نونا	ن و ن ا
هيئات	ه ي ئ ا ت
تفوق	ت ف و ق
مراكز	م ر ا ك ز
كذب	ك ذ ب
تصريح	ت ص ر ي ح
حواء	ح و ا ء
بدء	ب د ء
يحكو	ي ح ك و
اشرف	ا ش ر ف
صمام	ص م ا م
خط	خ ط
تركية	ت ر ك ي ة
يهاجم	ي ه ا ج م
عمرو	ع م ر و
رسم	ر س م
موقف	م و ق ف
أزمة	أ ز م ة
عائلة	ع ا ئ ل ة
مني	م ن ي
تركت	ت ر ك ت
فرحت	ف ر ح ت
تتحسن	ت ت ح س ن
امرأة	ا م ر أ ة
جو	ج و
غبب	غ ب ب
مسلمة	م س ل م ة
شارب	ش ا ر ب
يفيد	ي ف ي د
ظاهر	ظ ا ه ر
نسمح	ن س م ح
إطلاق	إ ط ل ا ق
عربية	ع ر ب ي ة
مد	م د
كاتب	ك ا ت ب
سمية	س م ي ة
الشيعة	ا ل ش ي ع ة
يساعد	ي س ا ع د
توليد	ت و ل ي د
مالي	م ا ل ي
حدث	ح د ث
تزال	ت ز ا ل
ستة	س ت ة
حقير	ح ق ي ر
متعة	م ت ع ة
كابل	ك ا ب ل
استعمال	ا س ت ع م ا ل
رائعة	ر ا ئ ع ة
شهيرة	ش ه ي ر ة
سريع	س ر ي ع
نجد	ن ج د
بنك	ب ن ك
رأى	ر أ ى
شحم	ش ح م
مخالف	م خ ا ل ف
عدن	ع د ن
عهد	ع ه د
توجه	ت و ج ه
جمهورية	ج م ه و ر ي ة
يدعم	ي د ع م
سعوا	س ع و ا
بعلبك	ب ع ل ب ك
ضرورة	ض ر و ر ة
تنفذ	ت ن ف ذ
عمري	ع م ر ي
تلحق	ت ل ح ق
جنرال	ج ن ر ا ل
صنع	ص ن ع
قشعريرة	ق ش ع ر ي ر ة
مئة	م ئ ة
صلاة	ص ل ا ة
تعارف	ت ع ا ر ف
حرارة	ح ر ا ر ة
مؤتمر	م ؤ ت م ر
فيروس	ف ي ر و س
يزعمون	ي ز ع م و ن
نفوذ	ن ف و ذ
شرق	ش ر ق
تحرير	ت ح ر ي ر
تفسير	ت ف س ي ر
ذكية	ذ ك ي ة
تضمين	ت ض م ي ن
رفعت	ر ف ع ت
مطران	م ط ر ا ن
الرحمن	ا ل ر ح م ن
متميزة	م ت م ي ز ة
ضيق	ض ي ق
راقي	ر ا ق ي
عيون	ع ي و ن
محكمة	م ح ك م ة
رائع	ر ا ئ ع
توزيع	ت و ز ي ع
مفاجأة	م ف ا ج أ ة
نقاط	ن ق ا ط
نومنا	ن و م ن ا
أجمل	أ ج م ل
تسير	ت س ي ر
جاءت	ج ا ء ت
أقصى	أ ق ص ى
إصرار	إ ص ر ا ر
تحيا	ت ح ي ا
بنك	ب ن ك
هامة	ه ا م ة
وراء	و ر ا ء
حفظ	ح ف ظ
مني	م ن ي
مقفولة	م ق ف و ل ة
خلق	خ ل ق
متر	م ت ر
حمد	ح م د
آراء	آ ر ا ء
المسيح	ا ل م س ي ح
صيف	ص ي ف
أفكار	أ ف ك ا ر
نفى	ن ف ى
ممارسة	م م ا ر س ة
يستفيد	ي س ت ف ي د
يقرب	ي ق ر ب
اكتشاف	ا ك ت ش ا ف
تؤدي	ت ؤ د ي
زاوية	ز ا و ي ة
صندوق	ص ن د و ق
حاليا	ح ا ل ي ا
يسخر	ي س خ ر
دولية	د و ل ي ة
قضايا	ق ض ا ي ا
حقائق	ح ق ا ئ ق
السرطان	ا ل س ر ط ا ن
حفل	ح ف ل
أبطال	أ ب ط ا ل
يدخل	ي د خ ل
تمكنوا	ت م ك ن و ا
يسبب	ي س ب ب
ادخل	ا د خ ل
شبكات	ش ب ك ا ت
فكرة	ف ك ر ة
جلب	ج ل ب
صدمة	ص د م ة
حقائق	ح ق ا ئ ق
ذل	ذ ل
رسائل	ر س ا ئ ل
مكة	م ك ة
ظلم	ظ ل م
مبنى	م ب ن ى
حنة	ح ن ة
أمة	أ م ة
حدود	ح د و د
مسقط	م س ق ط
انتحاري	ا ن ت ح ا ر ي
طال	ط ا ل
تنقذ	ت ن ق ذ
وطنية	و ط ن ي ة
نجحت	ن ج ح ت
يجوز	ي ج و ز
نجوم	ن ج و م
يكتب	ي ك ت ب
يرفع	ي ر ف ع
سواد	س و ا د
نعمل	ن ع م ل
معركة	م ع ر ك ة
اشهدوا	ا ش ه د و ا
سياق	س ي ا ق
رؤساء	ر ؤ س ا ء
شحن	ش ح ن
قدمت	ق د م ت
الأساطير	ا ل أ س ا ط ي ر
منازل	م ن ا ز ل
ممارسة	م م ا ر س ة
كاد	ك ا د
انتخابات	ا ن ت خ ا ب ا ت
ملف	م ل ف
حشرة	ح ش ر ة
زمان	ز م ا ن
تشغيل	ت ش غ ي ل
ضرب	ض ر ب
معرفة	م ع ر ف ة
ملابس	م ل ا ب س
حدث	ح د ث
ضحايا	ض ح ا ي ا
أماكن	أ م ا ك ن
كلية	ك ل ي ة
ثقة	ث ق ة
تماما	ت م ا م ا
آذار	آ ذ ا ر
يمثلون	ي م ث ل و ن
أمن	أ م ن
اسبانيا	ا س ب ا ن ي ا
عين	ع ي ن
كبرى	ك ب ر ى
عاشت	ع ا ش ت
مكة	م ك ة
إله	إ ل ه
تراجع	ت ر ا ج ع
يعقوب	ي ع ق و ب
أشرطة	أ ش ر ط ة
أقدام	أ ق د ا م
ذهب	ذ ه ب
اضافة	ا ض ا ف ة
دوري	د و ر ي
جودة	ج و د ة
أمين	أ م ي ن
خيار	خ ي ا ر
مرض	م ر ض
عماني	ع م ا ن ي
جري	ج ر ي
بينيت	ب ي ن ي ت
مساح	م س ا ح
تبيع	ت ب ي ع
اسمح	ا س م ح
نمط	ن م ط
محاور	م ح ا و ر
كوم	ك و م
كنيسة	ك ن ي س ة
يسوع	ي س و ع
أقول	أ ق و ل
يحاول	ي ح ا و ل
هام	ه ا م
مضحكة	م ض ح ك ة
مرت	م ر ت
أشكر	أ ش ك ر
خليفة	خ ل ي ف ة
انعكس	ا ن ع ك س
أضاع	أ ض ا ع
حضرموت	ح ض ر م و ت
فكرة	ف ك ر ة
وصول	و ص و ل
كبرى	ك ب ر ى
السفن	ا ل س ف ن
مراقبة	م ر ا ق ب ة
اقرأ	ا ق ر أ
يفضل	ي ف ض ل
أكاد	أ ك ا د
إدخال	إ د خ ا ل
بلال	ب ل ا ل
مبارك	م ب ا ر ك
سألتم	س أ ل ت م
سعد	س ع د
خلفية	خ ل ف ي ة
نقاط	ن ق ا ط
معهد	م ع ه د
مدرسة	م د ر س ة
سوى	س و ى
يطلق	ي ط ل ق
علوم	ع ل و م
مفاجأة	م ف ا ج أ ة
سقوط	س ق و ط
اختبار	ا خ ت ب ا ر
جسدت	ج س د ت
يسعد	ي س ع د
أجزاء	أ ج ز ا ء
حقائق	ح ق ا ئ ق
تقارير	ت ق ا ر ي ر
شوارع	ش و ا ر ع
يقرؤون	ي ق ر ؤ و ن
خط	خ ط
ننسي	ن ن س ي
إبلاغ	إ ب ل ا غ
تمارس	ت م ا ر س
حدة	ح د ة
أخر	أ خ ر
البحرين	ا ل ب ح ر ي ن
دوافع	د و ا ف ع
إسلامية	إ س ل ا م ي ة
قرارات	ق ر ا ر ا ت
مسجد	م س ج د
شمعة	ش م ع ة
تمتلك	ت م ت ل ك
هيثم	ه ي ث م
قلوب	ق ل و ب
داعش	د ا ع ش
تقع	ت ق ع
أخيرا	أ خ ي ر ا
حولي	ح و ل ي
سال	س ا ل
صدمة	ص د م ة
فلم	ف ل م
تشاهد	ت ش ا ه د
أقسام	أ ق س ا م
يعبر	ي ع ب ر
قلبت	ق ل ب ت
محجر	م ح ج ر
مكة	م ك ة
حصل	ح ص ل
شي	ش ي
فخورة	ف خ و ر ة
يوفر	ي و ف ر
معهد	م ع ه د
اقترحت	ا ق ت ر ح ت
جزئي	ج ز ئ ي
قرية	ق ر ي ة
حقيقي	ح ق ي ق ي
سيما	س ي م ا
خيار	خ ي ا ر
إبراهيم	إ ب ر ا ه ي م
منشأة	م ن ش أ ة
أدى	أ د ى
أجمل	أ ج م ل
قراءات	ق ر ا ء ا ت
تقيم	ت ق ي م
منظر	م ن ظ ر
إبراهيم	إ ب ر ا ه ي م
علمي	ع ل م ي
اجتماعية	ا ج ت م ا ع ي ة
أف	أ ف
قريش	ق ر ي ش
اتخاذ	ا ت خ ا ذ
شيخ	ش ي خ
تعبير	ت ع ب ي ر
يوقع	ي و ق ع
سمك	س م ك
إليهم	إ ل ي ه م
نراجع	ن ر ا ج ع
أسرع	أ س ر ع
تدهور	ت د ه و ر
مبين	م ب ي ن
أحسن	أ ح س ن
حادث	ح ا د ث
تسلم	ت س ل م
بان	ب ا ن
النار	ا ل ن ا ر
كلية	ك ل ي ة
تهاني	ت ه ا ن ي
تغريدة	ت غ ر ي د ة
استبدال	ا س ت ب د ا ل
حدث	ح د ث
الشام	ا ل ش ا م
رياضة	ر ي ا ض ة
استعمال	ا س ت ع م ا ل
تقول	ت ق و ل
زلفى	ز ل ف ى
يأخذ	ي أ خ ذ
رسوم	ر س و م
مراكز	م ر ا ك ز
نفع	ن ف ع
يقبض	ي ق ب ض
أخاف	أ خ ا ف
عوامل	ع و ا م ل
إزالة	إ ز ا ل ة
فولت	ف و ل ت
اول	ا و ل
أعلنت	أ ع ل ن ت
سلامة	س ل ا م ة
عامر	ع ا م ر
شهادات	ش ه ا د ا ت
امتدت	ا م ت د ت
صحة	ص ح ة
لبى	ل ب ى
غرف	غ ر ف
أنقذت	أ ن ق ذ ت
يزيد	ي ز ي د
أراد	أ ر ا د
رينت	ر ي ن ت
شديد	ش د ي د
مشاكل	م ش ا ك ل
عز	ع ز
معارف	م ع ا ر ف
توزيع	ت و ز ي ع
تعطي	ت ع ط ي
صدر	ص د ر
زوايا	ز و ا ي ا
أغلقت	أ غ ل ق ت
تقام	ت ق ا م
إسلامية	إ س ل ا م ي ة
معا	م ع ا
يمارسون	ي م ا ر س و ن
يشهد	ي ش ه د
يحاول	ي ح ا و ل
جهد	ج ه د
عراقية	ع ر ا ق ي ة
أمي	أ م ي
الجزيرة	ا ل ج ز ي ر ة
ضم	ض م
مياه	م ي ا ه
شي	ش ي
لاسلكي	ل ا س ل ك ي
هيبة	ه ي ب ة
استقبل	ا س ت ق ب ل
وافق	و ا ف ق
سليمان	س ل ي م ا ن
تتخذ	ت ت خ ذ
اتخاذ	ا ت خ ا ذ
طه	ط ه
اسرائيل	ا س ر ا ئ ي ل
مرتفع	م ر ت ف ع
مرات	م ر ا ت
شرم	ش ر م
مفهوم	م ف ه و م
يأخذ	ي أ خ ذ
عدل	ع د ل
تخضع	ت خ ض ع
شكر	ش ك ر
أصحاب	أ ص ح ا ب
زهرة	ز ه ر ة
خان	خ ا ن
محاور	م ح ا و ر
أبدى	أ ب د ى
دورة	د و ر ة
نابلس	ن ا ب ل س
أجنحة	أ ج ن ح ة
يسير	ي س ي ر
جملة	ج م ل ة
مضى	م ض ى
ينصح	ي ن ص ح
نموذج	ن م و ذ ج
تنزيل	ت ن ز ي ل
متر	م ت ر
صرح	ص ر ح
أسماء	أ س م ا ء
اتفاقية	ا ت ف ا ق ي ة
يدعون	ي د ع و ن
سطح	س ط ح
طلوع	ط ل و ع
زينب	ز ي ن ب
دفع	د ف ع
ضرورة	ض ر و ر ة
يحملون	ي ح م ل و ن
يمر	ي م ر
الرباط	ا ل ر ب ا ط
تماما	ت م ا م ا
يحتاج	ي ح ت ا ج
عائلة	ع ا ئ ل ة
شروط	ش ر و ط
كرم	ك ر م
ذو	ذ و
لوحة	ل و ح ة
احترام	ا ح ت ر ا م
مباريات	م ب ا ر ي ا ت
حررت	ح ر ر ت
محرك	م ح ر ك
أوصى	أ و ص ى
عالمي	ع ا ل م ي
تتغير	ت ت غ ي ر
موقف	م و ق ف
اتخاذ	ا ت خ ا ذ
تتعرفين	ت ت ع ر ف ي ن
أتعب	أ ت ع ب
زائر	ز ا ئ ر
تلف	ت ل ف
أزال	أ ز ا ل
غور	غ و ر
رؤساء	ر ؤ س ا ء
أواخر	أ و ا خ ر
عدل	ع د ل
يفعلون	ي ف ع ل و ن
تنجح	ت ن ج ح
عهد	ع ه د
إصدار	إ ص د ا ر
صندوق	ص ن د و ق
مدرسة	م د ر س ة
ذكور	ذ ك و ر
ذهب	ذ ه ب
انطباع	ا ن ط ب ا ع
كون	ك و ن
مجفف	م ج ف ف
يشار	ي ش ا ر
ينفد	ي ن ف د
أثر	أ ث ر
دخول	د خ و ل
سيدني	س ي د ن ي
يزيد	ي ز ي د
يكذب	ي ك ذ ب
عادل	ع ا د ل
منظمة	م ن ظ م ة
شر	ش ر
تحليل	ت ح ل ي ل
كلم	ك ل م
احترام	ا ح ت ر ا م
جبل	ج ب ل
تابع	ت ا ب ع
يبعث	ي ب ع ث
مواسم	م و ا س م
شديد	ش د ي د
أبحاث	أ ب ح ا ث
أدى	أ د ى
إنتاج	إ ن ت ا ج
ودى	و د ى
شن	ش ن
عشرات	ع ش ر ا ت
خلق	خ ل ق
صلاح	ص ل ا ح
احصل	ا ح ص ل
تحتوي	ت ح ت و ي
يعقوب	ي ع ق و ب
شيئا	ش ي ئ ا
خطة	خ ط ة
تسقط	ت س ق ط
للغاية	ل ل غ ا ي ة
عاشت	ع ا ش ت
الرباط	ا ل ر ب ا ط
الشمس	ا ل ش م س
يشعرون	ي ش ع ر و ن
جون	ج و ن
يطلق	ي ط ل ق
طويلة	ط و ي ل ة
مهارات	م ه ا ر ا ت
كذا	ك ذ ا
تشرين	ت ش ر ي ن
صنع	ص ن ع
ميشال	م ي ش ا ل
خلق	خ ل ق
يبعد	ي ب ع د
مطلوب	م ط ل و ب
دفاع	د ف ا ع
فرس	ف ر س
سلطوية	س ل ط و ي ة
عسل	ع س ل
مسرح	م س ر ح
ذهب	ذ ه ب
محل	م ح ل
تعرض	ت ع ر ض
أقاليم	أ ق ا ل ي م
متجر	م ت ج ر
كلما	ك ل م ا
صدر	ص د ر
متعددة	م ت ع د د ة
شاشة	ش ا ش ة
صدور	ص د و ر
كيفن	ك ي ف ن
تختلف	ت خ ت ل ف
يستسلم	ي س ت س ل م
باشا	ب ا ش ا
مرحلة	م ر ح ل ة
إليكم	إ ل ي ك م
نخاع	ن خ ا ع
ذهب	ذ ه ب
متعددة	م ت ع د د ة
مرض	م ر ض
داعش	د ا ع ش
حفل	ح ف ل
فرض	ف ر ض
أصل	أ ص ل
تذهب	ت ذ ه ب
برودة	ب ر و د ة
متى	م ت ى
ثبات	ث ب ا ت
إله	إ ل ه
أسواق	أ س و ا ق
أغلقت	أ غ ل ق ت
ملال	م ل ا ل
هذي	ه ذ ي
جم	ج م
ياسمين	ي ا س م ي ن
تأليف	ت أ ل ي ف
يبحثون	ي ب ح ث و ن
ترد	ت ر د
سلطة	س ل ط ة
طيران	ط ي ر ا ن
ترسم	ت ر س م
ارض	ا ر ض
جود	ج و د
أمانة	أ م ا ن ة
كفاية	ك ف ا ي ة
عالي	ع ا ل ي
حجي	ح ج ي
إصابات	إ ص ا ب ا ت
أنس	أ ن س
خفق	خ ف ق
نحاول	ن ح ا و ل
طائرة	ط ا ئ ر ة
مخالفة	م خ ا ل ف ة
فيروس	ف ي ر و س
رضي	ر ض ي
بسيط	ب س ي ط
بوصلة	ب و ص ل ة
نشاط	ن ش ا ط
جنابة	ج ن ا ب ة
شروط	ش ر و ط
مجدد	م ج د د
قليل	ق ل ي ل
يحاولون	ي ح ا و ل و ن
قدرات	ق د ر ا ت
مفهوم	م ف ه و م
نأمل	ن أ م ل
أماكن	أ م ا ك ن
مجفف	م ج ف ف
كانون	ك ا ن و ن
محافظ	م ح ا ف ظ
عاشق	ع ا ش ق
فتاة	ف ت ا ة
يطوع	ي ط و ع
تجريبي	ت ج ر ي ب ي
دكتور	د ك ت و ر
حبس	ح ب س
يوفر	ي و ف ر
يبقى	ي ب ق ى
نموذج	ن م و ذ ج
سبق	س ب ق
تماما	ت م ا م ا
يقع	ي ق ع
تحل	ت ح ل
تتقدم	ت ت ق د م
اغترب	ا غ ت ر ب
يلا	ي ل ا
ذو	ذ و
تحليل	ت ح ل ي ل
يوما	ي و م ا
محافظ	م ح ا ف ظ
محافظ	م ح ا ف ظ
مجلة	م ج ل ة
إبراهيم	إ ب ر ا ه ي م
منور	م ن و ر
شهدت	ش ه د ت
اثنين	ا ث ن ي ن
فرد	ف ر د
جمهورية	ج م ه و ر ي ة
متر	م ت ر
عروض	ع ر و ض
نجوم	ن ج و م
قمة	ق م ة
تراجع	ت ر ا ج ع
ضياع	ض ي ا ع
الرحمن	ا ل ر ح م ن
تخفيف	ت خ ف ي ف
تلغين	ت ل غ ي ن
ممارسة	م م ا ر س ة
مصرية	م ص ر ي ة
غشت	غ ش ت
هلال	ه ل ا ل
شجرة	ش ج ر ة
لحظات	ل ح ظ ا ت
دولية	د و ل ي ة
نوقش	ن و ق ش
تزرع	ت ز ر ع
جمال	ج م ا ل
ُ	ُ
استعرض	ا س ت ع ر ض
اتخاذ	ا ت خ ا ذ
تعرض	ت ع ر ض
لحظات	ل ح ظ ا ت
يفضل	ي ف ض ل
مصري	م ص ر ي
أسفر	أ س ف ر
شرق	ش ر ق
قادرة	ق ا د ر ة
وجوه	و ج و ه
يسمح	ي س م ح
تطلق	ت ط ل ق
محكمة	م ح ك م ة
جماعة	ج م ا ع ة
بدء	ب د ء
سطح	س ط ح
سجنوا	س ج ن و ا
دجلة	د ج ل ة
يزيد	ي ز ي د
مدريد	م د ر ي د
مبلغ	م ب ل غ
البحرين	ا ل ب ح ر ي ن
تجميع	ت ج م ي ع
ضل	ض ل
لابتوب	ل ا ب ت و ب
أعربت	أ ع ر ب ت
حصيرة	ح ص ي ر ة
نجم	ن ج م
خطاب	خ ط ا ب
يختلف	ي خ ت ل ف
وليد	و ل ي د
قرية	ق ر ي ة
حبيب	ح ب ي ب
حيلة	ح ي ل ة
تجديد	ت ج د ي د
زلت	ز ل ت
تمييز	ت م ي ي ز
أ	أ
يساعد	ي س ا ع د
كانون	ك ا ن و ن
عالمي	ع ا ل م ي
سعة	س ع ة
معاقبة	م ع ا ق ب ة
تفتح	ت ف ت ح
عقدت	ع ق د ت
إيجاد	إ ي ج ا د
رقصة	ر ق ص ة
نظم	ن ظ م
بيد	ب ي د
يستخدم	ي س ت خ د م
عزل	ع ز ل
عسكري	ع س ك ر ي
بسيط	ب س ي ط
أضاف	أ ض ا ف
مجيد	م ج ي د
غانم	غ ا ن م
حلقة	ح ل ق ة
حاليا	ح ا ل ي ا
توبي	ت و ب ي
ولد	و ل د
تقيم	ت ق ي م
رحمة	ر ح م ة
حرارة	ح ر ا ر ة
سويسرا	س و ي س ر ا
سويسرا	س و ي س ر ا
أبناء	أ ب ن ا ء
مداخل	م د ا خ ل
استقطب	ا س ت ق ط ب
جوار	ج و ا ر
نراجع	ن ر ا ج ع
ملاحظة	م ل ا ح ظ ة
ينتظمون	ي ن ت ظ م و ن
شروط	ش ر و ط
سياسي	س ي ا س ي
موجة	م و ج ة
شروط	ش ر و ط
صديق	ص د ي ق
أحوج	أ ح و ج
ظلم	ظ ل م
خلاص	خ ل ا ص
اعتدنا	ا ع ت د ن ا
مياه	م ي ا ه
كتبت	ك ت ب ت
جماعة	ج م ا ع ة
تصنع	ت ص ن ع
سواد	س و ا د
مظاهرة	م ظ ا ه ر ة
ألم	أ ل م
غناء	غ ن ا ء
أفكار	أ ف ك ا ر
تجري	ت ج ر ي
تعني	ت ع ن ي
عبارة	ع ب ا ر ة
دولية	د و ل ي ة
نعم	ن ع م
ظاهرة	ظ ا ه ر ة
عبارات	ع ب ا ر ا ت
زياد	ز ي ا د
إنسانية	إ ن س ا ن ي ة
تجميع	ت ج م ي ع
إطلاق	إ ط ل ا ق
سلطة	س ل ط ة
تكرار	ت ك ر ا ر
تركت	ت ر ك ت
الشمس	ا ل ش م س
فان	ف ا ن
رضي	ر ض ي
مجالات	م ج ا ل ا ت
تنتظر	ت ن ت ظ ر
شاهر	ش ا ه ر
يتحدث	ي ت ح د ث
شهود	ش ه و د
سلطان	س ل ط ا ن
بغداد	ب غ د ا د
فؤاد	ف ؤ ا د
ضحايا	ض ح ا ي ا
يقتل	ي ق ت ل
تخفيف	ت خ ف ي ف
جبل	ج ب ل
تكشف	ت ك ش ف
نقلنا	ن ق ل ن ا
فرض	ف ر ض
سفير	س ف ي ر
أبجدي	أ ب ج د ي
مبلغ	م ب ل غ
حققوا	ح ق ق و ا
الأسد	ا ل أ س د
هـ	ه ـ
أحذية	أ ح ذ ي ة
سيارات	س ي ا ر ا ت
تزيد	ت ز ي د
تزيد	ت ز ي د
ميدان	م ي د ا ن
حلول	ح ل و ل
تشكل	ت ش ك ل
تؤكد	ت ؤ ك د
إدخال	إ د خ ا ل
لمع	ل م ع
يصدقون	ي ص د ق و ن
حسان	ح س ا ن
مجلة	م ج ل ة
أنثى	أ ن ث ى
الشمس	ا ل ش م س
ممتاز	م م ت ا ز
قتل	ق ت ل
نموذج	ن م و ذ ج
يصعد	ي ص ع د
عدا	ع د ا
ولد	و ل د
آب	آ ب
يشار	ي ش ا ر
حجز	ح ج ز
جمعت	ج م ع ت
خلفية	خ ل ف ي ة
شبح	ش ب ح
إقامة	إ ق ا م ة
بلال	ب ل ا ل
وجدت	و ج د ت
نبحث	ن ب ح ث
مدين	م د ي ن
سيما	س ي م ا
تقرأ	ت ق ر أ
مرسى	م ر س ى
اتخاذ	ا ت خ ا ذ
خيار	خ ي ا ر
تشجع	ت ش ج ع
ماكياج	م ا ك ي ا ج
يضرب	ي ض ر ب
مدرب	م د ر ب
مقبرة	م ق ب ر ة
خبير	خ ب ي ر
يدينون	ي د ي ن و ن
رقعة	ر ق ع ة
تحليل	ت ح ل ي ل
ساحة	س ا ح ة
أشخاص	أ ش خ ا ص
حاولي	ح ا و ل ي
بعيد	ب ع ي د
قرب	ق ر ب
زالت	ز ا ل ت
إصلاح	إ ص ل ا ح
جثة	ج ث ة
أغلب	أ غ ل ب
يعلمون	ي ع ل م و ن
وجدت	و ج د ت
تعلم	ت ع ل م
تسمح	ت س م ح
تتغير	ت ت غ ي ر
قبول	ق ب و ل
عروبة	ع ر و ب ة
مقدمة	م ق د م ة
حجز	ح ج ز
بيتي	ب ي ت ي
مناسبة	م ن ا س ب ة
تمر	ت م ر
عائلة	ع ا ئ ل ة
يزيد	ي ز ي د
يحول	ي ح و ل
نسور	ن س و ر
صفية	ص ف ي ة
بست	ب س ت
مهرجان	م ه ر ج ا ن
فشل	ف ش ل
الأردن	ا ل أ ر د ن
مقدار	م ق د ا ر
سباك	س ب ا ك
عمود	ع م و د
منح	م ن ح
متعددة	م ت ع د د ة
قمت	ق م ت
ثمن	ث م ن
نشيط	ن ش ي ط
موجة	م و ج ة
شجاع	ش ج ا ع
مرحلة	م ر ح ل ة
أقول	أ ق و ل
دوار	د و ا ر
عائلة	ع ا ئ ل ة
يدري	ي د ر ي
يستخدم	ي س ت خ د م
فيروس	ف ي ر و س
أتباع	أ ت ب ا ع
عقيدة	ع ق ي د ة
حدود	ح د و د
نور	ن و ر
اعرف	ا ع ر ف
سلطة	س ل ط ة
محاكمة	م ح ا ك م ة
ظلت	ظ ل ت
طبيعي	ط ب ي ع ي
تشكل	ت ش ك ل
رجا	ر ج ا
حافلة	ح ا ف ل ة
أربع	أ ر ب ع
ي	ي
يعتقدون	ي ع ت ق د و ن
جلسة	ج ل س ة
طب	ط ب
أمن	أ م ن
إل	إ ل
ربع	ر ب ع
رعب	ر ع ب
آتت	آ ت ت
عادلة	ع ا د ل ة
مزورة	م ز و ر ة
متر	م ت ر
فصل	ف ص ل
تعدين	ت ع د ي ن
سدة	س د ة
مجددا	م ج د د ا
كورة	ك و ر ة
تفعلون	ت ف ع ل و ن
غيرت	غ ي ر ت
حداد	ح د ا د
معالم	م ع ا ل م
آنذاك	آ ن ذ ا ك
حاليا	ح ا ل ي ا
الرحمن	ا ل ر ح م ن
مجلة	م ج ل ة
يهودي	ي ه و د ي
سعاد	س ع ا د
رحمة	ر ح م ة
بغداد	ب غ د ا د
صابون	ص ا ب و ن
تكافئ	ت ك ا ف ئ
شي	ش ي
تشتري	ت ش ت ر ي
ربيع	ر ب ي ع
أني	أ ن ي
رئيسي	ر ئ ي س ي
حلول	ح ل و ل
نرد	ن ر د
يغيب	ي غ ي ب
يعقوب	ي ع ق و ب
تظهر	ت ظ ه ر
شرم	ش ر م
ضمان	ض م ا ن
عودة	ع و د ة
تعيد	ت ع ي د
يتكلم	ي ت ك ل م
سيما	س ي م ا
النيل	ا ل ن ي ل
قضايا	ق ض ا ي ا
مختبر	م خ ت ب ر
مهرجان	م ه ر ج ا ن
مرحبا	م ر ح ب ا
ذكرت	ذ ك ر ت
مكافأة	م ك ا ف أ ة
مشاكل	م ش ا ك ل
الجزيرة	ا ل ج ز ي ر ة
أسواق	أ س و ا ق
هضم	ه ض م
طهران	ط ه ر ا ن
صفة	ص ف ة
ظهرت	ظ ه ر ت
مكة	م ك ة
يبتلعون	ي ب ت ل ع و ن
سيء	س ي ء
مقر	م ق ر
صناديق	ص ن ا د ي ق
حفظ	ح ف ظ
حجرة	ح ج ر ة
يقولون	ي ق و ل و ن
مجالات	م ج ا ل ا ت
جدير	ج د ي ر
منظمة	م ن ظ م ة
شكري	ش ك ر ي
مايه	م ا ي ه
غريب	غ ر ي ب
سريع	س ر ي ع
حدثنا	ح د ث ن ا
يصدق	ي ص د ق
تعني	ت ع ن ي
الأسد	ا ل أ س د
دوري	د و ر ي
سيما	س ي م ا
تمت	ت م ت
تعذر	ت ع ذ ر
جائزة	ج ا ئ ز ة
حظوا	ح ظ و ا
حارب	ح ا ر ب
شعبية	ش ع ب ي ة
عشرات	ع ش ر ا ت
زالت	ز ا ل ت
فتاة	ف ت ا ة
أعظم	أ ع ظ م
مسموح	م س م و ح
حدثنا	ح د ث ن ا
شرق	ش ر ق
مسلسلات	م س ل س ل ا ت
يمكثون	ي م ك ث و ن
علماء	ع ل م ا ء
سعودية	س ع و د ي ة
زمان	ز م ا ن
مناسبة	م ن ا س ب ة
خليل	خ ل ي ل
شعر	ش ع ر
سيس	س ي س
تتمتع	ت ت م ت ع
فلو	ف ل و
أخر	أ خ ر
اختلط	ا خ ت ل ط
ملف	م ل ف
والوا	و ا ل و ا
أتمنى	أ ت م ن ى
للغاية	ل ل غ ا ي ة
أعلنت	أ ع ل ن ت
مبعوث	م ب ع و ث
يستطيع	ي س ت ط ي ع
شريط	ش ر ي ط
إخراج	إ خ ر ا ج
تكف	ت ك ف
ربع	ر ب ع
خواطر	خ و ا ط ر
بولي	ب و ل ي
شعيب	ش ع ي ب
تتمتع	ت ت م ت ع
كتبت	ك ت ب ت
مضبوط	م ض ب و ط
فهم	ف ه م
تعلق	ت ع ل ق
أماكن	أ م ا ك ن
فصل	ف ص ل
مرمى	م ر م ى
منظمة	م ن ظ م ة
ميدان	م ي د ا ن
تردد	ت ر د د
ضرب	ض ر ب
أسئلة	أ س ئ ل ة
دمرت	د م ر ت
جميل	ج م ي ل
جمعت	ج م ع ت
تماما	ت م ا م ا
تقول	ت ق و ل
عمرو	ع م ر و
مسرح	م س ر ح
ضاحية	ض ا ح ي ة
تفي	ت ف ي
يسع	ي س ع
شهادات	ش ه ا د ا ت
استعملي	ا س ت ع م ل ي
خانوا	خ ا ن و ا
يسهل	ي س ه ل
تطلق	ت ط ل ق
شرور	ش ر و ر
طيران	ط ي ر ا ن
يتساءل	ي ت س ا ء ل
استلام	ا س ت ل ا م
حوالى	ح و ا ل ى
تقعوا	ت ق ع و ا
طويلة	ط و ي ل ة
جرى	ج ر ى
قليل	ق ل ي ل
قدمت	ق د م ت
نصر	ن ص ر
لسنا	ل س ن ا
منور	م ن و ر
بدء	ب د ء
حدث	ح د ث
درع	د ر ع
طبيعية	ط ب ي ع ي ة
عين	ع ي ن
رائعة	ر ا ئ ع ة
أنجرة	أ ن ج ر ة
دورة	د و ر ة
لمن	ل م ن
هنالك	ه ن ا ل ك
استثمار	ا س ت ث م ا ر
صينية	ص ي ن ي ة
منح	م ن ح
ألمانيا	أ ل م ا ن ي ا
مؤسسات	م ؤ س س ا ت
كون	ك و ن
وصلت	و ص ل ت
يجلس	ي ج ل س
رضي	ر ض ي
دوري	د و ر ي
تصفح	ت ص ف ح
تعرفون	ت ع ر ف و ن
ميدان	م ي د ا ن
يوحد	ي و ح د
أمن	أ م ن
مقرر	م ق ر ر
تسوس	ت س و س
جماعة	ج م ا ع ة
يفرض	ي ف ر ض
هجوم	ه ج و م
أبسط	أ ب س ط
جينز	ج ي ن ز
مجلة	م ج ل ة
سروال	س ر و ا ل
خميس	خ م ي س
عود	ع و د
الدلو	ا ل د ل و
مرسى	م ر س ى
عالمية	ع ا ل م ي ة
ذكرت	ذ ك ر ت
جاءت	ج ا ء ت
تفاحة	ت ف ا ح ة
مياه	م ي ا ه
أبوظبي	أ ب و ظ ب ي
توقعت	ت و ق ع ت
فلم	ف ل م
شقة	ش ق ة
سياسية	س ي ا س ي ة
ممتلكات	م م ت ل ك ا ت
أشخاص	أ ش خ ا ص
فرقة	ف ر ق ة
حدث	ح د ث
وعي	و ع ي
حقيقي	ح ق ي ق ي
تأمين	ت أ م ي ن
عربية	ع ر ب ي ة
الجزيرة	ا ل ج ز ي ر ة
مقتضى	م ق ت ض ى
معمل	م ع م ل
إشارة	إ ش ا ر ة
قدرة	ق د ر ة
ملح	م ل ح
سريعة	س ر ي ع ة
صلاح	ص ل ا ح
بندر	ب ن د ر
طويلة	ط و ي ل ة
ظاهرة	ظ ا ه ر ة
سفن	س ف ن
صباح	ص ب ا ح
نموذج	ن م و ذ ج
حقائب	ح ق ا ئ ب
شي	ش ي
حرارة	ح ر ا ر ة
وصلت	و ص ل ت
رئاسي	ر ئ ا س ي
توقف	ت و ق ف
متر	م ت ر
حاليا	ح ا ل ي ا
داعش	د ا ع ش
ضغط	ض غ ط
استخدمت	ا س ت خ د م ت
اعتبار	ا ع ت ب ا ر
ليبيا	ل ي ب ي ا
حفظ	ح ف ظ
الجزيرة	ا ل ج ز ي ر ة
شبه	ش ب ه
بسكويت	ب س ك و ي ت
متعة	م ت ع ة
عقوبات	ع ق و ب ا ت
إعلان	إ ع ل ا ن
استقرضت	ا س ت ق ر ض ت
ظاهرة	ظ ا ه ر ة
أفاد	أ ف ا د
مشروب	م ش ر و ب
مكة	م ك ة
خطابات	خ ط ا ب ا ت
عين	ع ي ن
قليل	ق ل ي ل
اكتشفت	ا ك ت ش ف ت
تعرض	ت ع ر ض
انحراف	ا ن ح ر ا ف
دمت	د م ت
اغتيال	ا غ ت ي ا ل
سياحي	س ي ا ح ي
مراقبة	م ر ا ق ب ة
ممتلكات	م م ت ل ك ا ت
قاضي	ق ا ض ي
تتصوروا	ت ت ص و ر و ا
نحاس	ن ح ا س
أمير	أ م ي ر
أقارب	أ ق ا ر ب
جعفر	ج ع ف ر
سدرة	س د ر ة
دير	د ي ر
يقبل	ي ق ب ل
وسيلة	و س ي ل ة
عائلة	ع ا ئ ل ة
أعماق	أ ع م ا ق
خسارة	خ س ا ر ة
آذار	آ ذ ا ر
يبيع	ي ب ي ع
يخلي	ي خ ل ي
يقتضي	ي ق ت ض ي
ثمن	ث م ن
شأن	ش أ ن
اختبار	ا خ ت ب ا ر
أرضية	أ ر ض ي ة
تسلم	ت س ل م
مدريد	م د ر ي د
طائرة	ط ا ئ ر ة
ضربة	ض ر ب ة
متجر	م ت ج ر
شعور	ش ع و ر
منظمة	م ن ظ م ة
نص	ن ص
أية	أ ي ة
إله	إ ل ه
قنوع	ق ن و ع
بدوت	ب د و ت
اتفاق	ا ت ف ا ق
رضي	ر ض ي
موجة	م و ج ة
عين	ع ي ن
تقول	ت ق و ل
سلاطين	س ل ا ط ي ن
حبيبي	ح ب ي ب ي
تسكنون	ت س ك ن و ن
بطيخ	ب ط ي خ
صديق	ص د ي ق
رابع	ر ا ب ع
قبلية	ق ب ل ي ة
متطرف	م ت ط ر ف
تشكيل	ت ش ك ي ل
نوعية	ن و ع ي ة
تأتي	ت أ ت ي
استخرج	ا س ت خ ر ج
ناحية	ن ا ح ي ة
قدرة	ق د ر ة
إنسانية	إ ن س ا ن ي ة
سرت	س ر ت
خريطة	خ ر ي ط ة
زيدان	ز ي د ا ن
نظم	ن ظ م
لعبت	ل ع ب ت
يلا	ي ل ا
كتبت	ك ت ب ت
اول	ا و ل
كلم	ك ل م
نبلغ	ن ب ل غ
اقرب	ا ق ر ب
مدح	م د ح
نوعية	ن و ع ي ة
الأسد	ا ل أ س د
مفيدة	م ف ي د ة
بنت	ب ن ت
يفضل	ي ف ض ل
مختار	م خ ت ا ر
مني	م ن ي
دخلنا	د خ ل ن ا
نبك	ن ب ك
متأزمة	م ت أ ز م ة
جون	ج و ن
تقع	ت ق ع
تتغير	ت ت غ ي ر
استعمال	ا س ت ع م ا ل
علمت	ع ل م ت
سعد	س ع د
مفيد	م ف ي د
نطاق	ن ط ا ق
بلنسية	ب ل ن س ي ة
غرامة	غ ر ا م ة
كرة	ك ر ة
أرتدى	أ ر ت د ى
إبريل	إ ب ر ي ل
دوري	د و ر ي
خطأ	خ ط أ
مساعد	م س ا ع د
خيار	خ ي ا ر
إندونيسيا	إ ن د و ن ي س ي ا
غريب	غ ر ي ب
تعني	ت ع ن ي
تصوري	ت ص و ر ي
عاصمة	ع ا ص م ة
تخاف	ت خ ا ف
قريبة	ق ر ي ب ة
حادث	ح ا د ث
عمان	ع م ا ن
مسيرة	م س ي ر ة
مجدل	م ج د ل
تصليح	ت ص ل ي ح
اكتشاف	ا ك ت ش ا ف
اضافة	ا ض ا ف ة
فهم	ف ه م
مرحلة	م ر ح ل ة
راعي	ر ا ع ي
الجزيرة	ا ل ج ز ي ر ة
فان	ف ا ن
بغداد	ب غ د ا د
أثر	أ ث ر
وراء	و ر ا ء
بلى	ب ل ى
كيلومتر	ك ي ل و م ت ر
شهيد	ش ه ي د
رسوم	ر س و م
أنزل	أ ن ز ل
سن	س ن
لقمة	ل ق م ة
عطاء	ع ط ا ء
يسوع	ي س و ع
جمال	ج م ا ل
عادل	ع ا د ل
دوري	د و ر ي
اضافة	ا ض ا ف ة
لسان	ل س ا ن
نباتات	ن ب ا ت ا ت
خلاص	خ ل ا ص
اتفاق	ا ت ف ا ق
معقدة	م ع ق د ة
جهات	ج ه ا ت
تدعو	ت د ع و
مشاريع	م ش ا ر ي ع
أثار	أ ث ا ر
دوري	د و ر ي
يصلح	ي ص ل ح
أضعف	أ ض ع ف
مديرة	م د ي ر ة
زحمة	ز ح م ة
يبلغ	ي ب ل غ
يتوقف	ي ت و ق ف
أعظم	أ ع ظ م
رضيع	ر ض ي ع
يدخل	ي د خ ل
نطاق	ن ط ا ق
انفجار	ا ن ف ج ا ر
إعلان	إ ع ل ا ن
تكونوا	ت ك و ن و ا
عريف	ع ر ي ف
صندوق	ص ن د و ق
اعتبر	ا ع ت ب ر
فهم	ف ه م
فعلا	ف ع ل ا
عروض	ع ر و ض
لقاء	ل ق ا ء
حادث	ح ا د ث
قيم	ق ي م
سلامة	س ل ا م ة
ماي	م ا ي
دستوري	د س ت و ر ي
تؤكد	ت ؤ ك د
ألمانية	أ ل م ا ن ي ة
زواج	ز و ا ج
يطلق	ي ط ل ق
نيجيريا	ن ي ج ي ر ي ا
حدث	ح د ث
دعوة	د ع و ة
جيش	ج ي ش
مجالات	م ج ا ل ا ت
منظار	م ن ظ ا ر
أوصى	أ و ص ى
ناعمة	ن ا ع م ة
ينجح	ي ن ج ح
مصري	م ص ر ي
محافظ	م ح ا ف ظ
عودة	ع و د ة
حاولت	ح ا و ل ت
زيتون	ز ي ت و ن
أشعل	أ ش ع ل
أجمل	أ ج م ل
طيلة	ط ي ل ة
نمط	ن م ط
سحق	س ح ق
تخص	ت خ ص
تنبأ	ت ن ب أ
ركوب	ر ك و ب
كاتب	ك ا ت ب
متى	م ت ى
حزيران	ح ز ي ر ا ن
اتفاقات	ا ت ف ا ق ا ت
كشف	ك ش ف
سحر	س ح ر
نوم	ن و م
بغداد	ب غ د ا د
اختاري	ا خ ت ا ر ي
عنف	ع ن ف
أقصى	أ ق ص ى
يصب	ي ص ب
وسيلة	و س ي ل ة
يثابروا	ي ث ا ب ر و ا
يقف	ي ق ف
باشا	ب ا ش ا
أعظم	أ ع ظ م
سورة	س و ر ة
موجة	م و ج ة
عطل	ع ط ل
خطاب	خ ط ا ب
بكين	ب ك ي ن
داء	د ا ء
مصالح	م ص ا ل ح
مرحلة	م ر ح ل ة
عربي	ع ر ب ي
أطلقت	أ ط ل ق ت
سريع	س ر ي ع
محلي	م ح ل ي
كاليفورنيا	ك ا ل ي ف و ر ن ي ا
تدهور	ت د ه و ر
مشرحة	م ش ر ح ة
تداخل	ت د ا خ ل
انتخابات	ا ن ت خ ا ب ا ت
زالت	ز ا ل ت
أوت	أ و ت
نهائي	ن ه ا ئ ي
تتويج	ت ت و ي ج
نابلس	ن ا ب ل س
أمن	أ م ن
محرر	م ح ر ر
تزامن	ت ز ا م ن
سورية	س و ر ي ة
يوحنا	ي و ح ن ا
مفيد	م ف ي د
صورت	ص و ر ت
آنذاك	آ ن ذ ا ك
نسق	ن س ق
أمير	أ م ي ر
يتداول	ي ت د ا و ل
جزء	ج ز ء
خفت	خ ف ت
يلي	ي ل ي
متعددة	م ت ع د د ة
تكشف	ت ك ش ف
بدء	ب د ء
انقلاب	ا ن ق ل ا ب
معاهدة	م ع ا ه د ة
مدة	م د ة
مكة	م ك ة
أمان	أ م ا ن
بور	ب و ر
تشتري	ت ش ت ر ي
مناخ	م ن ا خ
مهارات	م ه ا ر ا ت
رأيت	ر أ ي ت
تلف	ت ل ف
مسؤول	م س ؤ و ل
شرط	ش ر ط
يستخدم	ي س ت خ د م
سار	س ا ر
تضر	ت ض ر
نبيه	ن ب ي ه
اغتيال	ا غ ت ي ا ل
طويلة	ط و ي ل ة
سيما	س ي م ا
خليفة	خ ل ي ف ة
داخلية	د ا خ ل ي ة
موقف	م و ق ف
بطاقات	ب ط ا ق ا ت
ادعم	ا د ع م
يختلف	ي خ ت ل ف
تليفزيون	ت ل ي ف ز ي و ن
تجسيد	ت ج س ي د
مني	م ن ي
سوى	س و ى
يخدم	ي خ د م
متقدمة	م ت ق د م ة
استعمال	ا س ت ع م ا ل
دافعوا	د ا ف ع و ا
خرجت	خ ر ج ت
السرطان	ا ل س ر ط ا ن
زينب	ز ي ن ب
نظم	ن ظ م
خواطر	خ و ا ط ر
علمي	ع ل م ي
قامت	ق ا م ت
تنسوا	ت ن س و ا
سبق	س ب ق
هبت	ه ب ت
سدة	س د ة
ربيع	ر ب ي ع
برشلونة	ب ر ش ل و ن ة
تقر	ت ق ر
جمعية	ج م ع ي ة
إنسان	إ ن س ا ن
تشرين	ت ش ر ي ن
يساعد	ي س ا ع د
جورج	ج و ر ج
أرفع	أ ر ف ع
إبراهيم	إ ب ر ا ه ي م
محطات	م ح ط ا ت
ملح	م ل ح
سيوف	س ي و ف
فين	ف ي ن
فجر	ف ج ر
يطلع	ي ط ل ع
اسبانيا	ا س ب ا ن ي ا
فهم	ف ه م
الشيعة	ا ل ش ي ع ة
حسني	ح س ن ي
مدريد	م د ر ي د
طبيعي	ط ب ي ع ي
أكيد	أ ك ي د
فعلا	ف ع ل ا
التهاب	ا ل ت ه ا ب
إقامة	إ ق ا م ة
قادرة	ق ا د ر ة
تصير	ت ص ي ر
لذيذ	ل ذ ي ذ
منح	م ن ح
مؤشر	م ؤ ش ر
تقريبا	ت ق ر ي ب ا
دورة	د و ر ة
كن	ك ن
أراد	أ ر ا د
ساخن	س ا خ ن
جرح	ج ر ح
يحتاج	ي ح ت ا ج
عوامل	ع و ا م ل
محل	م ح ل
ملعقة	م ل ع ق ة
إقفال	إ ق ف ا ل
وزراء	و ز ر ا ء
قبول	ق ب و ل
اسرائيل	ا س ر ا ئ ي ل
لبنة	ل ب ن ة
انفجار	ا ن ف ج ا ر
الأسد	ا ل أ س د
فر	ف ر
طول	ط و ل
قيادة	ق ي ا د ة
ضغط	ض غ ط
بدء	ب د ء
عودة	ع و د ة
احتفال	ا ح ت ف ا ل
وليد	و ل ي د
مديرة	م د ي ر ة
طرد	ط ر د
زائر	ز ا ئ ر
مديرة	م د ي ر ة
مسؤول	م س ؤ و ل
فضي	ف ض ي
أبوظبي	أ ب و ظ ب ي
عربي	ع ر ب ي
مستعمل	م س ت ع م ل
تباع	ت ب ا ع
صباح	ص ب ا ح
ملاحظة	م ل ا ح ظ ة
يسبب	ي س ب ب
رسائل	ر س ا ئ ل
كاتب	ك ا ت ب
عناء	ع ن ا ء
متعة	م ت ع ة
يسوي	ي س و ي
نجد	ن ج د
ذو	ذ و
والدة	و ا ل د ة
قدرة	ق د ر ة
تواصل	ت و ا ص ل
جمهورية	ج م ه و ر ي ة
تعلن	ت ع ل ن
حفظ	ح ف ظ
جودة	ج و د ة
يبحثون	ي ب ح ث و ن
سقف	س ق ف
كيفما	ك ي ف م ا
أدوا	أ د و ا
عد	ع د
إلقاء	إ ل ق ا ء
هنأ	ه ن أ
حبت	ح ب ت
يبعد	ي ب ع د
عالمي	ع ا ل م ي
هما	ه م ا
موسى	م و س ى
رائع	ر ا ئ ع
روبوت	ر و ب و ت
الراية	ا ل ر ا ي ة
ميشال	م ي ش ا ل
الجزيرة	ا ل ج ز ي ر ة
سيارات	س ي ا ر ا ت
عين	ع ي ن
حققت	ح ق ق ت
أعوام	أ ع و ا م
أحبطت	أ ح ب ط ت
عنت	ع ن ت
غانا	غ ا ن ا
تعلم	ت ع ل م
طائرة	ط ا ئ ر ة
التقاء	ا ل ت ق ا ء
ذهب	ذ ه ب
النرويج	ا ل ن ر و ي ج
سلامة	س ل ا م ة
محب	م ح ب
دخول	د خ و ل
شحن	ش ح ن
تشكيل	ت ش ك ي ل
مسلسلات	م س ل س ل ا ت
يحتوى	ي ح ت و ى
أريكة	أ ر ي ك ة
منية	م ن ي ة
أدى	أ د ى
وحيدة	و ح ي د ة
يستخدم	ي س ت خ د م
جدة	ج د ة
مقاس	م ق ا س
أجمل	أ ج م ل
قلم	ق ل م
داعش	د ا ع ش
محبة	م ح ب ة
صراط	ص ر ا ط
أشعر	أ ش ع ر
جنان	ج ن ا ن
إسماعيل	إ س م ا ع ي ل
إسماعيل	إ س م ا ع ي ل
يمثل	ي م ث ل
يحبون	ي ح ب و ن
مفتوح	م ف ت و ح
شعبية	ش ع ب ي ة
عدالة	ع د ا ل ة
طهران	ط ه ر ا ن
غرف	غ ر ف
مصانع	م ص ا ن ع
حقيقية	ح ق ي ق ي ة
فروق	ف ر و ق
إنقاذ	إ ن ق ا ذ
اتصال	ا ت ص ا ل
يقل	ي ق ل
يهم	ي ه م
مكة	م ك ة
أفاد	أ ف ا د
أولئك	أ و ل ئ ك
صدقة	ص د ق ة
خطة	خ ط ة
بال	ب ا ل
تفتح	ت ف ت ح
قبول	ق ب و ل
شرق	ش ر ق
تذكر	ت ذ ك ر
مجلة	م ج ل ة
جبارة	ج ب ا ر ة
مضى	م ض ى
تألق	ت أ ل ق
فائدة	ف ا ئ د ة
لجوء	ل ج و ء
ينشر	ي ن ش ر
اقصد	ا ق ص د
زواج	ز و ا ج
حورية	ح و ر ي ة
لكي	ل ك ي
كي	ك ي
نجوم	ن ج و م
نظم	ن ظ م
مكتوب	م ك ت و ب
سقف	س ق ف
مئة	م ئ ة
سيما	س ي م ا
تفرقة	ت ف ر ق ة
زرادشت	ز ر ا د ش ت
لؤلؤة	ل ؤ ل ؤ ة
اتصل	ا ت ص ل
تكمل	ت ك م ل
عائلة	ع ا ئ ل ة
بنت	ب ن ت
بسلة	ب س ل ة
ملايين	م ل ا ي ي ن
تفعيل	ت ف ع ي ل
حيلة	ح ي ل ة
مفاجأة	م ف ا ج أ ة
قررت	ق ر ر ت
تصدق	ت ص د ق
تعني	ت ع ن ي
قدرات	ق د ر ا ت
تقف	ت ق ف
مجالات	م ج ا ل ا ت
يهدف	ي ه د ف
كيوتو	ك ي و ت و
يهدد	ي ه د د
موسى	م و س ى
كلية	ك ل ي ة
مدريد	م د ر ي د
ترجمة	ت ر ج م ة
أوسع	أ و س ع
نا	ن ا
سياق	س ي ا ق
تواصل	ت و ا ص ل
تفسير	ت ف س ي ر
يرجى	ي ر ج ى
ليالي	ل ي ا ل ي
وهران	و ه ر ا ن
ترى	ت ر ى
صدور	ص د و ر
دوت	د و ت
محاكمة	م ح ا ك م ة
الجزيرة	ا ل ج ز ي ر ة
حلول	ح ل و ل
عنصرية	ع ن ص ر ي ة
لوى	ل و ى
تسلم	ت س ل م
كرة	ك ر ة
أشد	أ ش د
يستعمل	ي س ت ع م ل
سياسية	س ي ا س ي ة
توقيت	ت و ق ي ت
سميج	س م ي ج
طائرة	ط ا ئ ر ة
لحظة	ل ح ظ ة
توليد	ت و ل ي د
حمد	ح م د
يستطيع	ي س ت ط ي ع
يظهر	ي ظ ه ر
أصحاب	أ ص ح ا ب
يقدم	ي ق د م
سوى	س و ى
يبدو	ي ب د و
أين	أ ي ن
سقطت	س ق ط ت
اجتماعية	ا ج ت م ا ع ي ة
حماة	ح م ا ة
عطف	ع ط ف
جماهير	ج م ا ه ي ر
سلطة	س ل ط ة
يرفضون	ي ر ف ض و ن
نصيب	ن ص ي ب
غياب	غ ي ا ب
أسوأ	أ س و أ
فلاش	ف ل ا ش
تعرض	ت ع ر ض
حدثنا	ح د ث ن ا
عدلي	ع د ل ي
سلك	س ل ك
خيال	خ ي ا ل
ينقص	ي ن ق ص
اكتشفت	ا ك ت ش ف ت
نقدي	ن ق د ي
دخلت	د خ ل ت
شخصي	ش خ ص ي
نزلت	ن ز ل ت
أشترى	أ ش ت ر ى
تشير	ت ش ي ر
منتخب	م ن ت خ ب
مدرسة	م د ر س ة
نوعية	ن و ع ي ة
أوتاد	أ و ت ا د
صحيح	ص ح ي ح
الحسن	ا ل ح س ن
نعمل	ن ع م ل
أرجو	أ ر ج و
مستقيم	م س ت ق ي م
مكتبة	م ك ت ب ة
يرفع	ي ر ف ع
سورة	س و ر ة
جمال	ج م ا ل
هجوم	ه ج و م
سفن	س ف ن
قرص	ق ر ص
مكافآت	م ك ا ف آ ت
أخذوا	أ خ ذ و ا
صحة	ص ح ة
اتصال	ا ت ص ا ل
سورية	س و ر ي ة
عصير	ع ص ي ر
أخلي	أ خ ل ي
تغريدة	ت غ ر ي د ة
سنان	س ن ا ن
نظمت	ن ظ م ت
مقام	م ق ا م
ذاب	ذ ا ب
طوال	ط و ا ل
وزارات	و ز ا ر ا ت
مسؤول	م س ؤ و ل
نور	ن و ر
يحققون	ي ح ق ق و ن
عقود	ع ق و د
علمي	ع ل م ي
معقولة	م ع ق و ل ة
شيطان	ش ي ط ا ن
منى	م ن ى
دفع	د ف ع
يقبل	ي ق ب ل
وطنية	و ط ن ي ة
متر	م ت ر
قامت	ق ا م ت
اتجاهات	ا ت ج ا ه ا ت
عهد	ع ه د
أركض	أ ر ك ض
تصدر	ت ص د ر
تغليف	ت غ ل ي ف
عضوا	ع ض و ا
طيران	ط ي ر ا ن
لطيف	ل ط ي ف
سم	س م
تهديد	ت ه د ي د
جدة	ج د ة
لمن	ل م ن
شاكر	ش ا ك ر
حزيران	ح ز ي ر ا ن
محمدي	م ح م د ي
مشاكل	م ش ا ك ل
سعد	س ع د
النيل	ا ل ن ي ل
تمثيل	ت م ث ي ل
شاهد	ش ا ه د
يستطيع	ي س ت ط ي ع
كفاءة	ك ف ا ء ة
مريح	م ر ي ح
محدث	م ح د ث
سعادة	س ع ا د ة
إطلاق	إ ط ل ا ق
ملال	م ل ا ل
تطفئ	ت ط ف ئ
بقيت	ب ق ي ت
مرور	م ر و ر
تنجح	ت ن ج ح
استهدفت	ا س ت ه د ف ت
يستخدم	ي س ت خ د م
ينشط	ي ن ش ط
تزني	ت ز ن ي
أدخلوا	أ د خ ل و ا
الشمس	ا ل ش م س
وزراء	و ز ر ا ء
اختبار	ا خ ت ب ا ر
يسمح	ي س م ح
رضيت	ر ض ي ت
أنسب	أ ن س ب
غلاف	غ ل ا ف
يوما	ي و م ا
تقدمت	ت ق د م ت
إيجابية	إ ي ج ا ب ي ة
مباريات	م ب ا ر ي ا ت
تبقي	ت ب ق ي
إقامة	إ ق ا م ة
حفلة	ح ف ل ة
اتصال	ا ت ص ا ل
ذكرت	ذ ك ر ت
صباح	ص ب ا ح
تراجع	ت ر ا ج ع
دم	د م
تكوين	ت ك و ي ن
أبناء	أ ب ن ا ء
ماكياج	م ا ك ي ا ج
تنامي	ت ن ا م ي
خلق	خ ل ق
تذكر	ت ذ ك ر
كمبيوتر	ك م ب ي و ت ر
جفاف	ج ف ا ف
منتخب	م ن ت خ ب
اثنين	ا ث ن ي ن
دم	د م
نذكر	ن ذ ك ر
تمتلك	ت م ت ل ك
مناقشة	م ن ا ق ش ة
نقدا	ن ق د ا
تجويز	ت ج و ي ز
كوكبة	ك و ك ب ة
عالج	ع ا ل ج
وصلت	و ص ل ت
توقيف	ت و ق ي ف
ساخنة	س ا خ ن ة
متعددة	م ت ع د د ة
غم	غ م
صنع	ص ن ع
يقع	ي ق ع
ميادين	م ي ا د ي ن
واحة	و ا ح ة
هبة	ه ب ة
تهديد	ت ه د ي د
فاتورة	ف ا ت و ر ة
تجذير	ت ج ذ ي ر
لاحظ	ل ا ح ظ
ضباب	ض ب ا ب
منتخب	م ن ت خ ب
لأجل	ل أ ج ل
ضرورة	ض ر و ر ة
هادئة	ه ا د ئ ة
عمان	ع م ا ن
أبناء	أ ب ن ا ء
نور	ن و ر
موعد	م و ع د
عز	ع ز
سليمان	س ل ي م ا ن
يشكوا	ي ش ك و ا
شيخ	ش ي خ
تتقدم	ت ت ق د م
قادرة	ق ا د ر ة
تكشف	ت ك ش ف
الرحمن	ا ل ر ح م ن
غيداء	غ ي د ا ء
يهدف	ي ه د ف
منهج	م ن ه ج
أشخاص	أ ش خ ا ص
قريش	ق ر ي ش
دان	د ا ن
منح	م ن ح
استثمار	ا س ت ث م ا ر
عودة	ع و د ة
بوابة	ب و ا ب ة
أدرك	أ د ر ك
ثقة	ث ق ة
بغداد	ب غ د ا د
محاربة	م ح ا ر ب ة
مستعمل	م س ت ع م ل
صفقة	ص ف ق ة
كمبيوتر	ك م ب ي و ت ر
راية	ر ا ي ة
ظهرت	ظ ه ر ت
محاصرة	م ح ا ص ر ة
تشريعي	ت ش ر ي ع ي
تعرض	ت ع ر ض
شعر	ش ع ر
سرعة	س ر ع ة
مشهد	م ش ه د
خمس	خ م س
حرارة	ح ر ا ر ة
تباحث	ت ب ا ح ث
ܔ	ܔ
زيدان	ز ي د ا ن
وزارات	و ز ا ر ا ت
سوى	س و ى
رباط	ر ب ا ط
إليهم	إ ل ي ه م
دورة	د و ر ة
شقة	ش ق ة
غروب	غ ر و ب
نفهم	ن ف ه م
تعدى	ت ع د ى
أنحاء	أ ن ح ا ء
مصورة	م ص و ر ة
مؤتمر	م ؤ ت م ر
نزف	ن ز ف
احتلال	ا ح ت ل ا ل
رضي	ر ض ي
اسبانيا	ا س ب ا ن ي ا
تقارير	ت ق ا ر ي ر
معيد	م ع ي د
جمع	ج م ع
البوسنة	ا ل ب و س ن ة
معارك	م ع ا ر ك
بنزين	ب ن ز ي ن
فشل	ف ش ل
يستفيد	ي س ت ف ي د
تفتح	ت ف ت ح
علقت	ع ل ق ت
صلاح	ص ل ا ح
ماي	م ا ي
إليكم	إ ل ي ك م
بور	ب و ر
مشروعات	م ش ر و ع ا ت
تسمح	ت س م ح
استبدال	ا س ت ب د ا ل
مغربي	م غ ر ب ي
زياد	ز ي ا د
تدع	ت د ع
خلة	خ ل ة
ذقن	ذ ق ن
محو	م ح و
تفد	ت ف د
إحضار	إ ح ض ا ر
يكاد	ي ك ا د
تشغيل	ت ش غ ي ل
غناء	غ ن ا ء
إشبيلية	إ ش ب ي ل ي ة
استبدال	ا س ت ب د ا ل
يسهل	ي س ه ل
مهاجمة	م ه ا ج م ة
تزيد	ت ز ي د
لاسلكي	ل ا س ل ك ي
عائلة	ع ا ئ ل ة
عزل	ع ز ل
صباح	ص ب ا ح
نور	ن و ر
شديد	ش د ي د
مراقبة	م ر ا ق ب ة
مجلة	م ج ل ة
تراجع	ت ر ا ج ع
مترو	م ت ر و
كرة	ك ر ة
حرق	ح ر ق
يقود	ي ق و د
قتل	ق ت ل
أرضية	أ ر ض ي ة
أواخر	أ و ا خ ر
قمة	ق م ة
كانون	ك ا ن و ن
معالجة	م ع ا ل ج ة
خلف	خ ل ف
علوم	ع ل و م
خارجية	خ ا ر ج ي ة
سوى	س و ى
صلة	ص ل ة
محور	م ح و ر
إمام	إ م ا م
هـ	ه ـ
نون	ن و ن
أسوأ	أ س و أ
توجيه	ت و ج ي ه
تقريبا	ت ق ر ي ب ا
انو	ا ن و
مهرجان	م ه ر ج ا ن
تغريدة	ت غ ر ي د ة
هلا	ه ل ا
دخل	د خ ل
يخرجون	ي خ ر ج و ن
تروح	ت ر و ح
تجريبي	ت ج ر ي ب ي
أحسن	أ ح س ن
مسيرة	م س ي ر ة
روسي	ر و س ي
مد	م د
بعيدة	ب ع ي د ة
نورج	ن و ر ج
استعمال	ا س ت ع م ا ل
هافانا	ه ا ف ا ن ا
لولا	ل و ل ا
يمثل	ي م ث ل
نجد	ن ج د
ملاعب	م ل ا ع ب
يبلغ	ي ب ل غ
نجم	ن ج م
مراكز	م ر ا ك ز
باقون	ب ا ق و ن
القاعدة	ا ل ق ا ع د ة
شوال	ش و ا ل
سوء	س و ء
تفسير	ت ف س ي ر
دماء	د م ا ء
مسك	م س ك
داخلية	د ا خ ل ي ة
داعش	د ا ع ش
سياسة	س ي ا س ة
سخرية	س خ ر ي ة
اضافة	ا ض ا ف ة
ألا	أ ل ا
مدريد	م د ر ي د
زهراء	ز ه ر ا ء
قديمة	ق د ي م ة
إيرانية	إ ي ر ا ن ي ة
عمالقة	ع م ا ل ق ة
عربية	ع ر ب ي ة
صعيد	ص ع ي د
يسلم	ي س ل م
أغنى	أ غ ن ى
إمام	إ م ا م
دوري	د و ر ي
يستنير	ي س ت ن ي ر
جسم	ج س م
أشجار	أ ش ج ا ر
جل	ج ل
منظمة	م ن ظ م ة
يجوز	ي ج و ز
تعامل	ت ع ا م ل
نعم	ن ع م
سابقة	س ا ب ق ة
استخدموا	ا س ت خ د م و ا
سقف	س ق ف
أمثلة	أ م ث ل ة
زمني	ز م ن ي
سحب	س ح ب
حمد	ح م د
عروض	ع ر و ض
يستطيع	ي س ت ط ي ع
أقلام	أ ق ل ا م
تقليدي	ت ق ل ي د ي
تصريح	ت ص ر ي ح
أنثى	أ ن ث ى
مفتوح	م ف ت و ح
يدخلوا	ي د خ ل و ا
طلع	ط ل ع
تركت	ت ر ك ت
ملاحظة	م ل ا ح ظ ة
سراح	س ر ا ح
منفصلة	م ن ف ص ل ة
يعكس	ي ع ك س
أسامة	أ س ا م ة
يحتاج	ي ح ت ا ج
وجل	و ج ل
يهدف	ي ه د ف
ساحة	س ا ح ة
قادر	ق ا د ر
معهد	م ع ه د
شرق	ش ر ق
سرعة	س ر ع ة
ينظر	ي ن ظ ر
تحتوي	ت ح ت و ي
تأتي	ت أ ت ي
عين	ع ي ن
فؤاد	ف ؤ ا د
مهام	م ه ا م
ملايين	م ل ا ي ي ن
جزء	ج ز ء
فشل	ف ش ل
تعامل	ت ع ا م ل
قيم	ق ي م
مدرب	م د ر ب
صعود	ص ع و د
تقارير	ت ق ا ر ي ر
أحضان	أ ح ض ا ن
بلاغ	ب ل ا غ
أجبن	أ ج ب ن
جثث	ج ث ث
إله	إ ل ه
موقف	م و ق ف
أسواق	أ س و ا ق
مضادة	م ض ا د ة
مرات	م ر ا ت
شداد	ش د ا د
هزيمة	ه ز ي م ة
قبيلة	ق ب ي ل ة
جيب	ج ي ب
يفيد	ي ف ي د
قرب	ق ر ب
ثلاجة	ث ل ا ج ة
واجهة	و ا ج ه ة
قريبة	ق ر ي ب ة
عصر	ع ص ر
داعشي	د ا ع ش ي
تسلك	ت س ل ك
انتخابات	ا ن ت خ ا ب ا ت
خليط	خ ل ي ط
يبيع	ي ب ي ع
يلعبون	ي ل ع ب و ن
ذكية	ذ ك ي ة
حيال	ح ي ا ل
مطابخ	م ط ا ب خ
قريبة	ق ر ي ب ة
يرفض	ي ر ف ض
غرز	غ ر ز
قصص	ق ص ص
أعداد	أ ع د ا د
صلة	ص ل ة
علماء	ع ل م ا ء
علوم	ع ل و م
تنوي	ت ن و ي
دعوة	د ع و ة
نكتب	ن ك ت ب
أخيرا	أ خ ي ر ا
تليين	ت ل ي ي ن
سحق	س ح ق
واجهة	و ا ج ه ة
عظيم	ع ظ ي م
بحر	ب ح ر
نعدم	ن ع د م
نزع	ن ز ع
رسائل	ر س ا ئ ل
بحت	ب ح ت
أسماء	أ س م ا ء
أصحاب	أ ص ح ا ب
عبوة	ع ب و ة
بدء	ب د ء
بعثة	ب ع ث ة
نظر	ن ظ ر
تماما	ت م ا م ا
تلحق	ت ل ح ق
يزيد	ي ز ي د
سورية	س و ر ي ة
نقاط	ن ق ا ط
وزن	و ز ن
قائد	ق ا ئ د
فصيلة	ف ص ي ل ة
فرض	ف ر ض
حصدت	ح ص د ت
حلقة	ح ل ق ة
ندى	ن د ى
خطاب	خ ط ا ب
سويسرا	س و ي س ر ا
توزيع	ت و ز ي ع
شؤون	ش ؤ و ن
قلوب	ق ل و ب
مأزق	م أ ز ق
تبدلت	ت ب د ل ت
اعتقل	ا ع ت ق ل
مرافق	م ر ا ف ق
دوري	د و ر ي
وكيل	و ك ي ل
أية	أ ي ة
احتواء	ا ح ت و ا ء
مزرعة	م ز ر ع ة
زهرة	ز ه ر ة
آذار	آ ذ ا ر
يحتاج	ي ح ت ا ج
زحمة	ز ح م ة
سورية	س و ر ي ة
أخر	أ خ ر
انقطع	ا ن ق ط ع
عربي	ع ر ب ي
دماء	د م ا ء
قم	ق م
تتأكدي	ت ت أ ك د ي
الحسن	ا ل ح س ن
أضاف	أ ض ا ف
سوى	س و ى
إسبانيا	إ س ب ا ن ي ا
دخول	د خ و ل
عجز	ع ج ز
دوافع	د و ا ف ع
قامت	ق ا م ت
أقاصيص	أ ق ا ص ي ص
دخل	د خ ل
عائلة	ع ا ئ ل ة
غنت	غ ن ت
شكر	ش ك ر
اسرائيل	ا س ر ا ئ ي ل
خالص	خ ا ل ص
مسيرة	م س ي ر ة
يقدم	ي ق د م
مهندس	م ه ن د س
عظيم	ع ظ ي م
بدايات	ب د ا ي ا ت
سهم	س ه م
أعدم	أ ع د م
جعفر	ج ع ف ر
قدمت	ق د م ت
صدور	ص د و ر
يقع	ي ق ع
أسوأ	أ س و أ
قامت	ق ا م ت
ياسمين	ي ا س م ي ن
السويد	ا ل س و ي د
أراد	أ ر ا د
جائزة	ج ا ئ ز ة
منصب	م ن ص ب
كلفن	ك ل ف ن
هلهل	ه ل ه ل
دعونا	د ع و ن ا
اكتشف	ا ك ت ش ف
مشاريع	م ش ا ر ي ع
كن	ك ن
كتبت	ك ت ب ت
تتم	ت ت م
أيوب	أ ي و ب
وكيل	و ك ي ل
لكي	ل ك ي
وليد	و ل ي د
تتكلم	ت ت ك ل م
زوايا	ز و ا ي ا
صلاح	ص ل ا ح
أقول	أ ق و ل
تحترم	ت ح ت ر م
مرحلة	م ر ح ل ة
أهملت	أ ه م ل ت
قوس	ق و س
تصدر	ت ص د ر
عسكريون	ع س ك ر ي و ن
نريد	ن ر ي د
تربي	ت ر ب ي
حنا	ح ن ا
تقع	ت ق ع
أقرب	أ ق ر ب
منى	م ن ى
سيد	س ي د
مكتوب	م ك ت و ب
انتشار	ا ن ت ش ا ر
مرحلة	م ر ح ل ة
أطلقت	أ ط ل ق ت
أنقص	أ ن ق ص
شبه	ش ب ه
يرتقي	ي ر ت ق ي
عبارة	ع ب ا ر ة
جمهورية	ج م ه و ر ي ة
حديد	ح د ي د
يعطوا	ي ع ط و ا
أقيمت	أ ق ي م ت
اقتصادية	ا ق ت ص ا د ي ة
فتحت	ف ت ح ت
إليكم	إ ل ي ك م
ملاحظات	م ل ا ح ظ ا ت
حوادث	ح و ا د ث
يختلف	ي خ ت ل ف
تمثيل	ت م ث ي ل
بقيت	ب ق ي ت
انفطرت	ا ن ف ط ر ت
ولد	و ل د
منى	م ن ى
أوروبية	أ و ر و ب ي ة
تاجر	ت ا ج ر
مشاريع	م ش ا ر ي ع
كيلومتر	ك ي ل و م ت ر
مشاكل	م ش ا ك ل
حاجة	ح ا ج ة
سحق	س ح ق
تنبذ	ت ن ب ذ
دوري	د و ر ي
قم	ق م
شعري	ش ع ر ي
إحياء	إ ح ي ا ء
متميزة	م ت م ي ز ة
عني	ع ن ي
دنيا	د ن ي ا
تشغيل	ت ش غ ي ل
وراء	و ر ا ء
احتلال	ا ح ت ل ا ل
وجل	و ج ل
مخالف	م خ ا ل ف
ثقافية	ث ق ا ف ي ة
تكنولوجيا	ت ك ن و ل و ج ي ا
مدرسة	م د ر س ة
محركات	م ح ر ك ا ت
عائشة	ع ا ئ ش ة
بسيط	ب س ي ط
تخمين	ت خ م ي ن
قليلة	ق ل ي ل ة
تتمتع	ت ت م ت ع
ليبيا	ل ي ب ي ا
كاتب	ك ا ت ب
محرك	م ح ر ك
أقدام	أ ق د ا م
خيالية	خ ي ا ل ي ة
جعلت	ج ع ل ت
يؤدي	ي ؤ د ي
شأن	ش أ ن
سلامة	س ل ا م ة
متميزة	م ت م ي ز ة
جددنا	ج د د ن ا
إجراء	إ ج ر ا ء
عصر	ع ص ر
رجال	ر ج ا ل
ضغط	ض غ ط
يوحنا	ي و ح ن ا
حار	ح ا ر
وحش	و ح ش
يبق	ي ب ق
د	د
ممثل	م م ث ل
صندوق	ص ن د و ق
أعربت	أ ع ر ب ت
معترك	م ع ت ر ك
يسبق	ي س ب ق
يعقوب	ي ع ق و ب
التزام	ا ل ت ز ا م
اشرف	ا ش ر ف
كشف	ك ش ف
يقع	ي ق ع
مبلغ	م ب ل غ
حملت	ح م ل ت
مؤشر	م ؤ ش ر
شعر	ش ع ر
تراجع	ت ر ا ج ع
عمان	ع م ا ن
شارع	ش ا ر ع
جمادى	ج م ا د ى
مشاهد	م ش ا ه د
داوود	د ا و و د
حمد	ح م د
إقامة	إ ق ا م ة
عين	ع ي ن
أمطار	أ م ط ا ر
المريخ	ا ل م ر ي خ
أحمر	أ ح م ر
كرة	ك ر ة
شرط	ش ر ط
ناحية	ن ا ح ي ة
الأسد	ا ل أ س د
مرتاح	م ر ت ا ح
ووفي	و و ف ي
جميل	ج م ي ل
دخول	د خ و ل
رائعة	ر ا ئ ع ة
داعش	د ا ع ش
تمت	ت م ت
تهبط	ت ه ب ط
مبارك	م ب ا ر ك
قامت	ق ا م ت
يفصح	ي ف ص ح
نشيط	ن ش ي ط
تدبرون	ت د ب ر و ن
تعمر	ت ع م ر
مقاعد	م ق ا ع د
أذاكر	أ ذ ا ك ر
حساسية	ح س ا س ي ة
زكاة	ز ك ا ة
تبنى	ت ب ن ى
جملة	ج م ل ة
طيلة	ط ي ل ة
أمان	أ م ا ن
متعاون	م ت ع ا و ن
عزل	ع ز ل
يكسر	ي ك س ر
سريعة	س ر ي ع ة
تعلن	ت ع ل ن
ياسمين	ي ا س م ي ن
خمس	خ م س
نجحت	ن ج ح ت
أرسطو	أ ر س ط و
التقت	ا ل ت ق ت
عود	ع و د
صحفي	ص ح ف ي
صحيح	ص ح ي ح
تشجع	ت ش ج ع
غزة	غ ز ة
يختلف	ي خ ت ل ف
لبناني	ل ب ن ا ن ي
تشير	ت ش ي ر
مربع	م ر ب ع
صوفيا	ص و ف ي ا
مراجعة	م ر ا ج ع ة
آراء	آ ر ا ء
اثنين	ا ث ن ي ن
مضيئة	م ض ي ئ ة
سبعين	س ب ع ي ن
ملايين	م ل ا ي ي ن
منظمة	م ن ظ م ة
تقطيع	ت ق ط ي ع
دستور	د س ت و ر
عودة	ع و د ة
سياسية	س ي ا س ي ة
متر	م ت ر
حصل	ح ص ل
سوى	س و ى
رحمة	ر ح م ة
بطاقات	ب ط ا ق ا ت
توقف	ت و ق ف
تناقش	ت ن ا ق ش
لبى	ل ب ى
عروض	ع ر و ض
قيامة	ق ي ا م ة
اكتشف	ا ك ت ش ف
تصاب	ت ص ا ب
أشد	أ ش د
أشكال	أ ش ك ا ل
مرحاض	م ر ح ا ض
سليمان	س ل ي م ا ن
مرحلة	م ر ح ل ة
منصور	م ن ص و ر
لد	ل د
يسبق	ي س ب ق
ابحث	ا ب ح ث
تعلم	ت ع ل م
مخيم	م خ ي م
صلاح	ص ل ا ح
زاوية	ز ا و ي ة
دخل	د خ ل
خطأ	خ ط أ
صحي	ص ح ي
بعيد	ب ع ي د
يؤدي	ي ؤ د ي
تلف	ت ل ف
قالب	ق ا ل ب
وطني	و ط ن ي
الأسد	ا ل أ س د
النيل	ا ل ن ي ل
سوى	س و ى
يقطن	ي ق ط ن
اثنان	ا ث ن ا ن
تعميق	ت ع م ي ق
وجوه	و ج و ه
عائلة	ع ا ئ ل ة
ضرورة	ض ر و ر ة
مدريد	م د ر ي د
تنزل	ت ن ز ل
يسهل	ي س ه ل
أساعد	أ س ا ع د
رشيد	ر ش ي د
اليابان	ا ل ي ا ب ا ن
خان	خ ا ن
ماليزيا	م ا ل ي ز ي ا
متناول	م ت ن ا و ل
كيك	ك ي ك
ميدان	م ي د ا ن
أضيفت	أ ض ي ف ت
صلابة	ص ل ا ب ة
أصحاب	أ ص ح ا ب
ضغط	ض غ ط
تزيد	ت ز ي د
أسف	أ س ف
فساد	ف س ا د
بكرة	ب ك ر ة
خلفية	خ ل ف ي ة
استمر	ا س ت م ر
برميل	ب ر م ي ل
بغداد	ب غ د ا د
كرة	ك ر ة
منظمة	م ن ظ م ة
نجوم	ن ج و م
ذاكرة	ذ ا ك ر ة
أود	أ و د
يختار	ي خ ت ا ر
مائة	م ا ئ ة
دخول	د خ و ل
مي	م ي
ذهب	ذ ه ب
استحال	ا س ت ح ا ل
جواز	ج و ا ز
يفتح	ي ف ت ح
مهلة	م ه ل ة
السرطان	ا ل س ر ط ا ن
مقطع	م ق ط ع
ظلام	ظ ل ا م
يجوز	ي ج و ز
عروض	ع ر و ض
معهد	م ع ه د
ساحة	س ا ح ة
جدة	ج د ة
جينز	ج ي ن ز
يفرض	ي ف ر ض
نبحث	ن ب ح ث
حكام	ح ك ا م
وراء	و ر ا ء
منتج	م ن ت ج
أبيض	أ ب ي ض
نوم	ن و م
مرادف	م ر ا د ف
جدول	ج د و ل
اضافة	ا ض ا ف ة
هامة	ه ا م ة
لغات	ل غ ا ت
موجة	م و ج ة
لاحظ	ل ا ح ظ
نريد	ن ر ي د
تحدث	ت ح د ث
أستطيع	أ س ت ط ي ع
ريم	ر ي م
محبة	م ح ب ة
مخاطر	م خ ا ط ر
حدا	ح د ا
بؤس	ب ؤ س
مربعة	م ر ب ع ة
لقاح	ل ق ا ح
طه	ط ه
وجدت	و ج د ت
القاعدة	ا ل ق ا ع د ة
شركاء	ش ر ك ا ء
رشيد	ر ش ي د
غياب	غ ي ا ب
يوجب	ي و ج ب
طوال	ط و ا ل
علوم	ع ل و م
ورقة	و ر ق ة
نعم	ن ع م
يجمع	ي ج م ع
دخول	د خ و ل
نهائي	ن ه ا ئ ي
مترجمة	م ت ر ج م ة
حلو	ح ل و
قدمت	ق د م ت
قتل	ق ت ل
البحرين	ا ل ب ح ر ي ن
مرض	م ر ض
خيار	خ ي ا ر
نرى	ن ر ى
سويسرا	س و ي س ر ا
مرحلة	م ر ح ل ة
موسم	م و س م
شعبية	ش ع ب ي ة
الأسد	ا ل أ س د
مطرقة	م ط ر ق ة
أطول	أ ط و ل
علمي	ع ل م ي
أقيمت	أ ق ي م ت
استثناء	ا س ت ث ن ا ء
يوقف	ي و ق ف
إنسان	إ ن س ا ن
هيام	ه ي ا م
مجهر	م ج ه ر
نهائي	ن ه ا ئ ي
شرق	ش ر ق
موقف	م و ق ف
خلق	خ ل ق
أولئك	أ و ل ئ ك
مشاعر	م ش ا ع ر
شاهين	ش ا ه ي ن
نقلت	ن ق ل ت
عمرو	ع م ر و
مصير	م ص ي ر
موقف	م و ق ف
فكرة	ف ك ر ة
احتواء	ا ح ت و ا ء
خريف	خ ر ي ف
حدث	ح د ث
يد	ي د
النار	ا ل ن ا ر
أحلى	أ ح ل ى
وراء	و ر ا ء
شارع	ش ا ر ع
قرن	ق ر ن
شبه	ش ب ه
سياسة	س ي ا س ة
ناعمة	ن ا ع م ة
عموما	ع م و م ا
جدوى	ج د و ى
جمعية	ج م ع ي ة
إل	إ ل
اربد	ا ر ب د
عدل	ع د ل
كوبنهاجن	ك و ب ن ه ا ج ن
تشكيل	ت ش ك ي ل
الأمين	ا ل أ م ي ن
سعد	س ع د
إله	إ ل ه
تعلن	ت ع ل ن
عالي	ع ا ل ي
أوروبية	أ و ر و ب ي ة
شرط	ش ر ط
يفتقر	ي ف ت ق ر
حرارة	ح ر ا ر ة
إجراء	إ ج ر ا ء
يتكلم	ي ت ك ل م
ساخر	س ا خ ر
وظيفة	و ظ ي ف ة
حادث	ح ا د ث
صنع	ص ن ع
خلف	خ ل ف
توليد	ت و ل ي د
جوز	ج و ز
رائحة	ر ا ئ ح ة
نجت	ن ج ت
أية	أ ي ة
أضاع	أ ض ا ع
قلوب	ق ل و ب
نور	ن و ر
يوحنا	ي و ح ن ا
مرسى	م ر س ى
مائة	م ا ئ ة
مركزي	م ر ك ز ي
تكشف	ت ك ش ف
صندوق	ص ن د و ق
تمت	ت م ت
إنتاج	إ ن ت ا ج
فرقة	ف ر ق ة
تحدث	ت ح د ث
شجرة	ش ج ر ة
فاز	ف ا ز
ظهرت	ظ ه ر ت
خادم	خ ا د م
وصفوا	و ص ف و ا
كشف	ك ش ف
أدى	أ د ى
يلتقي	ي ل ت ق ي
خزنة	خ ز ن ة
ترى	ت ر ى
مصطفى	م ص ط ف ى
ترجمة	ت ر ج م ة
قضايا	ق ض ا ي ا
زائر	ز ا ئ ر
أبت	أ ب ت
يد	ي د
كانون	ك ا ن و ن
يبلغ	ي ب ل غ
أ	أ
مظهر	م ظ ه ر
أ	أ
موعد	م و ع د
انشر	ا ن ش ر
قادر	ق ا د ر
أسرار	أ س ر ا ر
دمع	د م ع
غرار	غ ر ا ر
يؤدي	ي ؤ د ي
شأن	ش أ ن
جمال	ج م ا ل
اعمل	ا ع م ل
قم	ق م
قرب	ق ر ب
محافظ	م ح ا ف ظ
زهراء	ز ه ر ا ء
تحلق	ت ح ل ق
ضباط	ض ب ا ط
أقيمت	أ ق ي م ت
ضاحية	ض ا ح ي ة
يتولد	ي ت و ل د
نفوذ	ن ف و ذ
ضباط	ض ب ا ط
يقاوم	ي ق ا و م
مبلغ	م ب ل غ
سيدات	س ي د ا ت
تواصل	ت و ا ص ل
كاليفورنيا	ك ا ل ي ف و ر ن ي ا
مباريات	م ب ا ر ي ا ت
دكتور	د ك ت و ر
إنسانية	إ ن س ا ن ي ة
للغاية	ل ل غ ا ي ة
أحترم	أ ح ت ر م
تصنع	ت ص ن ع
محبة	م ح ب ة
منتج	م ن ت ج
غرباء	غ ر ب ا ء
نبيل	ن ب ي ل
أنتم	أ ن ت م
ابرز	ا ب ر ز
أشار	أ ش ا ر
قدمت	ق د م ت
تعلن	ت ع ل ن
أقام	أ ق ا م
الراية	ا ل ر ا ي ة
أكدت	أ ك د ت
جدة	ج د ة
يسقط	ي س ق ط
شقة	ش ق ة
اتفاق	ا ت ف ا ق
حديد	ح د ي د
أعقاب	أ ع ق ا ب
مار	م ا ر
يخاطب	ي خ ا ط ب
انعكس	ا ن ع ك س
مساعد	م س ا ع د
جم	ج م
خمري	خ م ر ي
مرحبا	م ر ح ب ا
مثيل	م ث ي ل
تواصل	ت و ا ص ل
تفوق	ت ف و ق
احصل	ا ح ص ل
خلفية	خ ل ف ي ة
شئت	ش ئ ت
دل	د ل
سهولة	س ه و ل ة
حبيبي	ح ب ي ب ي
حكام	ح ك ا م
مرمى	م ر م ى
السويس	ا ل س و ي س
يحل	ي ح ل
تجريم	ت ج ر ي م
سرقت	س ر ق ت
أستطيع	أ س ت ط ي ع
خليفة	خ ل ي ف ة
تعلمنا	ت ع ل م ن ا
تتابع	ت ت ا ب ع
سيد	س ي د
خبير	خ ب ي ر
رشيد	ر ش ي د
افكر	ا ف ك ر
أحلى	أ ح ل ى
شعبنا	ش ع ب ن ا
رجال	ر ج ا ل
نلاحظ	ن ل ا ح ظ
تامة	ت ا م ة
أقرأ	أ ق ر أ
سلطان	س ل ط ا ن
صغرى	ص غ ر ى
الشمس	ا ل ش م س
السفن	ا ل س ف ن
دك	د ك
تؤكد	ت ؤ ك د
دفع	د ف ع
بالفعل	ب ا ل ف ع ل
تحوي	ت ح و ي
فنية	ف ن ي ة
ينصح	ي ن ص ح
خطة	خ ط ة
نذير	ن ذ ي ر
أشار	أ ش ا ر
رأى	ر أ ى
ستة	س ت ة
ذكرت	ذ ك ر ت
إصدار	إ ص د ا ر
مان	م ا ن
مهرجان	م ه ر ج ا ن
طهران	ط ه ر ا ن
يفيد	ي ف ي د
كرة	ك ر ة
طيب	ط ي ب
فكرة	ف ك ر ة
تحدد	ت ح د د
مرحلة	م ر ح ل ة
طب	ط ب
يدافع	ي د ا ف ع
يلقي	ي ل ق ي
رضي	ر ض ي
ترجمة	ت ر ج م ة
غرف	غ ر ف
يؤدي	ي ؤ د ي
تطلق	ت ط ل ق
منصب	م ن ص ب
سلامة	س ل ا م ة
عقوبات	ع ق و ب ا ت
سن	س ن
الشمس	ا ل ش م س
مرور	م ر و ر
جزء	ج ز ء
أغطية	أ غ ط ي ة
قاسم	ق ا س م
قريش	ق ر ي ش
ميكروويف	م ي ك ر و و ي ف
مقطع	م ق ط ع
أستشهد	أ س ت ش ه د
ضمان	ض م ا ن
مريم	م ر ي م
أوت	أ و ت
تقول	ت ق و ل
إطلاق	إ ط ل ا ق
الرحمن	ا ل ر ح م ن
عودة	ع و د ة
تبدلت	ت ب د ل ت
شجرة	ش ج ر ة
يختلف	ي خ ت ل ف
قيامة	ق ي ا م ة
عزل	ع ز ل
نصيب	ن ص ي ب
سيل	س ي ل
انفجار	ا ن ف ج ا ر
أ	أ
يضم	ي ض م
يجوز	ي ج و ز
خريج	خ ر ي ج
بكين	ب ك ي ن
أمانة	أ م ا ن ة
قذف	ق ذ ف
يوما	ي و م ا
أوقات	أ و ق ا ت
فين	ف ي ن
جون	ج و ن
هيا	ه ي ا
يتوقف	ي ت و ق ف
عراقية	ع ر ا ق ي ة
صبري	ص ب ر ي
يستطيع	ي س ت ط ي ع
كانون	ك ا ن و ن
مضت	م ض ت
أوقات	أ و ق ا ت
أشكر	أ ش ك ر
استعمال	ا س ت ع م ا ل
فيروس	ف ي ر و س
يغلق	ي غ ل ق
شكر	ش ك ر
بنك	ب ن ك
أسلاك	أ س ل ا ك
يوفق	ي و ف ق
موافق	م و ا ف ق
قطعت	ق ط ع ت
نيويورك	ن ي و ي و ر ك
زمان	ز م ا ن
بار	ب ا ر
لحظة	ل ح ظ ة
مدريد	م د ر ي د
إفريقيا	إ ف ر ي ق ي ا
رجال	ر ج ا ل
مصطفى	م ص ط ف ى
أسماء	أ س م ا ء
تقرأ	ت ق ر أ
حلب	ح ل ب
صفا	ص ف ا
نساء	ن س ا ء
جودة	ج و د ة
تزيد	ت ز ي د
تقويم	ت ق و ي م
النيجر	ا ل ن ي ج ر
يريدون	ي ر ي د و ن
غياب	غ ي ا ب
نهدف	ن ه د ف
سم	س م
اقل	ا ق ل
خطأ	خ ط أ
الأمين	ا ل أ م ي ن
حمد	ح م د
قدمت	ق د م ت
امتحانات	ا م ت ح ا ن ا ت
ازداد	ا ز د ا د
بنت	ب ن ت
ساخنة	س ا خ ن ة
مراجعة	م ر ا ج ع ة
يوفر	ي و ف ر
ينهي	ي ن ه ي
تمتد	ت م ت د
حذر	ح ذ ر
مدح	م د ح
قاسم	ق ا س م
تفوق	ت ف و ق
آب	آ ب
جعفر	ج ع ف ر
ترى	ت ر ى
عاش	ع ا ش
إصدار	إ ص د ا ر
أيوب	أ ي و ب
طرابزون	ط ر ا ب ز و ن
منظمة	م ن ظ م ة
عانى	ع ا ن ى
والدة	و ا ل د ة
مقدمة	م ق د م ة
تصر	ت ص ر
عناد	ع ن ا د
عرضت	ع ر ض ت
فرص	ف ر ص
بنت	ب ن ت
خطأ	خ ط أ
قيم	ق ي م
تكنولوجيا	ت ك ن و ل و ج ي ا
ملابس	م ل ا ب س
هـ	ه ـ
حفلة	ح ف ل ة
فرحون	ف ر ح و ن
خلط	خ ل ط
أوروبا	أ و ر و ب ا
داعش	د ا ع ش
تمت	ت م ت
ابحث	ا ب ح ث
يجوز	ي ج و ز
توجيه	ت و ج ي ه
أقول	أ ق و ل
عالمية	ع ا ل م ي ة
قالوا	ق ا ل و ا
ماتت	م ا ت ت
صولة	ص و ل ة
اعتبر	ا ع ت ب ر
أعياد	أ ع ي ا د
أوسع	أ و س ع
مؤتمرات	م ؤ ت م ر ا ت
ذكور	ذ ك و ر
يد	ي د
عذاب	ع ذ ا ب
أعداء	أ ع د ا ء
حديد	ح د ي د
محرك	م ح ر ك
مسرح	م س ر ح
تحرير	ت ح ر ي ر
أجزاء	أ ج ز ا ء
جولة	ج و ل ة
ضم	ض م
متأخر	م ت أ خ ر
أنبوب	أ ن ب و ب
اعتبر	ا ع ت ب ر
تصريح	ت ص ر ي ح
محل	م ح ل
رؤوس	ر ؤ و س
نجوم	ن ج و م
مزدوج	م ز د و ج
يستخدم	ي س ت خ د م
انتشار	ا ن ت ش ا ر
نزع	ن ز ع
لمى	ل م ى
لحظة	ل ح ظ ة
مواسير	م و ا س ي ر
دين	د ي ن
يدخل	ي د خ ل
فنية	ف ن ي ة
قوائم	ق و ا ئ م
اعمل	ا ع م ل
اكتشف	ا ك ت ش ف
وليد	و ل ي د
وجدت	و ج د ت
تشكيل	ت ش ك ي ل
يلي	ي ل ي
أ	أ
مالي	م ا ل ي
لكي	ل ك ي
نزع	ن ز ع
يلي	ي ل ي
واجهة	و ا ج ه ة
وجدت	و ج د ت
هبة	ه ب ة
يعبد	ي ع ب د
سفرة	س ف ر ة
اقترح	ا ق ت ر ح
يكتب	ي ك ت ب
خلل	خ ل ل
طابعة	ط ا ب ع ة
جسدت	ج س د ت
صن	ص ن
بكرة	ب ك ر ة
شروط	ش ر و ط
منور	م ن و ر
تقول	ت ق و ل
واد	و ا د
أقسام	أ ق س ا م
مستمر	م س ت م ر
سريع	س ر ي ع
علاء	ع ل ا ء
مؤشر	م ؤ ش ر
شرق	ش ر ق
اختير	ا خ ت ي ر
مورد	م و ر د
شرق	ش ر ق
هنأ	ه ن أ
يقدم	ي ق د م
قوافل	ق و ا ف ل
مقر	م ق ر
شاشة	ش ا ش ة
أطفئوا	أ ط ف ئ و ا
أربعة	أ ر ب ع ة
الأردن	ا ل أ ر د ن
كويتية	ك و ي ت ي ة
نوم	ن و م
دفع	د ف ع
تفتح	ت ف ت ح
إليهم	إ ل ي ه م
قدرة	ق د ر ة
قريبة	ق ر ي ب ة
منتخب	م ن ت خ ب
طائرة	ط ا ئ ر ة
يشهد	ي ش ه د
يشكر	ي ش ك ر
بمناسبة	ب م ن ا س ب ة
ميدان	م ي د ا ن
ازداد	ا ز د ا د
محل	م ح ل
زهرة	ز ه ر ة
أمير	أ م ي ر
عز	ع ز
إسرائيليون	إ س ر ا ئ ي ل ي و ن
ضمان	ض م ا ن
ندا	ن د ا
بكين	ب ك ي ن
صيغ	ص ي غ
النار	ا ل ن ا ر
يقولون	ي ق و ل و ن
معماري	م ع م ا ر ي
تطاول	ت ط ا و ل
تدهور	ت د ه و ر
يشكل	ي ش ك ل
أستطيع	أ س ت ط ي ع
أعلنت	أ ع ل ن ت
دخول	د خ و ل
قضاء	ق ض ا ء
ضجة	ض ج ة
ثابتة	ث ا ب ت ة
صلاح	ص ل ا ح
قماش	ق م ا ش
فساتين	ف س ا ت ي ن
تكشف	ت ك ش ف
خضوع	خ ض و ع
القاعدة	ا ل ق ا ع د ة
زيدان	ز ي د ا ن
نجد	ن ج د
أراد	أ ر ا د
متوسط	م ت و س ط
موسم	م و س م
منزل	م ن ز ل
تتوقف	ت ت و ق ف
غلاف	غ ل ا ف
شاهد	ش ا ه د
قضائي	ق ض ا ئ ي
عمم	ع م م
لكي	ل ك ي
صحيح	ص ح ي ح
تسمح	ت س م ح
واجهة	و ا ج ه ة
وزراء	و ز ر ا ء
عطية	ع ط ي ة
شهداء	ش ه د ا ء
ملعقة	م ل ع ق ة
يشير	ي ش ي ر
معهد	م ع ه د
مكلف	م ك ل ف
السرطان	ا ل س ر ط ا ن
فرق	ف ر ق
عامر	ع ا م ر
حققت	ح ق ق ت
فقيه	ف ق ي ه
حرار	ح ر ا ر
الشمس	ا ل ش م س
عدن	ع د ن
يدور	ي د و ر
تأخر	ت أ خ ر
سيد	س ي د
ربع	ر ب ع
صعيد	ص ع ي د
شغل	ش غ ل
يؤدي	ي ؤ د ي
استهدف	ا س ت ه د ف
كاتب	ك ا ت ب
أبوظبي	أ ب و ظ ب ي
إقامة	إ ق ا م ة
شعر	ش ع ر
مجددا	م ج د د ا
رؤية	ر ؤ ي ة
سلطة	س ل ط ة
سم	س م
يفتح	ي ف ت ح
رئيسية	ر ئ ي س ي ة
كرة	ك ر ة
شعبنا	ش ع ب ن ا
كوم	ك و م
تجري	ت ج ر ي
فر	ف ر
تفسير	ت ف س ي ر
ميدان	م ي د ا ن
ثبت	ث ب ت
تشكل	ت ش ك ل
خطوط	خ ط و ط
دورة	د و ر ة
موعد	م و ع د
تسوقوا	ت س و ق و ا
عالمية	ع ا ل م ي ة
اتخاذ	ا ت خ ا ذ
شهدت	ش ه د ت
أخر	أ خ ر
هامة	ه ا م ة
واحة	و ا ح ة
نحافظ	ن ح ا ف ظ
مجددا	م ج د د ا
قرب	ق ر ب
الفرات	ا ل ف ر ا ت
تأمن	ت أ م ن
نص	ن ص
قرارات	ق ر ا ر ا ت
جمهورية	ج م ه و ر ي ة
عصرنا	ع ص ر ن ا
عادت	ع ا د ت
الحمل	ا ل ح م ل
انتماء	ا ن ت م ا ء
تقاطع	ت ق ا ط ع
حزين	ح ز ي ن
فائدة	ف ا ئ د ة
متوفر	م ت و ف ر
مواسم	م و ا س م
مديرة	م د ي ر ة
تستقر	ت س ت ق ر
ذهبت	ذ ه ب ت
منفردة	م ن ف ر د ة
تؤدي	ت ؤ د ي
ملابس	م ل ا ب س
مهارات	م ه ا ر ا ت
عائلة	ع ا ئ ل ة
عرب	ع ر ب
اول	ا و ل
ذنوب	ذ ن و ب
أقصى	أ ق ص ى
نأمل	ن أ م ل
صلاة	ص ل ا ة
يسري	ي س ر ي
جرى	ج ر ى
سلمت	س ل م ت
عدي	ع د ي
انقطع	ا ن ق ط ع
النرويج	ا ل ن ر و ي ج
ذوات	ذ و ا ت
مذهب	م ذ ه ب
سيئون	س ي ئ و ن
تكسب	ت ك س ب
أقيم	أ ق ي م
أبحاث	أ ب ح ا ث
أعظم	أ ع ظ م
كلما	ك ل م ا
يصف	ي ص ف
عدنان	ع د ن ا ن
در	د ر
د	د
نجران	ن ج ر ا ن
تمت	ت م ت
سوى	س و ى
يعنى	ي ع ن ى
نسير	ن س ي ر
سورة	س و ر ة
اجتماعية	ا ج ت م ا ع ي ة
معقل	م ع ق ل
كذب	ك ذ ب
هاد	ه ا د
بنا	ب ن ا
يحاول	ي ح ا و ل
نصر	ن ص ر
عملي	ع م ل ي
صندوق	ص ن د و ق
يدفن	ي د ف ن
ولد	و ل د
مؤلف	م ؤ ل ف
تتحكم	ت ت ح ك م
نافذة	ن ا ف ذ ة
أنيس	أ ن ي س
علوم	ع ل و م
بيس	ب ي س
أطول	أ ط و ل
نزعم	ن ز ع م
يلي	ي ل ي
كي	ك ي
ن	ن
معاهدة	م ع ا ه د ة
رقيق	ر ق ي ق
تفضيل	ت ف ض ي ل
رائعة	ر ا ئ ع ة
أ	أ
سويسرا	س و ي س ر ا
حذار	ح ذ ا ر
زيتون	ز ي ت و ن
إجراء	إ ج ر ا ء
تتغير	ت ت غ ي ر
وكيل	و ك ي ل
محلي	م ح ل ي
مسيرة	م س ي ر ة
تبارك	ت ب ا ر ك
بطارية	ب ط ا ر ي ة
بوابة	ب و ا ب ة
أصفر	أ ص ف ر
تحتوي	ت ح ت و ي
فهم	ف ه م
غريبة	غ ر ي ب ة
أية	أ ي ة
لمن	ل م ن
مقدمة	م ق د م ة
قات	ق ا ت
تقع	ت ق ع
آنذاك	آ ن ذ ا ك
يصعد	ي ص ع د
تأتي	ت أ ت ي
يجري	ي ج ر ي
ذو	ذ و
مديرة	م د ي ر ة
رفضت	ر ف ض ت
الثور	ا ل ث و ر
يعقوبيان	ي ع ق و ب ي ا ن
جزء	ج ز ء
تحتوي	ت ح ت و ي
تظهر	ت ظ ه ر
روح	ر و ح
تشغيل	ت ش غ ي ل
نظريات	ن ظ ر ي ا ت
أصحاب	أ ص ح ا ب
ليبيا	ل ي ب ي ا
عار	ع ا ر
آن	آ ن
يحول	ي ح و ل
جريح	ج ر ي ح
يستقيم	ي س ت ق ي م
رأيت	ر أ ي ت
ضرورة	ض ر و ر ة
خلفية	خ ل ف ي ة
طائرات	ط ا ئ ر ا ت
عيون	ع ي و ن
صفع	ص ف ع
لوحة	ل و ح ة
حفل	ح ف ل
تقدير	ت ق د ي ر
بغداد	ب غ د ا د
صندوق	ص ن د و ق
فولت	ف و ل ت
أرباح	أ ر ب ا ح
نفور	ن ف و ر
دوري	د و ر ي
رضي	ر ض ي
جودة	ج و د ة
صباح	ص ب ا ح
يستطيع	ي س ت ط ي ع
ملف	م ل ف
قضايا	ق ض ا ي ا
قضايا	ق ض ا ي ا
فلح	ف ل ح
شهدت	ش ه د ت
قتل	ق ت ل
نعام	ن ع ا م
يسألون	ي س أ ل و ن
منتخب	م ن ت خ ب
يسير	ي س ي ر
اداء	ا د ا ء
يستقبل	ي س ت ق ب ل
مساعد	م س ا ع د
جارية	ج ا ر ي ة
اتصال	ا ت ص ا ل
شروط	ش ر و ط
شكر	ش ك ر
ناقل	ن ا ق ل
مائة	م ا ئ ة
أعلنت	أ ع ل ن ت
يولى	ي و ل ى
يبقى	ي ب ق ى
مسجد	م س ج د
صحيحة	ص ح ي ح ة
يحيي	ي ح ي ي
هامة	ه ا م ة
أخجل	أ خ ج ل
اعني	ا ع ن ي
إنما	إ ن م ا
اجتهاد	ا ج ت ه ا د
مدة	م د ة
فريدة	ف ر ي د ة
كاتب	ك ا ت ب
تعلن	ت ع ل ن
سحق	س ح ق
أسواق	أ س و ا ق
دق	د ق
عقود	ع ق و د
حواء	ح و ا ء
نيل	ن ي ل
طائرة	ط ا ئ ر ة
كوالا	ك و ا ل ا
الأردن	ا ل أ ر د ن
آنذاك	آ ن ذ ا ك
مدة	م د ة
رمت	ر م ت
يتجانس	ي ت ج ا ن س
مخالف	م خ ا ل ف
حفل	ح ف ل
ليثيوم	ل ي ث ي و م
هذي	ه ذ ي
يتحدث	ي ت ح د ث
بدء	ب د ء
مدارس	م د ا ر س
مسرح	م س ر ح
اليونان	ا ل ي و ن ا ن
النيل	ا ل ن ي ل
ناردين	ن ا ر د ي ن
استهدفت	ا س ت ه د ف ت
يشير	ي ش ي ر
تجريبي	ت ج ر ي ب ي
يعلمون	ي ع ل م و ن
شوارع	ش و ا ر ع
أين	أ ي ن
أين	أ ي ن
ينظر	ي ن ظ ر
فجوة	ف ج و ة
أدخل	أ د خ ل
توفر	ت و ف ر
خاتون	خ ا ت و ن
مرحبا	م ر ح ب ا
اجتمعت	ا ج ت م ع ت
باي	ب ا ي
منازل	م ن ا ز ل
كرة	ك ر ة
بلغت	ب ل غ ت
مؤسسات	م ؤ س س ا ت
خلود	خ ل و د
مات	م ا ت
صلاة	ص ل ا ة
قليلة	ق ل ي ل ة
يتقون	ي ت ق و ن
جزء	ج ز ء
أربعة	أ ر ب ع ة
تمتع	ت م ت ع
ودع	و د ع
استيراد	ا س ت ي ر ا د
عزل	ع ز ل
حلقة	ح ل ق ة
مهندس	م ه ن د س
مفتش	م ف ت ش
تعرض	ت ع ر ض
مناسبة	م ن ا س ب ة
المحرم	ا ل م ح ر م
إجراء	إ ج ر ا ء
يبلغ	ي ب ل غ
فشل	ف ش ل
اعتبار	ا ع ت ب ا ر
توجيه	ت و ج ي ه
سطح	س ط ح
براميل	ب ر ا م ي ل
بعثة	ب ع ث ة
سهل	س ه ل
متر	م ت ر
أجنحة	أ ج ن ح ة
طول	ط و ل
مديرة	م د ي ر ة
دنيا	د ن ي ا
عمرو	ع م ر و
أضاع	أ ض ا ع
حبيب	ح ب ي ب
رجاء	ر ج ا ء
درع	د ر ع
مهام	م ه ا م
وصلت	و ص ل ت
ابني	ا ب ن ي
زائر	ز ا ئ ر
عالمية	ع ا ل م ي ة
طيب	ط ي ب
أقصر	أ ق ص ر
أزمة	أ ز م ة
عدل	ع د ل
توقعت	ت و ق ع ت
بنك	ب ن ك
زرقاء	ز ر ق ا ء
سيما	س ي م ا
ساحة	س ا ح ة
رضي	ر ض ي
نوبة	ن و ب ة
طهران	ط ه ر ا ن
بطرس	ب ط ر س
وصول	و ص و ل
تنمية	ت ن م ي ة
بغدادي	ب غ د ا د ي
اجتماعات	ا ج ت م ا ع ا ت
إبراهيم	إ ب ر ا ه ي م
يجوز	ي ج و ز
أوروبا	أ و ر و ب ا
أشار	أ ش ا ر
هـ	ه ـ
جمع	ج م ع
سحب	س ح ب
تصريح	ت ص ر ي ح
تسمية	ت س م ي ة
تجميع	ت ج م ي ع
اعتراض	ا ع ت ر ا ض
مصير	م ص ي ر
ملف	م ل ف
حلب	ح ل ب
مجالات	م ج ا ل ا ت
تنمية	ت ن م ي ة
يجرح	ي ج ر ح
إنتاج	إ ن ت ا ج
قيادة	ق ي ا د ة
بنت	ب ن ت
عض	ع ض
ماليزيا	م ا ل ي ز ي ا
أقوال	أ ق و ا ل
مصائب	م ص ا ئ ب
تشكيل	ت ش ك ي ل
متوسط	م ت و س ط
يغير	ي غ ي ر
وجهة	و ج ه ة
استثناء	ا س ت ث ن ا ء
حاليا	ح ا ل ي ا
مؤاخذة	م ؤ ا خ ذ ة
مترجمة	م ت ر ج م ة
نجوم	ن ج و م
منصور	م ن ص و ر
طول	ط و ل
تواصل	ت و ا ص ل
عز	ع ز
سمحت	س م ح ت
تعلن	ت ع ل ن
منخفض	م ن خ ف ض
ألومنيوم	أ ل و م ن ي و م
دياب	د ي ا ب
أ	أ
تعرفون	ت ع ر ف و ن
قصور	ق ص و ر
أخبرنا	أ خ ب ر ن ا
حصد	ح ص د
صحيح	ص ح ي ح
سياسية	س ي ا س ي ة
نجيب	ن ج ي ب
تقارير	ت ق ا ر ي ر
إيقاف	إ ي ق ا ف
نصر	ن ص ر
فتحت	ف ت ح ت
سعد	س ع د
تلفظ	ت ل ف ظ
فشار	ف ش ا ر
جيش	ج ي ش
نقد	ن ق د
يورو	ي و ر و
مقارنة	م ق ا ر ن ة
مجالات	م ج ا ل ا ت
تترك	ت ت ر ك
مدفع	م د ف ع
ألا	أ ل ا
أعظم	أ ع ظ م
عادل	ع ا د ل
ورود	و ر و د
نية	ن ي ة
خصوصي	خ ص و ص ي
تحرم	ت ح ر م
واجبات	و ا ج ب ا ت
مؤتمر	م ؤ ت م ر
عز	ع ز
مثلما	م ث ل م ا
روح	ر و ح
مراقبة	م ر ا ق ب ة
فرحنا	ف ر ح ن ا
فرشاة	ف ر ش ا ة
صدري	ص د ر ي
مالك	م ا ل ك
اتخاذ	ا ت خ ا ذ
مطالبة	م ط ا ل ب ة
إيرانية	إ ي ر ا ن ي ة
كبح	ك ب ح
مترجمة	م ت ر ج م ة
حلقة	ح ل ق ة
لواء	ل و ا ء
قنابل	ق ن ا ب ل
سياسية	س ي ا س ي ة
أمير	أ م ي ر
اعرف	ا ع ر ف
بان	ب ا ن
عز	ع ز
غريبة	غ ر ي ب ة
مجلة	م ج ل ة
تمثال	ت م ث ا ل
اتفاقية	ا ت ف ا ق ي ة
يتوقع	ي ت و ق ع
أنيس	أ ن ي س
إزالة	إ ز ا ل ة
هيئات	ه ي ئ ا ت
راسخ	ر ا س خ
الدوحة	ا ل د و ح ة
ينظر	ي ن ظ ر
نصر	ن ص ر
فاز	ف ا ز
طول	ط و ل
عالمي	ع ا ل م ي
يجري	ي ج ر ي
سوى	س و ى
خلفية	خ ل ف ي ة
أمان	أ م ا ن
مات	م ا ت
تعمق	ت ع م ق
شكر	ش ك ر
خرجت	خ ر ج ت
أف	أ ف
نجيب	ن ج ي ب
أقصى	أ ق ص ى
إسبانيا	إ س ب ا ن ي ا
أقرب	أ ق ر ب
سب	س ب
ملابس	م ل ا ب س
تعلم	ت ع ل م
دورة	د و ر ة
تقارير	ت ق ا ر ي ر
جذب	ج ذ ب
ألا	أ ل ا
استقبل	ا س ت ق ب ل
ترى	ت ر ى
بصر	ب ص ر
تنزيل	ت ن ز ي ل
استمرت	ا س ت م ر ت
أشاد	أ ش ا د
عود	ع و د
نقاط	ن ق ا ط
خزامى	خ ز ا م ى
منتج	م ن ت ج
دوافع	د و ا ف ع
تفضل	ت ف ض ل
غياب	غ ي ا ب
جيش	ج ي ش
تحافظين	ت ح ا ف ظ ي ن
أشكال	أ ش ك ا ل
جزء	ج ز ء
أخبرنا	أ خ ب ر ن ا
تسلط	ت س ل ط
يحسبون	ي ح س ب و ن
دفع	د ف ع
مقدرة	م ق د ر ة
إبراهيم	إ ب ر ا ه ي م
غريبة	غ ر ي ب ة
أهلية	أ ه ل ي ة
اكتشف	ا ك ت ش ف
حامد	ح ا م د
اتصل	ا ت ص ل
عين	ع ي ن
ذو	ذ و
ربا	ر ب ا
سبعين	س ب ع ي ن
مدريد	م د ر ي د
هزم	ه ز م
وظيفة	و ظ ي ف ة
نقاط	ن ق ا ط
صفة	ص ف ة
جرجس	ج ر ج س
تصب	ت ص ب
يهربون	ي ه ر ب و ن
شعار	ش ع ا ر
عربية	ع ر ب ي ة
يهم	ي ه م
شارع	ش ا ر ع
يدخل	ي د خ ل
يستخدم	ي س ت خ د م
يدرى	ي د ر ى
شحن	ش ح ن
أسماء	أ س م ا ء
موت	م و ت
يعطي	ي ع ط ي
وجل	و ج ل
لكي	ل ك ي
دخول	د خ و ل
أفاد	أ ف ا د
سياسة	س ي ا س ة
أمسى	أ م س ى
إنجاز	إ ن ج ا ز
استعمال	ا س ت ع م ا ل
حضرموت	ح ض ر م و ت
يعنى	ي ع ن ى
ترحب	ت ر ح ب
بعيد	ب ع ي د
فيتنام	ف ي ت ن ا م
نشاط	ن ش ا ط
ضربة	ض ر ب ة
صندوق	ص ن د و ق
رضى	ر ض ى
متزوج	م ت ز و ج
شحن	ش ح ن
شقة	ش ق ة
بنى	ب ن ى
تحدي	ت ح د ي
إنتاج	إ ن ت ا ج
هشام	ه ش ا م
زمان	ز م ا ن
مؤتمر	م ؤ ت م ر
حادث	ح ا د ث
يشير	ي ش ي ر
نهب	ن ه ب
جو	ج و
فلاديمير	ف ل ا د ي م ي ر
هرتز	ه ر ت ز
عجائب	ع ج ا ئ ب
تشغيل	ت ش غ ي ل
برميل	ب ر م ي ل
يضم	ي ض م
سريع	س ر ي ع
جرائم	ج ر ا ئ م
تصريح	ت ص ر ي ح
فاز	ف ا ز
مجلة	م ج ل ة
نور	ن و ر
أدافع	أ د ا ف ع
شعبنا	ش ع ب ن ا
نختار	ن خ ت ا ر
أسرع	أ س ر ع
رؤية	ر ؤ ي ة
مطالعة	م ط ا ل ع ة
رائعة	ر ا ئ ع ة
كورة	ك و ر ة
توفر	ت و ف ر
عرب	ع ر ب
نيويورك	ن ي و ي و ر ك
لقاء	ل ق ا ء
شفط	ش ف ط
قطن	ق ط ن
خلفية	خ ل ف ي ة
إفريقيا	إ ف ر ي ق ي ا
تقطيع	ت ق ط ي ع
تكشف	ت ك ش ف
عميد	ع م ي د
توظيف	ت و ظ ي ف
لكي	ل ك ي
ملاحظة	م ل ا ح ظ ة
عقوبة	ع ق و ب ة
نعم	ن ع م
مركبة	م ر ك ب ة
متن	م ت ن
مكة	م ك ة
بطاقات	ب ط ا ق ا ت
عمرو	ع م ر و
حكاية	ح ك ا ي ة
إشارة	إ ش ا ر ة
صلاح	ص ل ا ح
أجنحة	أ ج ن ح ة
خلفية	خ ل ف ي ة
تلاقي	ت ل ا ق ي
فئة	ف ئ ة
ياالله	ي ا ا ل ل ه
يستفيد	ي س ت ف ي د
قصور	ق ص و ر
تذكر	ت ذ ك ر
مفر	م ف ر
آلام	آ ل ا م
دفة	د ف ة
إقامة	إ ق ا م ة
أجرى	أ ج ر ى
شقة	ش ق ة
يفتح	ي ف ت ح
استعرض	ا س ت ع ر ض
شارب	ش ا ر ب
منظر	م ن ظ ر
اقترب	ا ق ت ر ب
رياضة	ر ي ا ض ة
أشعار	أ ش ع ا ر
جماعة	ج م ا ع ة
يمثل	ي م ث ل
بان	ب ا ن
مسقط	م س ق ط
تتمتع	ت ت م ت ع
رشيد	ر ش ي د
دخول	د خ و ل
موضع	م و ض ع
يخدم	ي خ د م
دير	د ي ر
حفظ	ح ف ظ
كي	ك ي
انتخابات	ا ن ت خ ا ب ا ت
سهل	س ه ل
قليلة	ق ل ي ل ة
تحرير	ت ح ر ي ر
صندوق	ص ن د و ق
بحيرة	ب ح ي ر ة
مقارنة	م ق ا ر ن ة
عز	ع ز
يتحدث	ي ت ح د ث
أواخر	أ و ا خ ر
حامل	ح ا م ل
قبول	ق ب و ل
اختطاف	ا خ ت ط ا ف
قدمت	ق د م ت
يعكس	ي ع ك س
كيران	ك ي ر ا ن
تكرار	ت ك ر ا ر
غياب	غ ي ا ب
بنى	ب ن ى
أبناء	أ ب ن ا ء
انتخابات	ا ن ت خ ا ب ا ت
لادن	ل ا د ن
رحمة	ر ح م ة
قليلة	ق ل ي ل ة
مجددا	م ج د د ا
وزراء	و ز ر ا ء
كلما	ك ل م ا
إدخال	إ د خ ا ل
مفاجأة	م ف ا ج أ ة
مرات	م ر ا ت
نحدد	ن ح د د
مي	م ي
عناوين	ع ن ا و ي ن
وضوح	و ض و ح
قامت	ق ا م ت
حاجة	ح ا ج ة
ذكرت	ذ ك ر ت
موسم	م و س م
لقي	ل ق ي
قديمة	ق د ي م ة
أصحاب	أ ص ح ا ب
يلين	ي ل ي ن
لكي	ل ك ي
متوسط	م ت و س ط
فائدة	ف ا ئ د ة
ربع	ر ب ع
خميس	خ م ي س
أوسع	أ و س ع
يحول	ي ح و ل
طيران	ط ي ر ا ن
تشير	ت ش ي ر
خميس	خ م ي س
قماش	ق م ا ش
توقيت	ت و ق ي ت
ستار	س ت ا ر
كتبت	ك ت ب ت
البحرين	ا ل ب ح ر ي ن
عامر	ع ا م ر
عدا	ع د ا
أفكار	أ ف ك ا ر
سياق	س ي ا ق
ميشال	م ي ش ا ل
مداخل	م د ا خ ل
الزهرة	ا ل ز ه ر ة
نصل	ن ص ل
صنع	ص ن ع
مربع	م ر ب ع
بنا	ب ن ا
تتوقفي	ت ت و ق ف ي
شروع	ش ر و ع
تشغيل	ت ش غ ي ل
أدت	أ د ت
محبة	م ح ب ة
سياسية	س ي ا س ي ة
قاد	ق ا د
أدت	أ د ت
أغلب	أ غ ل ب
بنا	ب ن ا
هدنة	ه د ن ة
تقارير	ت ق ا ر ي ر
تحرك	ت ح ر ك
سوء	س و ء
سئل	س ئ ل
تشرين	ت ش ر ي ن
رائعة	ر ا ئ ع ة
أقول	أ ق و ل
خليل	خ ل ي ل
إرادة	إ ر ا د ة
نعم	ن ع م
اعرف	ا ع ر ف
مكتبة	م ك ت ب ة
تفاعلي	ت ف ا ع ل ي
بنا	ب ن ا
سما	س م ا
أزمة	أ ز م ة
ألمانيا	أ ل م ا ن ي ا
اقرأ	ا ق ر أ
أدت	أ د ت
تلاحظ	ت ل ا ح ظ
تفكير	ت ف ك ي ر
عبروا	ع ب ر و ا
سيد	س ي د
جدول	ج د و ل
محافظ	م ح ا ف ظ
قبيلة	ق ب ي ل ة
تؤدي	ت ؤ د ي
برشلونة	ب ر ش ل و ن ة
وسيلة	و س ي ل ة
طويلة	ط و ي ل ة
تغليف	ت غ ل ي ف
صعيد	ص ع ي د
تلميذة	ت ل م ي ذ ة
اختلط	ا خ ت ل ط
قانوني	ق ا ن و ن ي
تأهل	ت أ ه ل
يكتب	ي ك ت ب
ساكنة	س ا ك ن ة
موقف	م و ق ف
نية	ن ي ة
مؤشر	م ؤ ش ر
شمالي	ش م ا ل ي
كرة	ك ر ة
ممثل	م م ث ل
أماكن	أ م ا ك ن
جثة	ج ث ة
رائع	ر ا ئ ع
توفر	ت و ف ر
تقول	ت ق و ل
فضيلة	ف ض ي ل ة
أبناء	أ ب ن ا ء
ينظرون	ي ن ظ ر و ن
تسافر	ت س ا ف ر
عسكري	ع س ك ر ي
رائع	ر ا ئ ع
أطباء	أ ط ب ا ء
قدرة	ق د ر ة
بوتان	ب و ت ا ن
قماش	ق م ا ش
بان	ب ا ن
دخل	د خ ل
تثبت	ت ث ب ت
حفل	ح ف ل
أزمة	أ ز م ة
كلية	ك ل ي ة
إنقاذ	إ ن ق ا ذ
خطة	خ ط ة
ورقة	و ر ق ة
جدول	ج د و ل
آسيا	آ س ي ا
جزء	ج ز ء
يورو	ي و ر و
إبراهيم	إ ب ر ا ه ي م
هدد	ه د د
مياه	م ي ا ه
فعلوا	ف ع ل و ا
سياسي	س ي ا س ي
كاد	ك ا د
مدرسة	م د ر س ة
سياج	س ي ا ج
دوام	د و ا م
تسعة	ت س ع ة
تنمية	ت ن م ي ة
معقل	م ع ق ل
شجرة	ش ج ر ة
عودة	ع و د ة
احصل	ا ح ص ل
سار	س ا ر
مدين	م د ي ن
نوم	ن و م
تعاقبوا	ت ع ا ق ب و ا
اقتصاد	ا ق ت ص ا د
تزال	ت ز ا ل
التزام	ا ل ت ز ا م
محل	م ح ل
نسيت	ن س ي ت
الحركة	ا ل ح ر ك ة
اعمل	ا ع م ل
مني	م ن ي
جلسة	ج ل س ة
يغير	ي غ ي ر
بولي	ب و ل ي
فنلندا	ف ن ل ن د ا
لمن	ل م ن
نزل	ن ز ل
