3루	3 루
노숙하다	노 숙 하 다
不德義	不 德 義
완벽하다	완 벽 하 다
반가	반 가
콘테스트	콘 테 스 트
고사성어	고 사 성 어
가소롭다	가 소 롭 다
실례하다	실 례 하 다
졸다	졸 다
地下鐵驛	地 下 鐵 驛
가시화	가 시 화
대통령	대 통 령
䢖	䢖
모레	모 레
중국말	중 국 말
게젓	게 젓
가스레인지	가 스 레 인 지
精神勝利	精 神 勝 利
해열	해 열
-어도	- 어 도
태자	태 자
시누이	시 누 이
총대주교	총 대 주 교
遤	遤
갹출	갹 출
왕도마뱀	왕 도 마 뱀
환관	환 관
제주모치망둑	제 주 모 치 망 둑
역원	역 원
불치병	불 치 병
문집	문 집
드르렁	드 르 렁
고프다	고 프 다
엄두	엄 두
키프로스	키 프 로 스
주무르다	주 무 르 다
참모	참 모
교활하다	교 활 하 다
稁	稁
눈치채다	눈 치 채 다
시장하시다	시 장 하 시 다
헬기	헬 기
수류탄	수 류 탄
사회학	사 회 학
깻잎	깻 잎
외부	외 부
지저귀다	지 저 귀 다
군축	군 축
사대주의	사 대 주 의
추위	추 위
폴리프로필렌	폴 리 프 로 필 렌
협력하다	협 력 하 다
인용부	인 용 부
징집병	징 집 병
바지	바 지
보라	보 라
노출하다	노 출 하 다
일률	일 률
얼룩새코미꾸리	얼 룩 새 코 미 꾸 리
조직자	조 직 자
㖙	㖙
女學生	女 學 生
타협	타 협
추구	추 구
돌멩이	돌 멩 이
원앙	원 앙
된시옷	된 시 옷
우대석	우 대 석
망아지	망 아 지
울루루	울 루 루
-보다	- 보 다
상냥하다	상 냥 하 다
瓲	瓲
코드	코 드
포탄	포 탄
일대일	일 대 일
속세	속 세
진정제	진 정 제
노나다	노 나 다
英語圏	英 語 圏
여든	여 든
동봉하다	동 봉 하 다
동남아시아	동 남 아 시 아
孔德洞	孔 德 洞
자폐증	자 폐 증
양산	양 산
광서	광 서
민가	민 가
바지락	바 지 락
누나부트	누 나 부 트
그을다	그 을 다
환상곡	환 상 곡
참혹	참 혹
고대국어	고 대 국 어
항아리	항 아 리
제금	제 금
인형극	인 형 극
꾀꼬리	꾀 꼬 리
련애하다	련 애 하 다
현찰	현 찰
글쎄요	글 쎄 요
볼펜	볼 펜
움트다	움 트 다
국유화하다	국 유 화 하 다
체용	체 용
꼼트락꼼트락	꼼 트 락 꼼 트 락
마음씨	마 음 씨
계부	계 부
신청	신 청
테오도시우스	테 오 도 시 우 스
타타르어	타 타 르 어
비단조개	비 단 조 개
미분학	미 분 학
우크라	우 크 라
초은하단	초 은 하 단
해중	해 중
嶰	嶰
보온병	보 온 병
모국어	모 국 어
잇기	잇 기
량강도	량 강 도
노랑부리저어새	노 랑 부 리 저 어 새
그루지야어	그 루 지 야 어
가껍다	가 껍 다
下宿屋	下 宿 屋
하수구	하 수 구
創設者	創 設 者
祌	祌
점액	점 액
슬몃슬몃	슬 몃 슬 몃
소심하다	소 심 하 다
방송간섭	방 송 간 섭
식료품	식 료 품
깜빵	깜 빵
右翼手	右 翼 手
섞다	섞 다
이랴	이 랴
로마字	로 마 字
혐	혐
텐션	텐 션
욕	욕
風物詩	風 物 詩
화염병	화 염 병
생태학	생 태 학
이기적	이 기 적
카더라	카 더 라
하품하다	하 품 하 다
일반적	일 반 적
남자애	남 자 애
기르다	기 르 다
광부	광 부
해병대	해 병 대
화폐학	화 폐 학
두째	두 째
장음	장 음
우러러보다	우 러 러 보 다
부도덕하다	부 도 덕 하 다
空爆	空 爆
왕국	왕 국
범부	범 부
매이다	매 이 다
키보드	키 보 드
-라뇨	- 라 뇨
조류학	조 류 학
공수부대	공 수 부 대
잔점박이물범	잔 점 박 이 물 범
-의	- 의
체읍	체 읍
하나님	하 나 님
필승	필 승
머전	머 전
규정하다	규 정 하 다
민들레	민 들 레
몬타나	몬 타 나
윗수염박쥐	윗 수 염 박 쥐
기계공	기 계 공
빙결	빙 결
무빙워크	무 빙 워 크
홀어미	홀 어 미
구현하다	구 현 하 다
憘	憘
백정	백 정
냅킨	냅 킨
원족	원 족
죽마고우	죽 마 고 우
논리학	논 리 학
검소하다	검 소 하 다
버섯	버 섯
조리하다	조 리 하 다
라한	라 한
두문자	두 문 자
PJT	P J T
칠십대	칠 십 대
부딪다	부 딪 다
부루퉁이	부 루 퉁 이
불도	불 도
중력자	중 력 자
사업차	사 업 차
구기차	구 기 차
거년	거 년
未練	未 練
-러	- 러
갸름하다	갸 름 하 다
가언적	가 언 적
영	영
표현되다	표 현 되 다
내몽골	내 몽 골
문지르다	문 지 르 다
향유	향 유
사각지대	사 각 지 대
쏠다	쏠 다
부이온	부 이 온
호반새	호 반 새
고유명사	고 유 명 사
바알	바 알
물속	물 속
회남자	회 남 자
능률	능 률
륙	륙
벽장	벽 장
자가사리	자 가 사 리
거만	거 만
베니스	베 니 스
잔인하다	잔 인 하 다
왠지	왠 지
가시버시	가 시 버 시
개시	개 시
금요일	금 요 일
민의	민 의
스프링클러	스 프 링 클 러
부닥치다	부 닥 치 다
사자고추	사 자 고 추
동사하다	동 사 하 다
희다	희 다
오솔길	오 솔 길
융모	융 모
바그다드	바 그 다 드
入札	入 札
협서	협 서
족제비	족 제 비
수뇌상봉	수 뇌 상 봉
망루	망 루
잉부	잉 부
파라마리보	파 라 마 리 보
심	심
청남방	청 남 방
감지하다	감 지 하 다
평생	평 생
관군	관 군
작은땃쥐	작 은 땃 쥐
목람	목 람
조춘	조 춘
낙태	낙 태
백만	백 만
경례	경 례
권리	권 리
못생기다	못 생 기 다
맥점	맥 점
의심쩍다	의 심 쩍 다
8282	8 2 8 2
한글날	한 글 날
警察犬	警 察 犬
대륙	대 륙
唯一無二	唯 一 無 二
펌웨어	펌 웨 어
맹인	맹 인
이삭	이 삭
명망	명 망
와인	와 인
기중기	기 중 기
벨로키랍토르	벨 로 키 랍 토 르
강설	강 설
荒蕪地	荒 蕪 地
선원	선 원
부침개	부 침 개
멜라닌	멜 라 닌
갸웃	갸 웃
연맹	연 맹
브라키오사우루스	브 라 키 오 사 우 루 스
분자동역학	분 자 동 역 학
계명	계 명
오미크론	오 미 크 론
갓난아기	갓 난 아 기
투표함	투 표 함
번지다	번 지 다
鬂	鬂
기울다	기 울 다
번역가	번 역 가
낼래	낼 래
반추	반 추
사회주의	사 회 주 의
놀라다	놀 라 다
재밌다	재 밌 다
수라간	수 라 간
곰작곰작	곰 작 곰 작
영예	영 예
퍄	퍄
-되	- 되
낱자	낱 자
어버이	어 버 이
차르	차 르
길차다	길 차 다
공식어	공 식 어
노면전차	노 면 전 차
아무튼	아 무 튼
니케아	니 케 아
수증기	수 증 기
상견례	상 견 례
면역학	면 역 학
한중	한 중
외무	외 무
똠얌	똠 얌
청천벽력	청 천 벽 력
일인칭	일 인 칭
통상적	통 상 적
붐비다	붐 비 다
랜섬웨어	랜 섬 웨 어
실험실	실 험 실
연휴	연 휴
그지	그 지
-자마자	- 자 마 자
조타	조 타
동원령	동 원 령
광야	광 야
곡셱	곡 셱
도마뱀	도 마 뱀
둥글다	둥 글 다
교의	교 의
황복	황 복
음어	음 어
조리사	조 리 사
대하소설	대 하 소 설
간질대다	간 질 대 다
퓨란	퓨 란
추억	추 억
五萬	五 萬
만루	만 루
제대	제 대
께끈하다	께 끈 하 다
빗속	빗 속
쇼핑하다	쇼 핑 하 다
비치다	비 치 다
예명	예 명
젖통	젖 통
투먼	투 먼
매독	매 독
옥중	옥 중
가벼워지다	가 벼 워 지 다
묘포	묘 포
한눈	한 눈
내측광근	내 측 광 근
찌릿하다	찌 릿 하 다
주사기	주 사 기
파스닙	파 스 닙
엿듣다	엿 듣 다
대화방	대 화 방
팔뚝	팔 뚝
테크네튬	테 크 네 튬
수박색	수 박 색
工作員	工 作 員
끄다	끄 다
실패	실 패
세뇌	세 뇌
영사하다	영 사 하 다
거부감	거 부 감
이윽고	이 윽 고
나발니	나 발 니
休日	休 日
錪	錪
연습장	연 습 장
애완묘	애 완 묘
주모자	주 모 자
미니스커트	미 니 스 커 트
지형학	지 형 학
풍물놀이	풍 물 놀 이
맘카페	맘 카 페
유가	유 가
경이롭다	경 이 롭 다
뭍	뭍
요절	요 절
한기	한 기
살살하다	살 살 하 다
중자	중 자
우주인	우 주 인
조림	조 림
더위팔기	더 위 팔 기
통솔자	통 솔 자
大統領令	大 統 領 令
-습니다	- 습 니 다
스풀	스 풀
고두하다	고 두 하 다
꿈적꿈적	꿈 적 꿈 적
두드러지다	두 드 러 지 다
골무	골 무
잠자코	잠 자 코
단종되다	단 종 되 다
병음	병 음
기척	기 척
적절히	적 절 히
활개	활 개
신시아	신 시 아
판정	판 정
끄스다	끄 스 다
암페어	암 페 어
단순어	단 순 어
-우-	- 우 -
에터	에 터
태	태
近親相姦	近 親 相 姦
지팡이	지 팡 이
짧은부리참돌고래	짧 은 부 리 참 돌 고 래
키스하다	키 스 하 다
먹킹이	먹 킹 이
범고래	범 고 래
식빵	식 빵
지각자	지 각 자
양국	양 국
사내아이	사 내 아 이
기별	기 별
아유르베다	아 유 르 베 다
관음	관 음
전리품	전 리 품
함대	함 대
관료제	관 료 제
부착되다	부 착 되 다
곰국	곰 국
억류	억 류
건드리다	건 드 리 다
익숙하다	익 숙 하 다
구경	구 경
남극해	남 극 해
가꾸가다	가 꾸 가 다
하구	하 구
退院	退 院
토마스	토 마 스
연흔	연 흔
흑기사	흑 기 사
위훈	위 훈
국유화	국 유 화
갈증	갈 증
목수	목 수
응원하다	응 원 하 다
마팔디네	마 팔 디 네
㴍	㴍
-으옵-	- 으 옵 -
네꾸다이	네 꾸 다 이
장군석	장 군 석
頂板	頂 板
秘匿	秘 匿
찾아가다	찾 아 가 다
포사삭	포 사 삭
ᇚ	ᇚ
가리개	가 리 개
야수선택	야 수 선 택
불량배	불 량 배
劫迫	劫 迫
현대	현 대
중매인	중 매 인
텔레비전	텔 레 비 전
볼링	볼 링
젓갈	젓 갈
앉다	앉 다
㴻	㴻
놋쇠	놋 쇠
이부자리	이 부 자 리
공개하다	공 개 하 다
用紙	用 紙
삼초	삼 초
逃去	逃 去
삼일	삼 일
관풍금	관 풍 금
논란	논 란
육각수	육 각 수
남한	남 한
몰매	몰 매
세탁하다	세 탁 하 다
운동하다	운 동 하 다
돌솥	돌 솥
아리스토텔레스	아 리 스 토 텔 레 스
색경	색 경
글고	글 고
투르크	투 르 크
마시다	마 시 다
폭로	폭 로
野球場	野 球 場
잔혹	잔 혹
배수관	배 수 관
가는돌고기	가 는 돌 고 기
連立	連 立
汽車驛	汽 車 驛
긷다	긷 다
미싱	미 싱
신성하다	신 성 하 다
종달새	종 달 새
벌끈	벌 끈
샘터	샘 터
애수	애 수
여적지	여 적 지
핸드볼	핸 드 볼
낙천주의	낙 천 주 의
할라페뇨	할 라 페 뇨
-는	- 는
회전목마	회 전 목 마
와가두구	와 가 두 구
파리채	파 리 채
애무하다	애 무 하 다
쌍동이	쌍 동 이
신경전달물질	신 경 전 달 물 질
초콜렛	초 콜 렛
입향순속	입 향 순 속
위상수학	위 상 수 학
갈고	갈 고
숙제	숙 제
반려조	반 려 조
너도밤나무	너 도 밤 나 무
지구라트	지 구 라 트
메인트	메 인 트
동기	동 기
파이즈리	파 이 즈 리
씁쓸하다	씁 쓸 하 다
소돔사과	소 돔 사 과
拙吟	拙 吟
아베크	아 베 크
유인원	유 인 원
폐	폐
임진강	임 진 강
인촨	인 촨
존중하다	존 중 하 다
털	털
들소	들 소
수집하다	수 집 하 다
훑다	훑 다
까치복	까 치 복
백경	백 경
미어지다	미 어 지 다
교전	교 전
토이기어	토 이 기 어
식물학	식 물 학
에티켓	에 티 켓
갈아대다	갈 아 대 다
루비듐	루 비 듐
국면	국 면
접미어	접 미 어
매도하다	매 도 하 다
정답다	정 답 다
지라	지 라
도배	도 배
총알열차	총 알 열 차
자명금	자 명 금
게니자	게 니 자
뻐석	뻐 석
흩날다	흩 날 다
공생	공 생
사진첩	사 진 첩
풀다	풀 다
일거일동	일 거 일 동
터부시되다	터 부 시 되 다
예언하다	예 언 하 다
디	디
지리학	지 리 학
懷中日記	懷 中 日 記
-으니께니	- 으 니 께 니
쬐다	쬐 다
서브컬처	서 브 컬 처
얄궂다	얄 궂 다
집권당	집 권 당
공폭	공 폭
응징하다	응 징 하 다
작품집	작 품 집
쟁기질하다	쟁 기 질 하 다
부지깽이	부 지 깽 이
카나다	카 나 다
로씨야인	로 씨 야 인
의생	의 생
-댓-	- 댓 -
나리	나 리
세배	세 배
야구	야 구
출가	출 가
사과나무	사 과 나 무
복습하다	복 습 하 다
䃐	䃐
세바스토폴	세 바 스 토 폴
선언	선 언
가얏고	가 얏 고
청동	청 동
오스뮴	오 스 뮴
전근	전 근
의학	의 학
데불다	데 불 다
時限爆彈	時 限 爆 彈
연봉	연 봉
성실	성 실
옥문	옥 문
영한	영 한
거름	거 름
지배인	지 배 인
송자	송 자
가주	가 주
지칭하다	지 칭 하 다
그만큼	그 만 큼
발정	발 정
댄스	댄 스
활력	활 력
식순	식 순
지슬	지 슬
男性語	男 性 語
테헤란	테 헤 란
특별히	특 별 히
모양	모 양
새홀리기	새 홀 리 기
설하다	설 하 다
그러므로	그 러 므 로
위도	위 도
据置臺	据 置 臺
육이오전쟁	육 이 오 전 쟁
폐급	폐 급
십각형	십 각 형
소비하다	소 비 하 다
두레	두 레
당첨	당 첨
모솔	모 솔
카란	카 란
백지	백 지
孤食	孤 食
완소	완 소
외투	외 투
가면극	가 면 극
황새	황 새
검출되다	검 출 되 다
개방되다	개 방 되 다
채팅	채 팅
멸종	멸 종
익살스럽다	익 살 스 럽 다
찻잎	찻 잎
재주	재 주
黨葬	黨 葬
이젠	이 젠
상상력	상 상 력
부사	부 사
대모	대 모
비루스	비 루 스
왜서	왜 서
반짝반짝	반 짝 반 짝
예카테린부르크	예 카 테 린 부 르 크
훑어읽다	훑 어 읽 다
낳다	낳 다
절대영역	절 대 영 역
선명	선 명
마선	마 선
괄약근	괄 약 근
쌍꺼풀	쌍 꺼 풀
近接	近 接
側位	側 位
忌避	忌 避
빠삭	빠 삭
직캠	직 캠
시읏	시 읏
소년	소 년
굼벵이	굼 벵 이
요사군	요 사 군
깃	깃
隊商	隊 商
고레말	고 레 말
흑설탕	흑 설 탕
에스컬레이터	에 스 컬 레 이 터
먹이그물	먹 이 그 물
우렁각시	우 렁 각 시
피알	피 알
양탄자	양 탄 자
萬民法	萬 民 法
構成員	構 成 員
미확인비행물체	미 확 인 비 행 물 체
오가다	오 가 다
호빵	호 빵
프락치	프 락 치
평양	평 양
-시니껴	- 시 니 껴
군	군
하반신	하 반 신
일고여덟	일 고 여 덟
探偵	探 偵
지붕	지 붕
욕조	욕 조
하퇴삼두근	하 퇴 삼 두 근
艀	艀
묵은지	묵 은 지
慶尙南道	慶 尙 南 道
장가	장 가
중문	중 문
자찬	자 찬
흰줄박이오리	흰 줄 박 이 오 리
후난	후 난
용맹하다	용 맹 하 다
합창단	합 창 단
하극상	하 극 상
다운로드	다 운 로 드
醵金	醵 金
화나다	화 나 다
성능	성 능
발끈	발 끈
평안도	평 안 도
내키다	내 키 다
안사람	안 사 람
베오그라드	베 오 그 라 드
知慧	知 慧
바대	바 대
불길	불 길
열쇠글	열 쇠 글
모	모
편린	편 린
격찬하다	격 찬 하 다
잠기다	잠 기 다
적삼	적 삼
경장근	경 장 근
-느니	- 느 니
세르비아	세 르 비 아
짓다	짓 다
체구	체 구
수바	수 바
故意四球	故 意 四 球
분포하다	분 포 하 다
착륙시키다	착 륙 시 키 다
귀순	귀 순
미안하다	미 안 하 다
해지다	해 지 다
벤토	벤 토
부서석	부 서 석
만년필	만 년 필
생식기	생 식 기
도벽	도 벽
동경하다	동 경 하 다
솜사탕	솜 사 탕
제설차	제 설 차
서구	서 구
잠비아	잠 비 아
전문화	전 문 화
敎人	敎 人
부끄러움	부 끄 러 움
잽싸다	잽 싸 다
고객	고 객
쓰딸린	쓰 딸 린
점심	점 심
청순	청 순
모잠비크	모 잠 비 크
電氣綜合樂器	電 氣 綜 合 樂 器
잣	잣
계획하다	계 획 하 다
오등	오 등
모래무지	모 래 무 지
홀	홀
올라가다	올 라 가 다
기마이	기 마 이
통합	통 합
부르주아지	부 르 주 아 지
바라보다	바 라 보 다
특	특
터치패드	터 치 패 드
默考	默 考
휴척	휴 척
큰집박쥐	큰 집 박 쥐
아	아
의존	의 존
켄터키	켄 터 키
가세	가 세
끽연하다	끽 연 하 다
구약성경	구 약 성 경
선입선출	선 입 선 출
검역	검 역
푸서석푸서석	푸 서 석 푸 서 석
쇼어라인	쇼 어 라 인
語學	語 學
먹히다	먹 히 다
페치카	페 치 카
철저하다	철 저 하 다
漕艇	漕 艇
부정부패	부 정 부 패
참패	참 패
뮈슬리	뮈 슬 리
-ㅁ둥	- ㅁ 둥
유효하다	유 효 하 다
어부	어 부
킹	킹
전무이사	전 무 이 사
쇠뇌	쇠 뇌
천성	천 성
와삭바삭	와 삭 바 삭
침략하다	침 략 하 다
승원	승 원
구실잣밤나무	구 실 잣 밤 나 무
바쿠	바 쿠
신교도	신 교 도
비중	비 중
오스트리아-헝가리	오 스 트 리 아 - 헝 가 리
해골	해 골
마수다	마 수 다
굳기름	굳 기 름
꾸물꾸물	꾸 물 꾸 물
염력	염 력
대머리	대 머 리
보이차	보 이 차
회중시계	회 중 시 계
모토	모 토
새끼주머니	새 끼 주 머 니
첫눈	첫 눈
일견	일 견
무지하다	무 지 하 다
뺏다	뺏 다
지병	지 병
簏	簏
판매원	판 매 원
與黨	與 黨
훈가자	훈 가 자
영양실조	영 양 실 조
충충	충 충
노른자	노 른 자
쉐수	쉐 수
구성되다	구 성 되 다
교하질쉬	교 하 질 쉬
線畫	線 畫
주저앉다	주 저 앉 다
십자	십 자
큰겨울잠쥐	큰 겨 울 잠 쥐
폭격기	폭 격 기
인원	인 원
태반	태 반
아나테마	아 나 테 마
퓨라잔	퓨 라 잔
송어	송 어
총영사	총 영 사
누쿠알로파	누 쿠 알 로 파
더럽다	더 럽 다
썰다	썰 다
양봉장	양 봉 장
양성애자	양 성 애 자
독하다	독 하 다
봉건	봉 건
비주얼노벨	비 주 얼 노 벨
솔로몬	솔 로 몬
-아서	- 아 서
오프숄더	오 프 숄 더
크롬	크 롬
울다	울 다
탄	탄
수뇨관	수 뇨 관
상류사회	상 류 사 회
궐	궐
탄창	탄 창
䯩	䯩
노력하다	노 력 하 다
안전가옥	안 전 가 옥
뼈마디	뼈 마 디
허가	허 가
냉기	냉 기
중태	중 태
숙명	숙 명
연조비가사	연 조 비 가 사
설득하다	설 득 하 다
술병	술 병
페난트리딘	페 난 트 리 딘
僻字	僻 字
황당	황 당
편견	편 견
브리지타운	브 리 지 타 운
넙치	넙 치
비상사태	비 상 사 태
우세	우 세
웅데	웅 데
음식	음 식
ㄲ	ㄲ
째까닥	째 까 닥
관찰	관 찰
東歐圈	東 歐 圈
-으니	- 으 니
신박하다	신 박 하 다
백인	백 인
성폭행하다	성 폭 행 하 다
-는다	- 는 다
綠末	綠 末
푼	푼
분리주의	분 리 주 의
튕기다	튕 기 다
自己愛	自 己 愛
극악	극 악
데메테르	데 메 테 르
정역학	정 역 학
쇼윈도	쇼 윈 도
지푸라기	지 푸 라 기
칠월	칠 월
병독	병 독
체외사정	체 외 사 정
싱커	싱 커
바삭바삭	바 삭 바 삭
새끼새	새 끼 새
회음부	회 음 부
재깍	재 깍
체내	체 내
포리지	포 리 지
밭쥐	밭 쥐
주둔지	주 둔 지
생신	생 신
廚房長	廚 房 長
우체국	우 체 국
민첩성	민 첩 성
터디다	터 디 다
중세국어	중 세 국 어
격차	격 차
-대	- 대
언급하다	언 급 하 다
췌장암	췌 장 암
대교구	대 교 구
수권	수 권
요리	요 리
서점	서 점
모식	모 식
꼼짝	꼼 짝
갈애	갈 애
외계인	외 계 인
손오공	손 오 공
봐주다	봐 주 다
佛敎	佛 敎
사다새	사 다 새
군소리	군 소 리
읊다	읊 다
-아	- 아
부리	부 리
번트	번 트
두릅	두 릅
ㅊ	ㅊ
눈송이	눈 송 이
앨버타	앨 버 타
흰자위	흰 자 위
덤불	덤 불
어븀	어 븀
프린스에드워드아일랜드	프 린 스 에 드 워 드 아 일 랜 드
-시까	- 시 까
단수	단 수
때문	때 문
왕바랭이	왕 바 랭 이
안즉	안 즉
癒着	癒 着
도둑질	도 둑 질
이단자	이 단 자
에스와티니	에 스 와 티 니
에다	에 다
오호츠크해	오 호 츠 크 해
그만하다	그 만 하 다
색소	색 소
주방장	주 방 장
갈색머리흑조	갈 색 머 리 흑 조
아스파라거스	아 스 파 라 거 스
오타와	오 타 와
빼들다	빼 들 다
산사태	산 사 태
보일러	보 일 러
텔펜	텔 펜
傍點	傍 點
십날	십 날
마달	마 달
박봉	박 봉
캥거루	캥 거 루
자귀나무	자 귀 나 무
고기후학	고 기 후 학
부글부글	부 글 부 글
테제	테 제
생선회	생 선 회
-는교	- 는 교
도다리	도 다 리
수태	수 태
현부인	현 부 인
포화지방	포 화 지 방
어린아이	어 린 아 이
북장	북 장
모퉁이	모 퉁 이
희롱하다	희 롱 하 다
意慾	意 慾
길림	길 림
광접	광 접
캐나다기러기	캐 나 다 기 러 기
푸짐하다	푸 짐 하 다
배탈	배 탈
菓子	菓 子
베어링	베 어 링
蒸溜水	蒸 溜 水
바다표범	바 다 표 범
제꺼덕	제 꺼 덕
하양	하 양
개가하다	개 가 하 다
명암	명 암
獄中	獄 中
노댁	노 댁
천간	천 간
벽지	벽 지
閊	閊
미하일	미 하 일
안락의자	안 락 의 자
춰	춰
등불	등 불
공갈하다	공 갈 하 다
선동	선 동
천주	천 주
토륨	토 륨
승전하다	승 전 하 다
볼똑	볼 똑
주둥치	주 둥 치
누르술탄	누 르 술 탄
주년	주 년
향후	향 후
放射能	放 射 能
파인더	파 인 더
삼십	삼 십
고되다	고 되 다
전번	전 번
개꿈	개 꿈
님재	님 재
어둠	어 둠
려권	려 권
애초	애 초
厥女	厥 女
나서다	나 서 다
엷파랗다	엷 파 랗 다
신랑	신 랑
사모아	사 모 아
누룩	누 룩
카놀라유	카 놀 라 유
청머리오리	청 머 리 오 리
탈주병	탈 주 병
탄알	탄 알
편중	편 중
이름씨	이 름 씨
써리다	써 리 다
문둥이박쥐	문 둥 이 박 쥐
나우루	나 우 루
면사	면 사
부탁하다	부 탁 하 다
듯하다	듯 하 다
유조차	유 조 차
민스크	민 스 크
송두리째	송 두 리 째
芢	芢
혈암	혈 암
洗濯室	洗 濯 室
다소	다 소
방어기제	방 어 기 제
교목	교 목
성망	성 망
찾아보다	찾 아 보 다
따오기	따 오 기
옥석	옥 석
국영하다	국 영 하 다
가공되다	가 공 되 다
묘약	묘 약
잔원	잔 원
물리화학	물 리 화 학
간섭하다	간 섭 하 다
적연	적 연
목간	목 간
篒	篒
팥밥	팥 밥
형태학	형 태 학
베닌	베 닌
대야	대 야
해결되다	해 결 되 다
풋내기	풋 내 기
노른자위	노 른 자 위
가깝다	가 깝 다
반려묘	반 려 묘
곤란하다	곤 란 하 다
가만두다	가 만 두 다
안도라라베야	안 도 라 라 베 야
가배	가 배
곪다	곪 다
奪還	奪 還
회의	회 의
응접	응 접
유괴	유 괴
민주사회주의	민 주 사 회 주 의
합자	합 자
불포화	불 포 화
재갈매기	재 갈 매 기
인내심	인 내 심
명단	명 단
창가	창 가
전쟁하다	전 쟁 하 다
볶다	볶 다
괘종시계	괘 종 시 계
균계	균 계
규정되다	규 정 되 다
이견	이 견
구마모또	구 마 모 또
문구점	문 구 점
品詞	品 詞
객가	객 가
군비	군 비
애틋하다	애 틋 하 다
꿉다	꿉 다
폐어	폐 어
쪽발이	쪽 발 이
매미	매 미
고소	고 소
덮다	덮 다
난관	난 관
-꾼	- 꾼
백량금	백 량 금
논단	논 단
강렬하다	강 렬 하 다
무효하다	무 효 하 다
흑기러기	흑 기 러 기
이하	이 하
부럼	부 럼
대천사	대 천 사
캐러멜	캐 러 멜
두만강자그사니	두 만 강 자 그 사 니
강아지	강 아 지
젓뱅어	젓 뱅 어
동작하다	동 작 하 다
다정스럽다	다 정 스 럽 다
쉬메일	쉬 메 일
봉우리	봉 우 리
달려오다	달 려 오 다
두음	두 음
생각하다	생 각 하 다
물통	물 통
알제리	알 제 리
검은머리흰따오기	검 은 머 리 흰 따 오 기
오물오물	오 물 오 물
우주론	우 주 론
잔차	잔 차
셀룰로이드	셀 룰 로 이 드
갯과	갯 과
나나니	나 나 니
敎材	敎 材
양하	양 하
파렴치하다	파 렴 치 하 다
안티오키아	안 티 오 키 아
열변	열 변
용감하다	용 감 하 다
엥간히	엥 간 히
구적	구 적
삼공	삼 공
낭독되다	낭 독 되 다
부검	부 검
핑계	핑 계
갈아신다	갈 아 신 다
초어	초 어
빈민굴	빈 민 굴
흑고니	흑 고 니
도덕	도 덕
사안	사 안
母斑	母 斑
유주	유 주
首長龍	首 長 龍
대서양연어	대 서 양 연 어
보수	보 수
비취	비 취
육이오	육 이 오
승하	승 하
마이애미	마 이 애 미
소개되다	소 개 되 다
횡령하다	횡 령 하 다
해파리	해 파 리
眞臘	眞 臘
賆	賆
동성애자	동 성 애 자
안경돌고래	안 경 돌 고 래
里程標	里 程 標
無責任	無 責 任
지슴	지 슴
솔딱새	솔 딱 새
따다	따 다
回敎	回 敎
핥다	핥 다
간간이	간 간 이
스압	스 압
-으면	- 으 면
흰개미	흰 개 미
추격	추 격
주정	주 정
비트박스	비 트 박 스
뿌리혹	뿌 리 혹
신수	신 수
적연하다	적 연 하 다
뱅뱅	뱅 뱅
交叉路	交 叉 路
탁구	탁 구
科擧	科 擧
유익하다	유 익 하 다
텃밭	텃 밭
리마	리 마
살치	살 치
아이띠	아 이 띠
빌어먹을	빌 어 먹 을
완곡어법	완 곡 어 법
오디	오 디
주키니	주 키 니
猠	猠
난간	난 간
戱曲集	戱 曲 集
던지다	던 지 다
꽃다발	꽃 다 발
관계대명사	관 계 대 명 사
로크포르	로 크 포 르
외부인	외 부 인
발행소	발 행 소
즐기다	즐 기 다
인민폐	인 민 폐
보장하다	보 장 하 다
옥사	옥 사
퉁	퉁
변하다	변 하 다
등록기	등 록 기
경보	경 보
점주	점 주
給油	給 油
읊조리다	읊 조 리 다
항의	항 의
장가가다	장 가 가 다
내주다	내 주 다
발탁	발 탁
설기	설 기
생물권	생 물 권
가공품	가 공 품
희끗희끗	희 끗 희 끗
旁牌	旁 牌
앵무새	앵 무 새
타동사	타 동 사
菜食主義	菜 食 主 義
요크셔	요 크 셔
대국	대 국
꼬리표	꼬 리 표
설교	설 교
구조하다	구 조 하 다
㬨	㬨
큰철갑상어	큰 철 갑 상 어
다행	다 행
서푼	서 푼
부임하다	부 임 하 다
路面電車	路 面 電 車
慶尙道	慶 尙 道
갑충	갑 충
입구	입 구
묵살	묵 살
끄집다	끄 집 다
도랑	도 랑
슴베	슴 베
마니교	마 니 교
해상도	해 상 도
임부	임 부
바라다	바 라 다
국민	국 민
레알리즘	레 알 리 즘
캐넌	캐 넌
직관	직 관
角木	角 木
토끼박쥐	토 끼 박 쥐
중재인	중 재 인
아점	아 점
작성하다	작 성 하 다
출퇴근하다	출 퇴 근 하 다
험	험
물러서다	물 러 서 다
건너오다	건 너 오 다
㐙	㐙
노스다코타	노 스 다 코 타
영사관	영 사 관
구경꾼	구 경 꾼
꼭대기	꼭 대 기
뚜렷하다	뚜 렷 하 다
똥싸다	똥 싸 다
체온계	체 온 계
간데없이	간 데 없 이
수오리	수 오 리
피곤하다	피 곤 하 다
획	획
너페	너 페
즉흥	즉 흥
신명기	신 명 기
엄만	엄 만
뺑소니치다	뺑 소 니 치 다
철밥통	철 밥 통
스무째	스 무 째
고명하다	고 명 하 다
다락같다	다 락 같 다
침목	침 목
비숍	비 숍
종료하다	종 료 하 다
한라봉	한 라 봉
미섭다	미 섭 다
상투메	상 투 메
화단	화 단
분노	분 노
살리다	살 리 다
클릭	클 릭
범유행	범 유 행
연달다	연 달 다
건축학	건 축 학
긁다	긁 다
외식	외 식
하프늄	하 프 늄
압하스어	압 하 스 어
몽타주	몽 타 주
광자	광 자
편모	편 모
들쥐	들 쥐
단종하다	단 종 하 다
참바	참 바
내후년	내 후 년
부럽다	부 럽 다
남겨지다	남 겨 지 다
미술사	미 술 사
철갑상어	철 갑 상 어
협찬	협 찬
라찰	라 찰
타임아웃	타 임 아 웃
머리털	머 리 털
일맥상통	일 맥 상 통
염라	염 라
사냥감	사 냥 감
장애인	장 애 인
폭주	폭 주
-라고	- 라 고
속견	속 견
성가	성 가
킬로와트	킬 로 와 트
-호	- 호
-어라	- 어 라
야행	야 행
예일	예 일
뜨락또르	뜨 락 또 르
똑똑	똑 똑
주격	주 격
레닌	레 닌
빌다	빌 다
복불복	복 불 복
백금	백 금
통계학	통 계 학
몽고주름	몽 고 주 름
회복	회 복
흑화	흑 화
난제	난 제
목전	목 전
占領軍	占 領 軍
새우젓	새 우 젓
邪宗	邪 宗
式辭	式 辭
구기다	구 기 다
득도	득 도
안와	안 와
초딩	초 딩
백단	백 단
충북	충 북
악화되다	악 화 되 다
개펄	개 펄
사춘기	사 춘 기
고애	고 애
갑작부자	갑 작 부 자
인산인해	인 산 인 해
체스꼬슬로벤스꼬	체 스 꼬 슬 로 벤 스 꼬
靑春	靑 春
양달	양 달
뽀끈	뽀 끈
두근거리다	두 근 거 리 다
어쨌든	어 쨌 든
폭발물	폭 발 물
구이저우	구 이 저 우
피오르드	피 오 르 드
망상	망 상
소멸	소 멸
와전	와 전
낙서	낙 서
따오다	따 오 다
려관	려 관
일떠세우다	일 떠 세 우 다
꽁초	꽁 초
광둥	광 둥
욕심	욕 심
악역	악 역
세꼬	세 꼬
문명	문 명
내핵	내 핵
문바람	문 바 람
흠결	흠 결
抑留	抑 留
소원하다	소 원 하 다
비단털들쥐	비 단 털 들 쥐
하이픈	하 이 픈
목슈권	목 슈 권
촉	촉
선군	선 군
딮	딮
찌창	찌 창
霧氷	霧 氷
권선징악	권 선 징 악
씌우다	씌 우 다
越境地	越 境 地
소중화	소 중 화
슬픔증	슬 픔 증
영수증	영 수 증
령사	령 사
축척	축 척
웃돈	웃 돈
孕胎	孕 胎
출근시간	출 근 시 간
紙面	紙 面
물리학자	물 리 학 자
취체	취 체
몸통	몸 통
노갱이	노 갱 이
식혜	식 혜
풍미	풍 미
감명하다	감 명 하 다
대동소이	대 동 소 이
植民地化	植 民 地 化
스테아르산	스 테 아 르 산
바스라기	바 스 라 기
해면	해 면
팓다	팓 다
고환	고 환
도화뱅어	도 화 뱅 어
성어	성 어
사랑해	사 랑 해
고조선	고 조 선
쵸콜레트	쵸 콜 레 트
어항	어 항
신경언어학	신 경 언 어 학
의사록	의 사 록
各其	各 其
흰갈매기	흰 갈 매 기
송장	송 장
파하다	파 하 다
기계화	기 계 화
그립다	그 립 다
유성	유 성
한약	한 약
제유	제 유
된장찌게	된 장 찌 게
피통	피 통
하셔요	하 셔 요
굉장하다	굉 장 하 다
아르테미스	아 르 테 미 스
기묘하다	기 묘 하 다
끼니	끼 니
몽구스	몽 구 스
마하	마 하
색종이	색 종 이
클릭하다	클 릭 하 다
곰작	곰 작
야훼	야 훼
라틴화	라 틴 화
가물치	가 물 치
피폭	피 폭
점쟁이	점 쟁 이
가뭇가뭇	가 뭇 가 뭇
증기	증 기
땔싹	땔 싹
진행되다	진 행 되 다
귓불	귓 불
야회	야 회
脫出記	脫 出 記
㠤	㠤
혁신가	혁 신 가
부끄럼	부 끄 럼
약물	약 물
반신반인	반 신 반 인
개구리밥	개 구 리 밥
검다	검 다
팔방미인	팔 방 미 인
낭인	낭 인
고방	고 방
길냥이	길 냥 이
시주	시 주
이승	이 승
바치다	바 치 다
연결망	연 결 망
경멸감	경 멸 감
니께	니 께
과목	과 목
同業者	同 業 者
둥굴레	둥 굴 레
재야당	재 야 당
바랭이	바 랭 이
자랑하다	자 랑 하 다
피단	피 단
극작가	극 작 가
응답하다	응 답 하 다
강림	강 림
참돌고래	참 돌 고 래
선입관	선 입 관
흑우	흑 우
硏究所	硏 究 所
버클	버 클
면들레	면 들 레
未確認飛行物體	未 確 認 飛 行 物 體
노동조합원	노 동 조 합 원
簔	簔
해일	해 일
가로지다	가 로 지 다
관사	관 사
연골	연 골
비개	비 개
당하다	당 하 다
불과하다	불 과 하 다
지원병	지 원 병
씽글	씽 글
조부니	조 부 니
䰮	䰮
나체	나 체
-구나	- 구 나
산	산
勘案	勘 案
절정	절 정
호전되다	호 전 되 다
팥소	팥 소
박제	박 제
소농	소 농
과소평가	과 소 평 가
파라오	파 라 오
出願者	出 願 者
급병	급 병
촌사람	촌 사 람
노출	노 출
돌	돌
소학교	소 학 교
무간지옥	무 간 지 옥
생리학	생 리 학
지루하다	지 루 하 다
孔德	孔 德
조한	조 한
炭化水素	炭 化 水 素
예산	예 산
아이다호	아 이 다 호
절벽	절 벽
곤충학	곤 충 학
진한	진 한
결혼하다	결 혼 하 다
運轉技士	運 轉 技 士
플라네타륨	플 라 네 타 륨
의심되다	의 심 되 다
수판	수 판
산양개	산 양 개
범이신론	범 이 신 론
어벙하다	어 벙 하 다
이산화물	이 산 화 물
年中無休	年 中 無 休
-레	- 레
초혼	초 혼
심산유곡	심 산 유 곡
발언	발 언
둔갑법	둔 갑 법
도꾸이	도 꾸 이
수나사	수 나 사
리버모륨	리 버 모 륨
쓰다	쓰 다
壭	壭
헌장	헌 장
에스파냐	에 스 파 냐
원망	원 망
흰부리아비	흰 부 리 아 비
유린	유 린
가죽끈	가 죽 끈
교체하다	교 체 하 다
촨	촨
汚物	汚 物
숙녀	숙 녀
불구하다	불 구 하 다
엽궐련	엽 궐 련
푸껫	푸 껫
교회론	교 회 론
낙향	낙 향
녀성고음	녀 성 고 음
청천	청 천
알까기	알 까 기
똑	똑
유지어터	유 지 어 터
겨우내	겨 우 내
에네르기	에 네 르 기
프랑슘	프 랑 슘
㵜	㵜
슴새	슴 새
버글버글	버 글 버 글
내달	내 달
코냑	코 냑
혼술	혼 술
거르마니	거 르 마 니
半額	半 額
비버	비 버
원주필	원 주 필
약재	약 재
송부	송 부
열사	열 사
칠전팔기	칠 전 팔 기
퇴각하다	퇴 각 하 다
즉결	즉 결
시장하다	시 장 하 다
전학	전 학
발뒤꿈치	발 뒤 꿈 치
성찬	성 찬
시냅스	시 냅 스
태양초	태 양 초
종어	종 어
구름다리	구 름 다 리
야쿠츠크	야 쿠 츠 크
食器洗滌機	食 器 洗 滌 機
송이송이	송 이 송 이
이북오도	이 북 오 도
일여덟	일 여 덟
-으니께	- 으 니 께
로션	로 션
방생	방 생
바자르	바 자 르
당겨지다	당 겨 지 다
포사삭포사삭	포 사 삭 포 사 삭
컬래버레이션	컬 래 버 레 이 션
갯첨서	갯 첨 서
연패	연 패
산천	산 천
방점	방 점
메주	메 주
낙관	낙 관
멸망	멸 망
미수	미 수
수면제	수 면 제
식중독	식 중 독
카바레	카 바 레
귀접	귀 접
식생활	식 생 활
다짐	다 짐
느리다	느 리 다
폭동	폭 동
벌집	벌 집
국선	국 선
무찌르다	무 찌 르 다
生活賃金	生 活 賃 金
엽맥	엽 맥
먄	먄
짐꾼	짐 꾼
거듭홀소리	거 듭 홀 소 리
깔때기	깔 때 기
동전주	동 전 주
연해주	연 해 주
누우	누 우
합쇼체	합 쇼 체
진눈깨비	진 눈 깨 비
옮아오다	옮 아 오 다
산양	산 양
사이렌	사 이 렌
국가보안법	국 가 보 안 법
졸망	졸 망
羂	羂
당일	당 일
사생자	사 생 자
발랄라이카	발 랄 라 이 카
나타나다	나 타 나 다
구류하다	구 류 하 다
열흘	열 흘
전하	전 하
꿀꿀	꿀 꿀
볼넷	볼 넷
無性愛	無 性 愛
사령	사 령
거구	거 구
독극물	독 극 물
포가	포 가
헬창	헬 창
깨까사다	깨 까 사 다
강력하다	강 력 하 다
과학적	과 학 적
국교	국 교
비롯하다	비 롯 하 다
제원	제 원
폐공	폐 공
옥색	옥 색
테니스	테 니 스
滑走路	滑 走 路
警察官	警 察 官
상전벽해	상 전 벽 해
탄화수소	탄 화 수 소
채플	채 플
大河小說	大 河 小 說
매월	매 월
강화도	강 화 도
사이폰	사 이 폰
기러기	기 러 기
아바지	아 바 지
오아시스	오 아 시 스
사투르누스	사 투 르 누 스
헬스	헬 스
움직이다	움 직 이 다
同義語	同 義 語
훗날	훗 날
기똥차다	기 똥 차 다
섬짱깨	섬 짱 깨
몰카	몰 카
모리타니	모 리 타 니
악단	악 단
짜굽다	짜 굽 다
피짠짜짜라어	피 짠 짜 짜 라 어
장인어른	장 인 어 른
창자	창 자
구레나룻	구 레 나 룻
유가증권	유 가 증 권
규탄되다	규 탄 되 다
터키	터 키
호주머니	호 주 머 니
양귀자	양 귀 자
키리바시	키 리 바 시
자기애	자 기 애
아롱아롱	아 롱 아 롱
무닥데기	무 닥 데 기
여남은	여 남 은
어여쁘다	어 여 쁘 다
보통화	보 통 화
염가	염 가
보내다	보 내 다
파데	파 데
눈동자	눈 동 자
칼집	칼 집
뚝섬	뚝 섬
짐작	짐 작
석달	석 달
감명	감 명
마세루	마 세 루
지름길	지 름 길
웽그리아	웽 그 리 아
평지	평 지
가꾸로	가 꾸 로
제노바	제 노 바
통장	통 장
의형제	의 형 제
-잉	- 잉
ᄯᅡᆼ	ᄯ ᅡ ᆼ
눈보라	눈 보 라
떼아트르	떼 아 트 르
포옹	포 옹
질녀	질 녀
분필	분 필
상성	상 성
화염	화 염
범성애	범 성 애
돕다	돕 다
일심단결	일 심 단 결
北傀	北 傀
여전하다	여 전 하 다
피부색	피 부 색
로텔레	로 텔 레
엔지니어링	엔 지 니 어 링
줄공치	줄 공 치
쌍시옷	쌍 시 옷
연안	연 안
경찰관	경 찰 관
드리우다	드 리 우 다
외손자	외 손 자
바텐더	바 텐 더
깜박	깜 박
아침놀	아 침 놀
사역원	사 역 원
차용	차 용
지과	지 과
말고기	말 고 기
아파르트헤이트	아 파 르 트 헤 이 트
홈페지	홈 페 지
참주	참 주
걸음마	걸 음 마
좁다	좁 다
검찰하다	검 찰 하 다
높낮이	높 낮 이
불	불
衣食住	衣 食 住
가리비	가 리 비
영국인	영 국 인
금지하다	금 지 하 다
해개	해 개
白堊館	白 堊 館
검사하다	검 사 하 다
중부	중 부
不文律	不 文 律
놀이공원	놀 이 공 원
면허	면 허
망간	망 간
언어학	언 어 학
당추	당 추
칠십	칠 십
朱錫	朱 錫
白書	白 書
요사이	요 사 이
자유자재	자 유 자 재
지하	지 하
보리고래	보 리 고 래
상면	상 면
무선국	무 선 국
巪	巪
代身	代 身
폭력단	폭 력 단
잿빛	잿 빛
늘상	늘 상
잔치	잔 치
되풀이	되 풀 이
뇽	뇽
크루아상	크 루 아 상
廥	廥
닢	닢
감기	감 기
야짤	야 짤
지구대	지 구 대
순화	순 화
머리물비누	머 리 물 비 누
탄탈럼	탄 탈 럼
앞당기다	앞 당 기 다
메탄	메 탄
밤참	밤 참
그저께	그 저 께
성가시다	성 가 시 다
의지하다	의 지 하 다
끝소리	끝 소 리
교도	교 도
영갬	영 갬
여행하다	여 행 하 다
꿈지럭	꿈 지 럭
계엄	계 엄
노천	노 천
광화학	광 화 학
갈다	갈 다
과욕	과 욕
깁	깁
서남	서 남
彩度	彩 度
페럿	페 럿
때로	때 로
䲶	䲶
배관공	배 관 공
리자이나	리 자 이 나
몽고	몽 고
점선	점 선
私利私慾	私 利 私 慾
코린	코 린
정찰병	정 찰 병
공교롭다	공 교 롭 다
진지	진 지
䃨	䃨
상그랍다	상 그 랍 다
눈초리	눈 초 리
지명하다	지 명 하 다
코치	코 치
지정학	지 정 학
음란하다	음 란 하 다
상구	상 구
㐊	㐊
바램	바 램
시도	시 도
바람직하다	바 람 직 하 다
듯	듯
운전기사	운 전 기 사
싶으다	싶 으 다
오월	오 월
前任者	前 任 者
슬픔	슬 픔
사립	사 립
시합	시 합
도란스	도 란 스
거	거
헬레나	헬 레 나
간물	간 물
광석	광 석
벼룩	벼 룩
일본주	일 본 주
솜씨	솜 씨
虎狼이	虎 狼 이
면발	면 발
버뮤다	버 뮤 다
화병	화 병
겹	겹
약탈자	약 탈 자
바누아투	바 누 아 투
최후통첩	최 후 통 첩
打者	打 者
달래다	달 래 다
아이러니	아 이 러 니
㣗	㣗
팔팔하다	팔 팔 하 다
청량음료	청 량 음 료
주도	주 도
흡입	흡 입
-치	- 치
한때	한 때
여캐	여 캐
륙십	륙 십
군벌	군 벌
바람쭉	바 람 쭉
머리하다	머 리 하 다
색아	색 아
이성주의	이 성 주 의
서술	서 술
쟁	쟁
불가지론	불 가 지 론
마누	마 누
코트디부아르	코 트 디 부 아 르
磼	磼
航空機	航 空 機
낫돌고래	낫 돌 고 래
복리	복 리
漏泄	漏 泄
턱선	턱 선
초성	초 성
개걸	개 걸
지하철역	지 하 철 역
매표구	매 표 구
엔나	엔 나
차축	차 축
妓生	妓 生
좀비	좀 비
市廳	市 廳
책자	책 자
쿠키	쿠 키
화란	화 란
낯설다	낯 설 다
㩂	㩂
비슷하다	비 슷 하 다
정예하다	정 예 하 다
㶂	㶂
포획하다	포 획 하 다
경작	경 작
作心三日	作 心 三 日
-ㄴ	- ㄴ
호주인	호 주 인
手票	手 票
가득히	가 득 히
발사	발 사
효자손	효 자 손
메	메
신법	신 법
피눈물	피 눈 물
사바나	사 바 나
종다리	종 다 리
생이	생 이
방광염	방 광 염
딴지	딴 지
과학	과 학
젖먹이	젖 먹 이
시트	시 트
어찌	어 찌
큰볏말뚝망둥어	큰 볏 말 뚝 망 둥 어
육조	육 조
感氣	感 氣
심심하다	심 심 하 다
흉	흉
게하	게 하
꾸르륵	꾸 르 륵
레퍼토리	레 퍼 토 리
조끼	조 끼
쟁기	쟁 기
이체	이 체
호정	호 정
일년감	일 년 감
배스	배 스
낭송하다	낭 송 하 다
가무	가 무
마케도니아	마 케 도 니 아
검은금	검 은 금
보자기	보 자 기
거둥둥하다	거 둥 둥 하 다
아도	아 도
침낭	침 낭
벚	벚
쏠배감펭	쏠 배 감 펭
更地	更 地
왕태자	왕 태 자
필롭다	필 롭 다
낮	낮
천조국	천 조 국
조선글	조 선 글
남빙양	남 빙 양
상응	상 응
최적화	최 적 화
쌍절곤	쌍 절 곤
約婚女	約 婚 女
대주교	대 주 교
다엽	다 엽
편찮으시다	편 찮 으 시 다
개발되다	개 발 되 다
정령	정 령
거렁뱅이	거 렁 뱅 이
부양하다	부 양 하 다
배소	배 소
인출	인 출
여보	여 보
쥬스	쥬 스
제복	제 복
때늦다	때 늦 다
㤼	㤼
뜯기	뜯 기
룻	룻
음독	음 독
퇴비	퇴 비
싸불	싸 불
노랫소리	노 랫 소 리
급여하다	급 여 하 다
이성애자	이 성 애 자
현대사	현 대 사
성냥	성 냥
핏줄	핏 줄
쌀밥	쌀 밥
난태생	난 태 생
邌	邌
버몬트	버 몬 트
㳲	㳲
드립	드 립
라파엘	라 파 엘
겅게	겅 게
선창	선 창
곰틀	곰 틀
큰굿	큰 굿
배불리	배 불 리
네브라스카	네 브 라 스 카
타일	타 일
안뜰	안 뜰
섶	섶
육봉	육 봉
미어터지다	미 어 터 지 다
찌끄레기	찌 끄 레 기
유신론	유 신 론
貇	貇
무당벌레	무 당 벌 레
곤색	곤 색
만주어	만 주 어
무역항	무 역 항
-으이-	- 으 이 -
꽃미남	꽃 미 남
한월어	한 월 어
낚시터	낚 시 터
걸림	걸 림
여행사	여 행 사
맏형	맏 형
아웃사이더	아 웃 사 이 더
유언	유 언
계엄령	계 엄 령
女子親舊	女 子 親 舊
넓적다리	넓 적 다 리
앰풀	앰 풀
유명하다	유 명 하 다
유교	유 교
말미암다	말 미 암 다
저승	저 승
겨울털	겨 울 털
함흥	함 흥
물어보다	물 어 보 다
망령	망 령
새끼손가락	새 끼 손 가 락
체적	체 적
감투	감 투
상어피	상 어 피
살금살금	살 금 살 금
六德	六 德
수영복	수 영 복
대리석	대 리 석
왼	왼
탐색	탐 색
이끌다	이 끌 다
미제	미 제
데망	데 망
현무암	현 무 암
화학자	화 학 자
힘없다	힘 없 다
송과선	송 과 선
도작	도 작
면실유	면 실 유
춘절	춘 절
일으키다	일 으 키 다
사냥하다	사 냥 하 다
희	희
비평가	비 평 가
마찰시키다	마 찰 시 키 다
갈증나다	갈 증 나 다
데타	데 타
억울하다	억 울 하 다
용대	용 대
론쟁	론 쟁
필살기	필 살 기
묵다	묵 다
농악	농 악
원주율	원 주 율
在日朝鮮語	在 日 朝 鮮 語
의태어	의 태 어
공급자	공 급 자
협격	협 격
호박등	호 박 등
팡구	팡 구
몬로비아	몬 로 비 아
단순히	단 순 히
방구	방 구
未滿	未 滿
水死	水 死
펴낸곳	펴 낸 곳
이슬비	이 슬 비
소수민족	소 수 민 족
통가리	통 가 리
위층	위 층
明神	明 神
과일물	과 일 물
맞추다	맞 추 다
간증	간 증
납세자	납 세 자
사리	사 리
견문발검	견 문 발 검
분납하다	분 납 하 다
카디건	카 디 건
㐚	㐚
하슘	하 슘
목석	목 석
신농	신 농
끽연	끽 연
잠바	잠 바
쒀이러우	쒀 이 러 우
오케스트라	오 케 스 트 라
面刀	面 刀
威風堂堂	威 風 堂 堂
그물기름갖	그 물 기 름 갖
명신	명 신
수동태	수 동 태
전답	전 답
북빙양	북 빙 양
해코지	해 코 지
살며시	살 며 시
몸매	몸 매
물증	물 증
방조	방 조
팥배나무	팥 배 나 무
사진술	사 진 술
궤	궤
토라	토 라
새닥다리	새 닥 다 리
終着	終 着
부적	부 적
갈쓰뚝	갈 쓰 뚝
계집종	계 집 종
해안	해 안
흑비둘기	흑 비 둘 기
덴푸라	덴 푸 라
되야지	되 야 지
아제르바이잔	아 제 르 바 이 잔
딸꾹질하다	딸 꾹 질 하 다
건포도	건 포 도
닭싸움	닭 싸 움
여성주의자	여 성 주 의 자
부자	부 자
쾌락	쾌 락
구식	구 식
미융모	미 융 모
찌다	찌 다
파충	파 충
폐막식	폐 막 식
호전	호 전
질식하다	질 식 하 다
변이하다	변 이 하 다
선택권	선 택 권
쨍아	쨍 아
안마당	안 마 당
명료	명 료
졸리다	졸 리 다
벌써	벌 써
위력	위 력
簒奪	簒 奪
단어	단 어
상반신	상 반 신
버썩	버 썩
베드신	베 드 신
鑛物學	鑛 物 學
뛰어들다	뛰 어 들 다
음쓰	음 쓰
토스터	토 스 터
만이	만 이
토우	토 우
마이트너륨	마 이 트 너 륨
호장근	호 장 근
갈옷	갈 옷
레위니옹	레 위 니 옹
불가결	불 가 결
정관사	정 관 사
압운	압 운
앗	앗
뽀뽀하다	뽀 뽀 하 다
갋다	갋 다
박수하다	박 수 하 다
천자문	천 자 문
끼야기	끼 야 기
돈닢	돈 닢
찌꺼기	찌 꺼 기
언	언
사라예보	사 라 예 보
엉가	엉 가
전화번호	전 화 번 호
앨라바마	앨 라 바 마
트름	트 름
잠망경	잠 망 경
혐짤	혐 짤
裁判所	裁 判 所
재량	재 량
㫇	㫇
양봉	양 봉
트럼펫	트 럼 펫
파랗다	파 랗 다
이문	이 문
공기방석자동차	공 기 방 석 자 동 차
시적	시 적
대응하다	대 응 하 다
크세논	크 세 논
거서간	거 서 간
유기체	유 기 체
개리	개 리
레늄	레 늄
스케트	스 케 트
완행	완 행
풍차	풍 차
酸化物	酸 化 物
칠면조	칠 면 조
가시나	가 시 나
애아	애 아
플래카드	플 래 카 드
合成語	合 成 語
齄	齄
침울	침 울
被曝	被 曝
밭재	밭 재
가발	가 발
크레인	크 레 인
해제끼다	해 제 끼 다
작렬하다	작 렬 하 다
악귀	악 귀
심줄	심 줄
누리	누 리
아줄렌	아 줄 렌
여자친구	여 자 친 구
미혼모	미 혼 모
발리볼	발 리 볼
㐦	㐦
휴학	휴 학
속삭임	속 삭 임
防禦하다	防 禦 하 다
흩어지다	흩 어 지 다
감지기	감 지 기
분명하다	분 명 하 다
不撤晝夜	不 撤 晝 夜
염주비둘기	염 주 비 둘 기
전심	전 심
마라샹궈	마 라 샹 궈
盲目的	盲 目 的
피망	피 망
사납다	사 납 다
변변하다	변 변 하 다
닭쌈	닭 쌈
태양절	태 양 절
신놀린	신 놀 린
서정시	서 정 시
가령	가 령
복병	복 병
생사여탈권	생 사 여 탈 권
필통	필 통
구타	구 타
염복	염 복
비명	비 명
폐하	폐 하
드릴	드 릴
전디다	전 디 다
이슬람국가	이 슬 람 국 가
肉德	肉 德
사르다	사 르 다
출전	출 전
넘기다	넘 기 다
인물사전	인 물 사 전
북아프리카	북 아 프 리 카
장로	장 로
밥집	밥 집
자랑스럽다	자 랑 스 럽 다
근절하다	근 절 하 다
에피소드	에 피 소 드
노이로제	노 이 로 제
굴러가다	굴 러 가 다
ㄵ	ㄵ
주사	주 사
부드럽다	부 드 럽 다
화신	화 신
하리코프	하 리 코 프
䰶	䰶
케이터링	케 이 터 링
기증자	기 증 자
어우르다	어 우 르 다
腦裏	腦 裏
鎤	鎤
과하다	과 하 다
카바졸	카 바 졸
모래상자	모 래 상 자
성지	성 지
鬪爭	鬪 爭
모란	모 란
평가하다	평 가 하 다
앙골라	앙 골 라
㐋	㐋
공화국	공 화 국
음소문자	음 소 문 자
경성	경 성
썸팅	썸 팅
죽부인	죽 부 인
매콤하다	매 콤 하 다
쟁반	쟁 반
공범	공 범
스타디움	스 타 디 움
영서	영 서
攄得	攄 得
굼지럭	굼 지 럭
칡	칡
학대	학 대
서류철	서 류 철
부업	부 업
-이까	- 이 까
굶주림	굶 주 림
요셉	요 셉
반다르세리베가완	반 다 르 세 리 베 가 완
취하다	취 하 다
뚝뚝하다	뚝 뚝 하 다
당연히	당 연 히
고리	고 리
야행차	야 행 차
연적	연 적
금수저	금 수 저
야기하다	야 기 하 다
방목하다	방 목 하 다
㱷	㱷
옹근	옹 근
승리자	승 리 자
잠재력	잠 재 력
막다	막 다
노름	노 름
사마귀	사 마 귀
숙	숙
六曹	六 曹
목면	목 면
산유화	산 유 화
금병매	금 병 매
반화석	반 화 석
양력	양 력
고금	고 금
아몬드	아 몬 드
변절	변 절
아무르산개구리	아 무 르 산 개 구 리
八色鳥	八 色 鳥
두드러기	두 드 러 기
까맣다	까 맣 다
십	십
수레	수 레
매화	매 화
용하다	용 하 다
불닭	불 닭
병아	병 아
않다	않 다
억누르다	억 누 르 다
해산물	해 산 물
반동	반 동
양성자	양 성 자
고투	고 투
何如間	何 如 間
빙고	빙 고
저금	저 금
고랑내	고 랑 내
칭찬	칭 찬
오리너구리	오 리 너 구 리
구마	구 마
베달	베 달
오르가슴	오 르 가 슴
세르비아어	세 르 비 아 어
쌍기역	쌍 기 역
흑해	흑 해
접경	접 경
베다	베 다
봄나물	봄 나 물
녜	녜
자유지상주의	자 유 지 상 주 의
우렁이	우 렁 이
벌하다	벌 하 다
잎새버섯	잎 새 버 섯
벌주다	벌 주 다
캄차카	캄 차 카
薔薇水	薔 薇 水
翾	翾
음탕하다	음 탕 하 다
-갰-	- 갰 -
그림버티개	그 림 버 티 개
안후이	안 후 이
핵반응	핵 반 응
電話番號	電 話 番 號
쿠알라룸푸르	쿠 알 라 룸 푸 르
비암	비 암
계시판	계 시 판
반려	반 려
가찹다	가 찹 다
관대하다	관 대 하 다
급습	급 습
토치	토 치
소꿉동무	소 꿉 동 무
캡슐	캡 슐
왕관비둘기	왕 관 비 둘 기
매다	매 다
차단하다	차 단 하 다
쿠바	쿠 바
필적학	필 적 학
정판	정 판
운동선수	운 동 선 수
청신	청 신
인격	인 격
세미콜론	세 미 콜 론
돼지갈비	돼 지 갈 비
원장	원 장
다우존스	다 우 존 스
재래	재 래
완전히	완 전 히
이슬라마바드	이 슬 라 마 바 드
후견인	후 견 인
가타카나	가 타 카 나
얼다	얼 다
압록자그사니	압 록 자 그 사 니
퍼지다	퍼 지 다
원자력발전소	원 자 력 발 전 소
십팔	십 팔
서로	서 로
오롯하다	오 롯 하 다
참새피	참 새 피
막힘없다	막 힘 없 다
대장장이	대 장 장 이
북측	북 측
까마귀	까 마 귀
-마동	- 마 동
브로맨스	브 로 맨 스
추잡하다	추 잡 하 다
골동품	골 동 품
기슭	기 슭
벗기다	벗 기 다
PC통신	P C 통 신
가문비나무	가 문 비 나 무
빤스런	빤 스 런
대취타	대 취 타
걸리다	걸 리 다
물망초	물 망 초
백설	백 설
우도	우 도
率先垂範	率 先 垂 範
備蓄	備 蓄
일확천금	일 확 천 금
목격되다	목 격 되 다
오페레타	오 페 레 타
連動	連 動
氷菓	氷 菓
-슈	- 슈
네다섯	네 다 섯
쏠리다	쏠 리 다
개구리매	개 구 리 매
콜론	콜 론
아르메니아어	아 르 메 니 아 어
밀랍	밀 랍
뼈대	뼈 대
미성	미 성
부카티니	부 카 티 니
함경도	함 경 도
수수	수 수
느낌	느 낌
날다	날 다
我田引水	我 田 引 水
다행감	다 행 감
미용사	미 용 사
플러쉬	플 러 쉬
촉각	촉 각
동북아	동 북 아
들어가다	들 어 가 다
인가	인 가
-까정	- 까 정
자유롭다	자 유 롭 다
온공일	온 공 일
덜컹이다	덜 컹 이 다
물고기	물 고 기
저력	저 력
단정하다	단 정 하 다
해협	해 협
식인종	식 인 종
후두	후 두
老衰	老 衰
톈안먼	톈 안 먼
주기	주 기
소방수	소 방 수
폭소	폭 소
수리공	수 리 공
교인	교 인
푸석	푸 석
사닥다리	사 닥 다 리
파자마	파 자 마
어름치	어 름 치
암기하다	암 기 하 다
넢다	넢 다
괴롭히다	괴 롭 히 다
인절미	인 절 미
치어리딩	치 어 리 딩
赤血球	赤 血 球
해다	해 다
율	율
방동사니	방 동 사 니
안녕하다	안 녕 하 다
심사숙고	심 사 숙 고
유리기	유 리 기
불란서어	불 란 서 어
검스	검 스
열한째	열 한 째
지중해	지 중 해
끔뻑	끔 뻑
보드	보 드
폭풍우	폭 풍 우
살모사	살 모 사
부아소리	부 아 소 리
유약	유 약
생물체	생 물 체
파시즘	파 시 즘
고별	고 별
알칼리	알 칼 리
각혈	각 혈
말똥구리	말 똥 구 리
프런트	프 런 트
따라가다	따 라 가 다
팀부	팀 부
붙잡다	붙 잡 다
망초	망 초
보신탕	보 신 탕
아첨꾼	아 첨 꾼
벌거벗다	벌 거 벗 다
삼나라	삼 나 라
재미없다	재 미 없 다
성게	성 게
일구이언	일 구 이 언
묵직하다	묵 직 하 다
대영제국	대 영 제 국
䭜	䭜
중력	중 력
栮	栮
두덩	두 덩
부등식	부 등 식
거릿모테이	거 릿 모 테 이
본조	본 조
공휴	공 휴
기만되다	기 만 되 다
윤년	윤 년
설교자	설 교 자
우펀국	우 펀 국
쌍방	쌍 방
버클륨	버 클 륨
이진수	이 진 수
접때	접 때
없애다	없 애 다
레코더	레 코 더
검댕	검 댕
통지	통 지
샤워	샤 워
피리다진	피 리 다 진
검정색	검 정 색
돌잡이	돌 잡 이
헌사	헌 사
一品料理	一 品 料 理
顈	顈
카공족	카 공 족
말다툼	말 다 툼
베도라치	베 도 라 치
확실	확 실
궁민	궁 민
손주	손 주
곱사	곱 사
紙匣	紙 匣
유민	유 민
각설	각 설
삼림	삼 림
창조적	창 조 적
어지럽다	어 지 럽 다
돌격하다	돌 격 하 다
떡국	떡 국
밀당	밀 당
개집	개 집
생크림	생 크 림
-쓰	- 쓰
확성기	확 성 기
수도권	수 도 권
엽록소	엽 록 소
먹어요	먹 어 요
숨통	숨 통
옷장	옷 장
料金	料 金
오스트랄리아	오 스 트 랄 리 아
더미	더 미
민족사회주의	민 족 사 회 주 의
사학자	사 학 자
칠성장어	칠 성 장 어
기생물	기 생 물
파출소	파 출 소
둑중개	둑 중 개
어떠하다	어 떠 하 다
취조	취 조
금하다	금 하 다
유두	유 두
-답다	- 답 다
ㅄ	ㅄ
흰동가리	흰 동 가 리
원산	원 산
창작물	창 작 물
된장찌개	된 장 찌 개
성립되다	성 립 되 다
술기운	술 기 운
펜테인	펜 테 인
세모꼴	세 모 꼴
법적	법 적
펠리컨	펠 리 컨
대학원생	대 학 원 생
集中力	集 中 力
한동안	한 동 안
취흥	취 흥
논제	논 제
쿨쿨	쿨 쿨
삯	삯
폐경기	폐 경 기
물메기	물 메 기
배암	배 암
어엿하다	어 엿 하 다
조이스틱	조 이 스 틱
갱도	갱 도
사사오입	사 사 오 입
망각	망 각
故鄕	故 鄕
㑡	㑡
꿩의밥	꿩 의 밥
-디	- 디
따지다	따 지 다
비판하다	비 판 하 다
진열장	진 열 장
과식	과 식
밤샘	밤 샘
더듬이다리	더 듬 이 다 리
千年紀	千 年 紀
압생트	압 생 트
-어요	- 어 요
遊泳	遊 泳
뻔쩍뻔쩍	뻔 쩍 뻔 쩍
줄몰개	줄 몰 개
입장권	입 장 권
창공	창 공
부룬디	부 룬 디
수력	수 력
폭뢰	폭 뢰
가강수량	가 강 수 량
放送社	放 送 社
동음이의어	동 음 이 의 어
모독	모 독
항복	항 복
전자공학	전 자 공 학
이단	이 단
노르웨이어	노 르 웨 이 어
갈기	갈 기
거북	거 북
랭장고	랭 장 고
회교도	회 교 도
출산	출 산
屈曲位	屈 曲 位
겨누다	겨 누 다
편경	편 경
천황	천 황
匪賊	匪 賊
맡기다	맡 기 다
여위다	여 위 다
견본	견 본
불로불사	불 로 불 사
週期律表	週 期 律 表
생기다	생 기 다
단감자	단 감 자
양성애	양 성 애
아마	아 마
이륙	이 륙
격언	격 언
해성	해 성
락다운	락 다 운
서왕모	서 왕 모
巼	巼
코주부원숭이	코 주 부 원 숭 이
예취기	예 취 기
물박달나무	물 박 달 나 무
자국	자 국
도시	도 시
특별하다	특 별 하 다
容疑者	容 疑 者
배드민턴	배 드 민 턴
향참외	향 참 외
빠그르르	빠 그 르 르
탄화	탄 화
뼈해장국	뼈 해 장 국
로획	로 획
나조	나 조
까물까물	까 물 까 물
부정적분	부 정 적 분
別別	別 別
그윽하다	그 윽 하 다
시짱	시 짱
여배우	여 배 우
게르만	게 르 만
거치적거리다	거 치 적 거 리 다
컨베이어	컨 베 이 어
과로사	과 로 사
학생회관	학 생 회 관
독물	독 물
얼룩말	얼 룩 말
놀이	놀 이
숙취	숙 취
쿵후	쿵 후
행리	행 리
토착	토 착
과시하다	과 시 하 다
知能	知 能
나토	나 토
축복하다	축 복 하 다
이런저런	이 런 저 런
붉은솔개	붉 은 솔 개
傍接圓	傍 接 圓
열애하다	열 애 하 다
죄수	죄 수
감소	감 소
례	례
채석장	채 석 장
침착하다	침 착 하 다
해설하다	해 설 하 다
청진기	청 진 기
조촐하다	조 촐 하 다
가나다순	가 나 다 순
최애	최 애
개회식	개 회 식
동정녀	동 정 녀
줄임말	줄 임 말
말갛다	말 갛 다
성신	성 신
오밤	오 밤
와싹	와 싹
춘우	춘 우
持株	持 株
돌고래	돌 고 래
앞서다	앞 서 다
민물가마우지	민 물 가 마 우 지
녘	녘
고뱅이	고 뱅 이
찬란하다	찬 란 하 다
옥황상제	옥 황 상 제
제육	제 육
도야지	도 야 지
집채	집 채
시체	시 체
싸움터	싸 움 터
동자개	동 자 개
似而非	似 而 非
그믐	그 믐
멸시	멸 시
쓰레받기	쓰 레 받 기
가락지빵	가 락 지 빵
瑎	瑎
노보시비르스크	노 보 시 비 르 스 크
쉬리	쉬 리
조산사	조 산 사
代理者	代 理 者
계기비행	계 기 비 행
비자나무	비 자 나 무
말하기	말 하 기
위령제	위 령 제
예다	예 다
아프리카	아 프 리 카
고리짝	고 리 짝
洬	洬
돌팔이	돌 팔 이
라파스	라 파 스
만	만
연정	연 정
破談	破 談
설거지	설 거 지
조선반도	조 선 반 도
승학연	승 학 연
빛	빛
복수형	복 수 형
샤쯔	샤 쯔
오랑우탄	오 랑 우 탄
문화재	문 화 재
縱的	縱 的
과일	과 일
濠洲	濠 洲
꽃가루	꽃 가 루
경입자	경 입 자
-래요	- 래 요
타당	타 당
노처녀	노 처 녀
초인종	초 인 종
홍위병	홍 위 병
달다	달 다
로키	로 키
길경	길 경
음용수	음 용 수
명조체	명 조 체
철인	철 인
돌마자	돌 마 자
맨들다	맨 들 다
마리우폴	마 리 우 폴
相性	相 性
엎디리다	엎 디 리 다
칼납자루	칼 납 자 루
-시니까	- 시 니 까
만엽집	만 엽 집
감파르다	감 파 르 다
작살	작 살
푸실리	푸 실 리
테레비	테 레 비
모욕	모 욕
앎	앎
筽	筽
갈밭쥐	갈 밭 쥐
현재시제	현 재 시 제
모형	모 형
기쁘다	기 쁘 다
곱이곱이	곱 이 곱 이
흘러가다	흘 러 가 다
배교	배 교
백그라운드	백 그 라 운 드
브라질리아	브 라 질 리 아
冠形詞	冠 形 詞
빨찌산	빨 찌 산
동명인	동 명 인
병살	병 살
-간	- 간
시대정신	시 대 정 신
여단	여 단
지정되다	지 정 되 다
상완삼두근	상 완 삼 두 근
찹쌀	찹 쌀
죽이다	죽 이 다
필적	필 적
투영기	투 영 기
사향	사 향
적당하다	적 당 하 다
-더	- 더
렴	렴
향항	향 항
보약	보 약
곤난	곤 난
바로잡다	바 로 잡 다
쏴	쏴
이르쿠츠크	이 르 쿠 츠 크
성함	성 함
관습	관 습
숙청	숙 청
迲	迲
포르토프랭스	포 르 토 프 랭 스
옥좌	옥 좌
꼬마향고래	꼬 마 향 고 래
경영하다	경 영 하 다
저널리스트	저 널 리 스 트
우사	우 사
형무소	형 무 소
감쇠기	감 쇠 기
뇽새	뇽 새
시나이	시 나 이
자잘하다	자 잘 하 다
글라이더	글 라 이 더
마침표	마 침 표
양파	양 파
우두커니	우 두 커 니
乺	乺
백야	백 야
샐러드	샐 러 드
꽁무니	꽁 무 니
참붕어	참 붕 어
거두다	거 두 다
황학루	황 학 루
처신하다	처 신 하 다
저울	저 울
넓이	넓 이
비닐류	비 닐 류
복음서	복 음 서
변론가	변 론 가
와타시	와 타 시
삼매	삼 매
부츠	부 츠
피라미	피 라 미
저지하다	저 지 하 다
홀스터	홀 스 터
막창자	막 창 자
테러범	테 러 범
주리다	주 리 다
밤빵	밤 빵
䥹	䥹
씹다	씹 다
砂果	砂 果
타협하다	타 협 하 다
舷窓	舷 窓
어귀	어 귀
설악산	설 악 산
삽입곡	삽 입 곡
기념품	기 념 품
순박	순 박
모스크	모 스 크
-더랫-	- 더 랫 -
부끄리다	부 끄 리 다
퍅	퍅
피넨	피 넨
심정	심 정
특이하다	특 이 하 다
ㅑ	ㅑ
순무	순 무
칠하다	칠 하 다
광물	광 물
교가	교 가
가락점	가 락 점
支援者	支 援 者
조언하다	조 언 하 다
장독	장 독
숫처녀	숫 처 녀
배우	배 우
한류	한 류
와싹와싹	와 싹 와 싹
작용하다	작 용 하 다
배기관	배 기 관
마스다	마 스 다
미꾸리	미 꾸 리
꿀빨기새	꿀 빨 기 새
탱커	탱 커
自鳴琴	自 鳴 琴
분교	분 교
색채	색 채
가무이야기	가 무 이 야 기
팔목	팔 목
안습	안 습
폴란드	폴 란 드
남사친	남 사 친
무두붉나무	무 두 붉 나 무
봉분	봉 분
사격	사 격
공습	공 습
조종하다	조 종 하 다
유충	유 충
광란	광 란
외야수	외 야 수
팔십	팔 십
각선미	각 선 미
단검	단 검
㔛	㔛
닝샤	닝 샤
임대하다	임 대 하 다
물꿩	물 꿩
도망자	도 망 자
북조선	북 조 선
조피볼락	조 피 볼 락
식물	식 물
눈총	눈 총
아리새	아 리 새
도륙되다	도 륙 되 다
衙婢	衙 婢
중고기	중 고 기
恭遜	恭 遜
회개	회 개
뢴트겐	뢴 트 겐
사랑채	사 랑 채
논밭	논 밭
종가시나무	종 가 시 나 무
곰실곰실	곰 실 곰 실
들치기	들 치 기
朱色	朱 色
漣痕	漣 痕
아련	아 련
번체	번 체
공경	공 경
피읖	피 읖
속수무책	속 수 무 책
목말	목 말
그렇다	그 렇 다
잔인	잔 인
나전	나 전
가련하다	가 련 하 다
김장	김 장
코이	코 이
잎꼭지	잎 꼭 지
입방체	입 방 체
햇언나	햇 언 나
참모장	참 모 장
신부님	신 부 님
서약하다	서 약 하 다
아이오와	아 이 오 와
㥙	㥙
사법	사 법
ᄯᅳ겁다	ᄯ ᅳ 겁 다
중천	중 천
영포자	영 포 자
덕택	덕 택
-ㄴ다	- ㄴ 다
립자	립 자
大衆交通	大 衆 交 通
지붕케	지 붕 케
李箱	李 箱
훌리건	훌 리 건
맺음말	맺 음 말
뒷북	뒷 북
두꺼비	두 꺼 비
락타	락 타
여객	여 객
대동강	대 동 강
생쥐	생 쥐
위풍당당하다	위 풍 당 당 하 다
약력	약 력
기록하다	기 록 하 다
가제따	가 제 따
모이다	모 이 다
데려가다	데 려 가 다
鏶	鏶
우비다	우 비 다
에어컨디셔너	에 어 컨 디 셔 너
마렵다	마 렵 다
둏다	둏 다
보안사	보 안 사
장서	장 서
그女	그 女
스트리머	스 트 리 머
워썩	워 썩
약품	약 품
케더링	케 더 링
흐릿하다	흐 릿 하 다
위원	위 원
마괘	마 괘
앉을배이	앉 을 배 이
아방궁	아 방 궁
범아귀	범 아 귀
송편	송 편
위험하다	위 험 하 다
버썩버썩	버 썩 버 썩
kijul	k i j u l
모태솔로	모 태 솔 로
받치다	받 치 다
헛기다리다	헛 기 다 리 다
밝히다	밝 히 다
회자	회 자
혜택	혜 택
썬글라스	썬 글 라 스
㐐	㐐
프랑스인	프 랑 스 인
셤	셤
목도	목 도
비축	비 축
남동생	남 동 생
품목	품 목
뀌매다	뀌 매 다
탈출하다	탈 출 하 다
곱	곱
피	피
주다	주 다
폭격	폭 격
강철	강 철
납자루	납 자 루
흑사병	흑 사 병
버텅아래	버 텅 아 래
유청	유 청
전위	전 위
답습하다	답 습 하 다
개렵다	개 렵 다
복원하다	복 원 하 다
경옥	경 옥
뿔논병아리	뿔 논 병 아 리
손뼉	손 뼉
암기	암 기
정숙하다	정 숙 하 다
항복하다	항 복 하 다
창설하다	창 설 하 다
향기롭다	향 기 롭 다
새콤하다	새 콤 하 다
한하다	한 하 다
애란	애 란
킹스타운	킹 스 타 운
골백	골 백
궂다	궂 다
루비	루 비
동티모르	동 티 모 르
기수열외	기 수 열 외
부정하다	부 정 하 다
본부	본 부
서진	서 진
조리다	조 리 다
벗다	벗 다
私讐	私 讐
적분	적 분
별똥	별 똥
유월절	유 월 절
문틈	문 틈
예언	예 언
교육하다	교 육 하 다
경관	경 관
보철	보 철
가리다	가 리 다
마구간	마 구 간
간직하다	간 직 하 다
모세관	모 세 관
방위산업체	방 위 산 업 체
은퇴하다	은 퇴 하 다
간지럼	간 지 럼
참개구리	참 개 구 리
참신	참 신
南阿共	南 阿 共
팸플릿	팸 플 릿
놔두다	놔 두 다
얼음과자	얼 음 과 자
海嶺	海 嶺
술자리	술 자 리
닮음	닮 음
노파심	노 파 심
항공모함	항 공 모 함
초강대국	초 강 대 국
미분	미 분
알켄	알 켄
椧	椧
범퍼	범 퍼
겁먹다	겁 먹 다
고르다	고 르 다
몬트리올	몬 트 리 올
붉은피톨	붉 은 피 톨
극심	극 심
마흐디	마 흐 디
괴혈병	괴 혈 병
말레이어	말 레 이 어
알바니아어	알 바 니 아 어
훈훈하다	훈 훈 하 다
음표	음 표
투포환	투 포 환
죠이	죠 이
진하다	진 하 다
기세하다	기 세 하 다
써다	써 다
자판	자 판
도기	도 기
심구다	심 구 다
誤審	誤 審
지적	지 적
열리다	열 리 다
죽음	죽 음
改寤	改 寤
누두	누 두
변화하다	변 화 하 다
퍼브	퍼 브
주형	주 형
數學者	數 學 者
핀란드	핀 란 드
파행	파 행
재난	재 난
비읍	비 읍
품삯	품 삯
어의	어 의
장강	장 강
공주병	공 주 병
대리자	대 리 자
조약돌	조 약 돌
전동	전 동
열여덟	열 여 덟
해쓱하다	해 쓱 하 다
독립국가협동체	독 립 국 가 협 동 체
볼런티어	볼 런 티 어
소방서	소 방 서
잔재	잔 재
암살자	암 살 자
구매되다	구 매 되 다
신입생	신 입 생
적히다	적 히 다
분주하다	분 주 하 다
웨스트버지니아	웨 스 트 버 지 니 아
이론	이 론
거릿모티이	거 릿 모 티 이
하릅	하 릅
닫히다	닫 히 다
밀리그램	밀 리 그 램
개똥벌레	개 똥 벌 레
禝	禝
찧다	찧 다
예보	예 보
알현	알 현
방안	방 안
투사지	투 사 지
맹꽁맹꽁	맹 꽁 맹 꽁
베냉	베 냉
벼리다	벼 리 다
한탄하다	한 탄 하 다
울리짜	울 리 짜
쌍벽	쌍 벽
세슘	세 슘
자살자	자 살 자
크기	크 기
구판	구 판
가티노	가 티 노
부채선인장	부 채 선 인 장
곧다	곧 다
맹자	맹 자
고릴라	고 릴 라
튀기다	튀 기 다
모태	모 태
㠫	㠫
轟音	轟 音
원격조작	원 격 조 작
의미론	의 미 론
테구시갈파	테 구 시 갈 파
빠뜨리다	빠 뜨 리 다
구미호	구 미 호
의하다	의 하 다
댕댕	댕 댕
남성	남 성
休憩室	休 憩 室
훵크	훵 크
확대경	확 대 경
백개먼	백 개 먼
마우재	마 우 재
드러나다	드 러 나 다
헤로인	헤 로 인
士禍	士 禍
독당근	독 당 근
크로아티아인	크 로 아 티 아 인
귀결	귀 결
용지	용 지
모냥	모 냥
철물점	철 물 점
벼루	벼 루
메스	메 스
코피	코 피
홋카이도	홋 카 이 도
카르텔	카 르 텔
價格帶	價 格 帶
漆板	漆 板
머그잔	머 그 잔
아르바이트	아 르 바 이 트
개봉하다	개 봉 하 다
둬	둬
심문	심 문
간자이	간 자 이
조용하다	조 용 하 다
깜둥이	깜 둥 이
트랙터	트 랙 터
揵	揵
콘택트	콘 택 트
承服	承 服
해일경보	해 일 경 보
아틀리에	아 틀 리 에
담박	담 박
곤돌라	곤 돌 라
준주	준 주
이상하다	이 상 하 다
㐘	㐘
억류자	억 류 자
군담	군 담
누부	누 부
-기-	- 기 -
군중	군 중
튀다	튀 다
왕래하다	왕 래 하 다
시찰	시 찰
음경골	음 경 골
아뇰로티	아 뇰 로 티
칠각형	칠 각 형
손쉽다	손 쉽 다
三葉機	三 葉 機
사하다	사 하 다
티아졸	티 아 졸
훑어보다	훑 어 보 다
기초하다	기 초 하 다
긋다	긋 다
스캐너	스 캐 너
원자력	원 자 력
아해	아 해
감탄하다	감 탄 하 다
절대적	절 대 적
세종	세 종
산토끼	산 토 끼
애국자	애 국 자
히드록시기	히 드 록 시 기
일본국	일 본 국
나놔다	나 놔 다
대위	대 위
교착	교 착
일면식	일 면 식
급격하다	급 격 하 다
擴大鏡	擴 大 鏡
영사	영 사
논어	논 어
진딧물	진 딧 물
幱	幱
칫솔	칫 솔
여의자	여 의 자
-야요	- 야 요
랭면	랭 면
부탁해요	부 탁 해 요
채찍	채 찍
안절부절	안 절 부 절
껭이	껭 이
판옥선	판 옥 선
副腎皮質	副 腎 皮 質
사시미	사 시 미
도륙	도 륙
집쥐	집 쥐
불안하다	불 안 하 다
적응도	적 응 도
스웨터	스 웨 터
오랑캐	오 랑 캐
아야톨라	아 야 톨 라
뱃놀이	뱃 놀 이
날것	날 것
어휘집	어 휘 집
마술사	마 술 사
악필	악 필
말세	말 세
여끄	여 끄
껌	껌
부섴	부 섴
전람회	전 람 회
乾畓	乾 畓
북두칠성	북 두 칠 성
惡辣	惡 辣
다묵장어	다 묵 장 어
一品	一 品
접문	접 문
에스토니아어	에 스 토 니 아 어
부리다	부 리 다
동양	동 양
갈아들다	갈 아 들 다
자고배	자 고 배
너덧	너 덧
절차	절 차
교육되다	교 육 되 다
의중	의 중
不凍液	不 凍 液
쇠	쇠
테프	테 프
낙	낙
등가물	등 가 물
個月	個 月
떨어뜨리다	떨 어 뜨 리 다
지극	지 극
平海	平 海
제주도	제 주 도
일코	일 코
북마크	북 마 크
드러냄	드 러 냄
흑발	흑 발
나치즘	나 치 즘
검은무리	검 은 무 리
깨끗하다	깨 끗 하 다
톳	톳
균류	균 류
不可缺脂肪酸	不 可 缺 脂 肪 酸
터럭	터 럭
갤치다	갤 치 다
화장지	화 장 지
중거	중 거
인도유럽어족	인 도 유 럽 어 족
매듭	매 듭
검둥오리사촌	검 둥 오 리 사 촌
오케이	오 케 이
지사	지 사
캄팔라	캄 팔 라
깜빡하다	깜 빡 하 다
土着	土 着
동행	동 행
불리다	불 리 다
말살하다	말 살 하 다
-걸랑	- 걸 랑
어찌하다	어 찌 하 다
보지하다	보 지 하 다
숭배되다	숭 배 되 다
同窓	同 窓
관목	관 목
잎갈나무	잎 갈 나 무
대황	대 황
산호	산 호
호분자	호 분 자
잡년	잡 년
해외	해 외
마다	마 다
꽃병	꽃 병
년도	년 도
간청	간 청
풍자	풍 자
토착어	토 착 어
기공	기 공
재킷	재 킷
냠냠	냠 냠
트렁크	트 렁 크
합치다	합 치 다
불타다	불 타 다
요건	요 건
토쿄	토 쿄
뭉클하다	뭉 클 하 다
無言症	無 言 症
이팝나무	이 팝 나 무
합성록음	합 성 록 음
기윽	기 윽
묠니르	묠 니 르
예비	예 비
骪	骪
예약하다	예 약 하 다
여건	여 건
-께서	- 께 서
관리인	관 리 인
미유기	미 유 기
박대	박 대
아라비아인	아 라 비 아 인
땐쓰	땐 쓰
플라이어	플 라 이 어
목젖	목 젖
커버	커 버
-은데	- 은 데
이과	이 과
수리하다	수 리 하 다
基礎하다	基 礎 하 다
트롤리버스	트 롤 리 버 스
반의어	반 의 어
증발	증 발
온돌	온 돌
애무	애 무
서밋	서 밋
껴안다	껴 안 다
합리주의	합 리 주 의
시더기	시 더 기
우로	우 로
한턱내다	한 턱 내 다
편재	편 재
용도	용 도
양치	양 치
핵분열	핵 분 열
무궁화	무 궁 화
립스틱	립 스 틱
아실기	아 실 기
학식	학 식
미음	미 음
그레나다	그 레 나 다
조사	조 사
브금	브 금
발전되다	발 전 되 다
합격	합 격
문화원	문 화 원
예상하다	예 상 하 다
철갑	철 갑
궐녀	궐 녀
분재	분 재
등허리	등 허 리
在日韓國語	在 日 韓 國 語
단절	단 절
마드라스	마 드 라 스
동중국해	동 중 국 해
효과적	효 과 적
마다가스카르	마 다 가 스 카 르
침향	침 향
권당	권 당
筥	筥
뇨키	뇨 키
밧	밧
당밀	당 밀
ㄼ	ㄼ
공성계	공 성 계
笭	笭
아보카도	아 보 카 도
어머	어 머
평판	평 판
칼상어	칼 상 어
침묵	침 묵
밤색	밤 색
선택하다	선 택 하 다
寸劇	寸 劇
헤집다	헤 집 다
蜃氣樓	蜃 氣 樓
쓰딸로바야	쓰 딸 로 바 야
겹치다	겹 치 다
참마자	참 마 자
國粹主義	國 粹 主 義
협잡질	협 잡 질
핀	핀
淸潔	淸 潔
률시	률 시
불꽃놀이	불 꽃 놀 이
프로펠러	프 로 펠 러
자산	자 산
陽數	陽 數
살짝살짝	살 짝 살 짝
왜어	왜 어
그만두다	그 만 두 다
장터	장 터
사악	사 악
슬로베니아어	슬 로 베 니 아 어
래	래
기물	기 물
토벌	토 벌
퇴학	퇴 학
싣다	싣 다
打率	打 率
몰리브데넘	몰 리 브 데 넘
무화과	무 화 과
카나리아	카 나 리 아
포함하다	포 함 하 다
가관	가 관
탱	탱
직장	직 장
갈아입다	갈 아 입 다
실천하다	실 천 하 다
쪼뼛	쪼 뼛
단묵	단 묵
펩타이드	펩 타 이 드
사체	사 체
대저택	대 저 택
片鱗	片 鱗
텐구	텐 구
유리창	유 리 창
군사력	군 사 력
선악	선 악
계랄	계 랄
더블유	더 블 유
보릿고개	보 릿 고 개
오글오글	오 글 오 글
살결	살 결
어릿광대	어 릿 광 대
여달	여 달
방언	방 언
황태후	황 태 후
귀요미	귀 요 미
바다뱀	바 다 뱀
화사하다	화 사 하 다
케밥	케 밥
전투	전 투
정리하다	정 리 하 다
고물고물	고 물 고 물
본능	본 능
금메	금 메
-리-	- 리 -
개봉	개 봉
나중	나 중
수사학	수 사 학
발각	발 각
살처분	살 처 분
신자식	신 자 식
방어율	방 어 율
대검집	대 검 집
깜작깜작	깜 작 깜 작
숭경	숭 경
관용구	관 용 구
식사하다	식 사 하 다
傳貰	傳 貰
파고다	파 고 다
미소년	미 소 년
종횡가	종 횡 가
활엽수	활 엽 수
경쟁하다	경 쟁 하 다
오얘	오 얘
재구하다	재 구 하 다
네댓	네 댓
삼엽기	삼 엽 기
덧니	덧 니
삥삥	삥 삥
품행	품 행
유로퓸	유 로 퓸
연구	연 구
작곡자	작 곡 자
交差位	交 差 位
찾아오다	찾 아 오 다
척하다	척 하 다
豫約	豫 約
귀빈	귀 빈
우리말	우 리 말
순서	순 서
수달	수 달
꿇다	꿇 다
막히다	막 히 다
문	문
팩토리	팩 토 리
휘다	휘 다
증명하다	증 명 하 다
풀네임	풀 네 임
액사	액 사
편수	편 수
아콰리움	아 콰 리 움
인감	인 감
동급생	동 급 생
냇가	냇 가
조립하다	조 립 하 다
후라이판	후 라 이 판
스테파노	스 테 파 노
드래건	드 래 건
퀴논	퀴 논
딱딱하다	딱 딱 하 다
주먹밥	주 먹 밥
㫌	㫌
두마	두 마
어둑서니	어 둑 서 니
따이	따 이
프랑스빵	프 랑 스 빵
센타	센 타
거닐다	거 닐 다
공수도	공 수 도
단일하다	단 일 하 다
육촌	육 촌
세존	세 존
덮개	덮 개
멱	멱
농작물	농 작 물
쪼박	쪼 박
병리	병 리
음수	음 수
주근깨	주 근 깨
추파	추 파
비평	비 평
머루	머 루
설명	설 명
묘미	묘 미
개마고원	개 마 고 원
암내	암 내
블라디보스토크	블 라 디 보 스 토 크
설농탕	설 농 탕
올빼미	올 빼 미
운전자	운 전 자
죄송	죄 송
명사화	명 사 화
눈동자개	눈 동 자 개
자르다	자 르 다
배전반	배 전 반
뻐스럭뻐스럭	뻐 스 럭 뻐 스 럭
가뭄	가 뭄
곰실	곰 실
의식하다	의 식 하 다
잠수하다	잠 수 하 다
엉뎅이	엉 뎅 이
쇠뜨기	쇠 뜨 기
큰아버지	큰 아 버 지
-아라	- 아 라
현미녹차	현 미 녹 차
뒷간	뒷 간
요리사	요 리 사
너려오다	너 려 오 다
일벌	일 벌
미시소가	미 시 소 가
거품기	거 품 기
라선	라 선
이심	이 심
찰흙	찰 흙
무신	무 신
버슬버슬	버 슬 버 슬
목화	목 화
나각	나 각
挾攻	挾 攻
핵가족	핵 가 족
공문서	공 문 서
역정	역 정
바리	바 리
시쇠	시 쇠
조부모	조 부 모
물리치다	물 리 치 다
성당	성 당
악수하다	악 수 하 다
계략	계 략
연소하다	연 소 하 다
洪吉童	洪 吉 童
열역학	열 역 학
그제	그 제
예금	예 금
경찰견	경 찰 견
마그마	마 그 마
페르시아어	페 르 시 아 어
會社員	會 社 員
대중교통	대 중 교 통
-십니꺼	- 십 니 꺼
야쿠자	야 쿠 자
미아	미 아
정신병	정 신 병
참수	참 수
가위바위보	가 위 바 위 보
미누스	미 누 스
득남하다	득 남 하 다
送金	送 金
뜸부기	뜸 부 기
개선문	개 선 문
킬트	킬 트
초롱꽃	초 롱 꽃
구개음화	구 개 음 화
朰	朰
ㄴㄴ	ㄴ ㄴ
동백	동 백
주막	주 막
행동하다	행 동 하 다
突入	突 入
가공하다	가 공 하 다
독음	독 음
不動産	不 動 産
모페드	모 페 드
槪念	槪 念
판단하다	판 단 하 다
푸석푸석	푸 석 푸 석
브로치	브 로 치
도분	도 분
斑指	斑 指
집난이	집 난 이
우방	우 방
녕	녕
육교	육 교
실내운동	실 내 운 동
선렬	선 렬
기울	기 울
보체	보 체
대원군	대 원 군
어데	어 데
최강	최 강
돈가스	돈 가 스
어금니	어 금 니
취지	취 지
價値	價 値
지원자	지 원 자
흰기러기	흰 기 러 기
동행하다	동 행 하 다
켕기다	켕 기 다
자류석	자 류 석
교섭	교 섭
문도	문 도
조팝나무	조 팝 나 무
인국	인 국
척결	척 결
티오펜	티 오 펜
석가모니	석 가 모 니
곰틀곰틀	곰 틀 곰 틀
동궁	동 궁
악력	악 력
네모	네 모
리해	리 해
낭비하다	낭 비 하 다
배변	배 변
무능	무 능
추출하다	추 출 하 다
언론	언 론
眞空管	眞 空 管
푸주	푸 주
생로병사	생 로 병 사
㻦	㻦
지권	지 권
버리다	버 리 다
실례	실 례
비율	비 율
변압기	변 압 기
평화적	평 화 적
호우	호 우
송치	송 치
우	우
으스름하다	으 스 름 하 다
시계비행	시 계 비 행
추리닝	추 리 닝
강단	강 단
핵전쟁	핵 전 쟁
노조비	노 조 비
팔라우	팔 라 우
거치다	거 치 다
계기판	계 기 판
에스키모	에 스 키 모
투표자	투 표 자
상	상
짜구배	짜 구 배
肛門性交	肛 門 性 交
風說	風 說
소프트웨어	소 프 트 웨 어
희생타	희 생 타
패스트볼	패 스 트 볼
살찐	살 찐
불사르다	불 사 르 다
수수미꾸리	수 수 미 꾸 리
셔벗	셔 벗
완비	완 비
혐오하다	혐 오 하 다
부쿠레슈티	부 쿠 레 슈 티
수익	수 익
남프릭	남 프 릭
저승사자	저 승 사 자
물떼새	물 떼 새
懷中鏡	懷 中 鏡
중화대북	중 화 대 북
걸어가다	걸 어 가 다
차분법	차 분 법
미륵	미 륵
쌍정	쌍 정
단순청상아리	단 순 청 상 아 리
체벌	체 벌
흡수지	흡 수 지
䄣	䄣
祛痰劑	祛 痰 劑
남의자	남 의 자
세계어	세 계 어
황후	황 후
뒤영벌	뒤 영 벌
각하	각 하
사냥꾼	사 냥 꾼
직발	직 발
지질	지 질
향찰	향 찰
토혈	토 혈
자가용차	자 가 용 차
제인	제 인
러시아어	러 시 아 어
식자	식 자
갈매기	갈 매 기
봄날	봄 날
서과	서 과
둥치	둥 치
족적	족 적
우편함	우 편 함
案內狀	案 內 狀
라고스	라 고 스
낮추다	낮 추 다
넓적부리	넓 적 부 리
멩이	멩 이
-유	- 유
구분하다	구 분 하 다
사난아이	사 난 아 이
탈덕	탈 덕
불량자	불 량 자
력	력
이발소	이 발 소
연회	연 회
비잔티온	비 잔 티 온
설설	설 설
암자	암 자
종일	종 일
음절	음 절
기입	기 입
만화영화	만 화 영 화
색욕	색 욕
채용하다	채 용 하 다
흑역사	흑 역 사
旣視感	旣 視 感
데띠기	데 띠 기
한열	한 열
혈청학	혈 청 학
소스	소 스
뽈스카	뽈 스 카
공손하다	공 손 하 다
촌락	촌 락
악티늄	악 티 늄
㒱	㒱
대량학살	대 량 학 살
인니	인 니
에러	에 러
도다	도 다
화실	화 실
탐폰	탐 폰
덕트	덕 트
침침하다	침 침 하 다
담배	담 배
한아바이	한 아 바 이
괴뢰	괴 뢰
㐝	㐝
兒孩	兒 孩
짤방	짤 방
결정하다	결 정 하 다
낱	낱
旗學	旗 學
베어물다	베 어 물 다
약제	약 제
미호종개	미 호 종 개
플루토늄	플 루 토 늄
촉수	촉 수
풋옵션	풋 옵 션
쳐	쳐
카피바라	카 피 바 라
䴨	䴨
피말강이	피 말 강 이
빼치다	빼 치 다
품격	품 격
홀-	홀 -
-것-	- 것 -
교사하다	교 사 하 다
봉사	봉 사
손상하다	손 상 하 다
可及的	可 及 的
어법	어 법
間食	間 食
남기다	남 기 다
보임틀	보 임 틀
안가	안 가
고어	고 어
자본가	자 본 가
초밥	초 밥
-수다	- 수 다
허벅지	허 벅 지
짊다	짊 다
誤打	誤 打
경칭	경 칭
오라버이	오 라 버 이
순교	순 교
상속인	상 속 인
꿈적	꿈 적
왼쪽	왼 쪽
씽글씽글	씽 글 씽 글
窒化	窒 化
泌尿器科	泌 尿 器 科
고약하다	고 약 하 다
이엉	이 엉
논의	논 의
콱	콱
의식주	의 식 주
존예	존 예
私益	私 益
미역감다	미 역 감 다
𣴘	𣴘
자괴감	자 괴 감
칼날	칼 날
아리조나	아 리 조 나
관현악단	관 현 악 단
자손	자 손
귀주	귀 주
우울하다	우 울 하 다
싸리	싸 리
읎다	읎 다
로망	로 망
족발	족 발
드럼	드 럼
복받치다	복 받 치 다
굽이굽이	굽 이 굽 이
개명되다	개 명 되 다
아니하다	아 니 하 다
사모뿔	사 모 뿔
可視光線	可 視 光 線
무함마드	무 함 마 드
비기다	비 기 다
한물	한 물
레즈비언	레 즈 비 언
해고하다	해 고 하 다
赤線	赤 線
프랑	프 랑
폭도	폭 도
쓸데없다	쓸 데 없 다
고래	고 래
언저리	언 저 리
심성	심 성
게이다	게 이 다
문신	문 신
派閥	派 閥
뜻밖에	뜻 밖 에
음양가	음 양 가
황오리	황 오 리
천정	천 정
동국	동 국
소각하다	소 각 하 다
쥐창시	쥐 창 시
보필	보 필
덴뿌라	덴 뿌 라
크라상	크 라 상
당기다	당 기 다
무탈	무 탈
까자	까 자
문턱	문 턱
半齒音	半 齒 音
잡히다	잡 히 다
수말	수 말
연구원	연 구 원
잡담하다	잡 담 하 다
희귀하다	희 귀 하 다
피격	피 격
어디메	어 디 메
규소수지	규 소 수 지
꽹과리	꽹 과 리
홈	홈
회비	회 비
무차별	무 차 별
음렬	음 렬
자주복	자 주 복
멀다	멀 다
연가	연 가
척량	척 량
젤리	젤 리
摩尼敎	摩 尼 敎
적법하다	적 법 하 다
사하라	사 하 라
쩔어	쩔 어
바두쯔	바 두 쯔
고순쥐	고 순 쥐
혁명가극	혁 명 가 극
치안	치 안
샐러리	샐 러 리
만우절	만 우 절
古代國語	古 代 國 語
내강	내 강
도토리묵	도 토 리 묵
기도서	기 도 서
선구	선 구
참신하다	참 신 하 다
회의하다	회 의 하 다
명분	명 분
다치다	다 치 다
반구	반 구
나성	나 성
무진장	무 진 장
대여섯	대 여 섯
된디읃	된 디 읃
왕실	왕 실
깜짝깜짝	깜 짝 깜 짝
남체	남 체
원망하다	원 망 하 다
로메	로 메
은방울꽃	은 방 울 꽃
투자	투 자
우럭볼락	우 럭 볼 락
밀접하다	밀 접 하 다
運轉免許證	運 轉 免 許 證
그루터기	그 루 터 기
자구다복	자 구 다 복
친애	친 애
탈북	탈 북
-매	- 매
울음소리	울 음 소 리
사르르	사 르 르
호흡계통	호 흡 계 통
패자	패 자
홍길동	홍 길 동
안전하다	안 전 하 다
경낭	경 낭
천체	천 체
광대뼈	광 대 뼈
무사하다	무 사 하 다
마리아주	마 리 아 주
사육제	사 육 제
큰흰죽지	큰 흰 죽 지
남방동사리	남 방 동 사 리
흥정	흥 정
볏짚	볏 짚
飜譯家	飜 譯 家
평민	평 민
알아보다	알 아 보 다
공중전화	공 중 전 화
명창	명 창
西歐圈	西 歐 圈
례절	례 절
훼방하다	훼 방 하 다
橵	橵
숙제하다	숙 제 하 다
피처폰	피 처 폰
海月	海 月
구원	구 원
낙농업	낙 농 업
아름답다	아 름 답 다
모범	모 범
衢街	衢 街
목탄	목 탄
한담하다	한 담 하 다
땀띠약	땀 띠 약
티라나	티 라 나
차질	차 질
깃대	깃 대
고맙다	고 맙 다
세습무	세 습 무
홀소리	홀 소 리
회음	회 음
이웆	이 웆
궐련	궐 련
중성	중 성
호전적	호 전 적
만들어지다	만 들 어 지 다
음침하다	음 침 하 다
투자되다	투 자 되 다
개망초	개 망 초
성구	성 구
여쭈다	여 쭈 다
왈츠	왈 츠
㤀	㤀
붉은목지빠귀	붉 은 목 지 빠 귀
통구	통 구
새롭다	새 롭 다
까치발	까 치 발
어휘장	어 휘 장
오얏	오 얏
원두	원 두
-는-	- 는 -
鑄型	鑄 型
슈퍼모델	슈 퍼 모 델
출납계	출 납 계
유화정책	유 화 정 책
聲讀	聲 讀
걸인	걸 인
중추절	중 추 절
일나다	일 나 다
바늘겨레	바 늘 겨 레
곤운	곤 운
욕하다	욕 하 다
갱구	갱 구
거스르다	거 스 르 다
연월일	연 월 일
자업자득	자 업 자 득
애교살	애 교 살
살피	살 피
시신경	시 신 경
전야제	전 야 제
반지성주의	반 지 성 주 의
대충	대 충
-덜	- 덜
두발	두 발
탱탱	탱 탱
대망	대 망
救恤	救 恤
양질	양 질
바꾸다	바 꾸 다
기냥	기 냥
地形學	地 形 學
만유	만 유
다도	다 도
죽순	죽 순
텔레비	텔 레 비
表語文字	表 語 文 字
바다제비	바 다 제 비
횡파	횡 파
가봉	가 봉
만족하다	만 족 하 다
가체	가 체
가시부리새	가 시 부 리 새
공증인	공 증 인
성운	성 운
검은해오라기	검 은 해 오 라 기
꼼꼼하다	꼼 꼼 하 다
으쌰	으 쌰
남자답다	남 자 답 다
산동	산 동
곧은창자	곧 은 창 자
발전도상국	발 전 도 상 국
여와	여 와
햇발	햇 발
곱하다	곱 하 다
복종	복 종
닭알	닭 알
까타르	까 타 르
정구	정 구
우란	우 란
기필코	기 필 코
영도자	영 도 자
구입하다	구 입 하 다
긴부리참돌고래	긴 부 리 참 돌 고 래
약하다	약 하 다
䭏	䭏
나누이다	나 누 이 다
안기다	안 기 다
우마	우 마
입학하다	입 학 하 다
-붙이	- 붙 이
㐂	㐂
진지하다	진 지 하 다
유카타	유 카 타
점몰개	점 몰 개
여기저기	여 기 저 기
배신하다	배 신 하 다
착지	착 지
애드웨어	애 드 웨 어
애너그램	애 너 그 램
낭송되다	낭 송 되 다
야레	야 레
귀리	귀 리
허벌나다	허 벌 나 다
장뇌	장 뇌
-ㄴ께	- ㄴ 께
도둑	도 둑
反騰	反 騰
신음	신 음
나프탈렌	나 프 탈 렌
인수	인 수
供給者	供 給 者
해설자	해 설 자
거래	거 래
문혁	문 혁
삭제하다	삭 제 하 다
가책되다	가 책 되 다
네바다	네 바 다
충전하다	충 전 하 다
안개꽃	안 개 꽃
도륙하다	도 륙 하 다
따뜻하다	따 뜻 하 다
끔적끔적	끔 적 끔 적
숲	숲
사립문	사 립 문
특급시	특 급 시
무모하다	무 모 하 다
피크닉	피 크 닉
全速前進	全 速 前 進
악대	악 대
전생	전 생
공안	공 안
꿈틀	꿈 틀
아끼다	아 끼 다
관광하다	관 광 하 다
비다	비 다
물뿌리개	물 뿌 리 개
해달	해 달
수탉	수 탉
몰도바	몰 도 바
아쉬움	아 쉬 움
불라	불 라
인나다	인 나 다
신시사이저	신 시 사 이 저
근삿값	근 삿 값
비파나무	비 파 나 무
하강	하 강
달마	달 마
단백	단 백
모으다	모 으 다
검색하다	검 색 하 다
닦다	닦 다
-와	- 와
진급	진 급
뉴질랜드	뉴 질 랜 드
빈약	빈 약
눈썹	눈 썹
석랍	석 랍
왼손잡이	왼 손 잡 이
푸르디푸르다	푸 르 디 푸 르 다
눼	눼
璹	璹
로케트	로 케 트
팽	팽
연세대	연 세 대
쾅	쾅
앵커리지	앵 커 리 지
민부리고래	민 부 리 고 래
국비	국 비
파래	파 래
자기소개서	자 기 소 개 서
포그롬	포 그 롬
검출하다	검 출 하 다
속성	속 성
개구장이	개 구 장 이
큰재개구마리	큰 재 개 구 마 리
피다	피 다
접종하다	접 종 하 다
달밤	달 밤
버들가지	버 들 가 지
아메바	아 메 바
ㄾ	ㄾ
捿	捿
수식어	수 식 어
계속되다	계 속 되 다
ㅒ	ㅒ
탈춤	탈 춤
거칠다	거 칠 다
海溢警報	海 溢 警 報
경기관	경 기 관
計器板	計 器 板
西紀	西 紀
굴착기	굴 착 기
보닛	보 닛
고냉이	고 냉 이
소멸하다	소 멸 하 다
적량	적 량
生覺	生 覺
견성하다	견 성 하 다
갈토	갈 토
흰머리솔개	흰 머 리 솔 개
연결하다	연 결 하 다
반포	반 포
석영	석 영
희붐하다	희 붐 하 다
흔적	흔 적
국밥	국 밥
디귿	디 귿
旽	旽
자뻑	자 뻑
누선	누 선
학	학
곰지락곰지락	곰 지 락 곰 지 락
놀이기구	놀 이 기 구
밴드	밴 드
댐	댐
龍台	龍 台
칼리파	칼 리 파
학생복	학 생 복
천적	천 적
아전인수	아 전 인 수
싸인펜	싸 인 펜
靑信號	靑 信 號
마드리드	마 드 리 드
미국나팔꽃	미 국 나 팔 꽃
꽃봉오리	꽃 봉 오 리
무선전화	무 선 전 화
領收證	領 收 證
승진되다	승 진 되 다
십사	십 사
말하다	말 하 다
피페리딘	피 페 리 딘
거스러미	거 스 러 미
팟타이	팟 타 이
胊	胊
기울이다	기 울 이 다
팔목시계	팔 목 시 계
사이시옷	사 이 시 옷
불편	불 편
키릴	키 릴
기주떡	기 주 떡
배척	배 척
大日	大 日
솔직하다	솔 직 하 다
린스	린 스
料理師	料 理 師
크림반도	크 림 반 도
왕녀	왕 녀
녹이다	녹 이 다
연출	연 출
생키다	생 키 다
숙이다	숙 이 다
어순	어 순
유자	유 자
巭	巭
화해	화 해
오곡밥	오 곡 밥
두루마리	두 루 마 리
제습기	제 습 기
새방자	새 방 자
-아야겠-	- 아 야 겠 -
비비다	비 비 다
老眼	老 眼
민간	민 간
옻나무	옻 나 무
새벽녘	새 벽 녘
마두금	마 두 금
천연두	천 연 두
요방형근	요 방 형 근
높임말	높 임 말
짜다	짜 다
냉동고	냉 동 고
큰회색머리아비	큰 회 색 머 리 아 비
運動靴	運 動 靴
솜털	솜 털
우리다	우 리 다
미시사가	미 시 사 가
널쭈다	널 쭈 다
교미하다	교 미 하 다
임기	임 기
단고기탕	단 고 기 탕
묵고	묵 고
비치발리볼	비 치 발 리 볼
강의하다	강 의 하 다
섀르밴대	섀 르 밴 대
은제	은 제
冊床	冊 床
이서	이 서
조개나물	조 개 나 물
랭	랭
손가락질	손 가 락 질
나무껍질	나 무 껍 질
動悸	動 悸
프로파길	프 로 파 길
-이라도	- 이 라 도
의논하다	의 논 하 다
소박하다	소 박 하 다
길강아지	길 강 아 지
서라벌	서 라 벌
째깍	째 깍
지명학	지 명 학
깃털	깃 털
박해자	박 해 자
향고래	향 고 래
저녁놀	저 녁 놀
사진기	사 진 기
차주	차 주
얼차려	얼 차 려
경축	경 축
개발하다	개 발 하 다
通念	通 念
타원	타 원
설산	설 산
대북	대 북
銃口	銃 口
及其也	及 其 也
렬차	렬 차
마당너구리	마 당 너 구 리
송곳	송 곳
답장하다	답 장 하 다
안드로이드	안 드 로 이 드
중국대륙	중 국 대 륙
본드	본 드
그을음	그 을 음
와이셔츠	와 이 셔 츠
새내기	새 내 기
不敢請固所願	不 敢 請 固 所 願
贊反	贊 反
가새	가 새
하녀	하 녀
영춘권	영 춘 권
건더기	건 더 기
하이킹	하 이 킹
발매하다	발 매 하 다
꺽지	꺽 지
오십	오 십
硏究院	硏 究 院
-짜리	- 짜 리
희생양	희 생 양
발등	발 등
모피	모 피
승인하다	승 인 하 다
ꥸ	ꥸ
관청	관 청
맘마통	맘 마 통
勞組	勞 組
하락시	하 락 시
우야다	우 야 다
봉기	봉 기
궁핍	궁 핍
무끼	무 끼
부덕의	부 덕 의
심리학자	심 리 학 자
온주	온 주
이사악	이 사 악
정확히	정 확 히
지다	지 다
半地下	半 地 下
아홉째	아 홉 째
정직	정 직
빛내다	빛 내 다
머리카락	머 리 카 락
흰이마기러기	흰 이 마 기 러 기
멀쩡하다	멀 쩡 하 다
악령	악 령
예식	예 식
나프타	나 프 타
뿌석뿌석	뿌 석 뿌 석
대결	대 결
몽고점	몽 고 점
천구	천 구
공통	공 통
국제어	국 제 어
풀잎	풀 잎
사탕수수	사 탕 수 수
기후학	기 후 학
구더기	구 더 기
흉내내다	흉 내 내 다
샛바람	샛 바 람
곱다랗다	곱 다 랗 다
세면	세 면
구월	구 월
그분	그 분
유쾌	유 쾌
-데	- 데
惡天候	惡 天 候
방출	방 출
뭔	뭔
친절하다	친 절 하 다
황사	황 사
葡萄狀球菌	葡 萄 狀 球 菌
추출물	추 출 물
차고	차 고
가까이하다	가 까 이 하 다
퀘벡	퀘 벡
좀수수치	좀 수 수 치
비약하다	비 약 하 다
거문고	거 문 고
카르빌아민	카 르 빌 아 민
백의민족	백 의 민 족
오곡	오 곡
甅	甅
똥파리	똥 파 리
심상	심 상
공리주의	공 리 주 의
상사	상 사
해군	해 군
경각	경 각
참말로	참 말 로
주소	주 소
-을래	- 을 래
영락	영 락
鑄型油	鑄 型 油
마그네슘	마 그 네 슘
콤포트	콤 포 트
충청북도	충 청 북 도
마케도니아어	마 케 도 니 아 어
회오	회 오
㲩	㲩
꿀밤	꿀 밤
크산텐	크 산 텐
훈독	훈 독
불철주야	불 철 주 야
조로아스터	조 로 아 스 터
D-	D -
폐백	폐 백
옥새	옥 새
금욕	금 욕
명명법	명 명 법
地境	地 境
바스스카프	바 스 스 카 프
대가	대 가
문해	문 해
멕이다	멕 이 다
아리	아 리
봉착하다	봉 착 하 다
꽈리	꽈 리
몽치다래	몽 치 다 래
사우스캐롤라이나	사 우 스 캐 롤 라 이 나
광장	광 장
미신	미 신
땔나무	땔 나 무
앰뷸런스	앰 뷸 런 스
영양물	영 양 물
처지다	처 지 다
일흔	일 흔
분단	분 단
독점	독 점
뒤늦다	뒤 늦 다
제시	제 시
클락션	클 락 션
작은관코박쥐	작 은 관 코 박 쥐
료리	료 리
설문지	설 문 지
치우다	치 우 다
교차위	교 차 위
부아	부 아
기소하다	기 소 하 다
덧머리	덧 머 리
팔딱	팔 딱
㵛	㵛
반공	반 공
졸음	졸 음
들꿩	들 꿩
월동	월 동
샌들	샌 들
잡언	잡 언
피하	피 하
뒤꿈치	뒤 꿈 치
먹기	먹 기
꽃게	꽃 게
내각	내 각
방향	방 향
자장노래	자 장 노 래
밤낮없이	밤 낮 없 이
우화	우 화
끈기	끈 기
삼색	삼 색
표음	표 음
기억되다	기 억 되 다
알버타	알 버 타
국가사회주의	국 가 사 회 주 의
淡白	淡 白
수선	수 선
재현하다	재 현 하 다
되살리다	되 살 리 다
서사하라	서 사 하 라
강도다리	강 도 다 리
자낳괴	자 낳 괴
色眼鏡	色 眼 鏡
자랑	자 랑
토이기	토 이 기
접두사	접 두 사
열반	열 반
삼한	삼 한
삐딱하다	삐 딱 하 다
깍두기	깍 두 기
워라밸	워 라 밸
庭球	庭 球
改題	改 題
용광로	용 광 로
제압하다	제 압 하 다
삼수	삼 수
제비	제 비
南氷洋	南 氷 洋
亞鉛鐵	亞 鉛 鐵
귀엽다	귀 엽 다
吉夢	吉 夢
치타	치 타
링	링
連絡船	連 絡 船
하객	하 객
서까래	서 까 래
얹다	얹 다
촉지	촉 지
존엄	존 엄
시리다	시 리 다
골격	골 격
형편	형 편
-을	- 을
水泳場	水 泳 場
안목	안 목
대퇴	대 퇴
삶다	삶 다
배반하다	배 반 하 다
수진본	수 진 본
널다	널 다
천도	천 도
방대하다	방 대 하 다
경쟁자	경 쟁 자
可하다	可 하 다
벽시계	벽 시 계
소제부	소 제 부
붉은가슴흰죽지	붉 은 가 슴 흰 죽 지
근접하다	근 접 하 다
朝鮮封建王朝	朝 鮮 封 建 王 朝
인심	인 심
총구	총 구
긴꼬리윗수염박쥐	긴 꼬 리 윗 수 염 박 쥐
㴹	㴹
물텀벙이	물 텀 벙 이
㸴	㸴
총알받이	총 알 받 이
장요근	장 요 근
인적	인 적
탈영	탈 영
대체유	대 체 유
추구하다	추 구 하 다
가차	가 차
긴꼬리꼬마쥐	긴 꼬 리 꼬 마 쥐
로천	로 천
요의	요 의
규제하다	규 제 하 다
광동어	광 동 어
바슬바슬	바 슬 바 슬
포트오브스페인	포 트 오 브 스 페 인
뺄셈	뺄 셈
새집	새 집
기치	기 치
미주리	미 주 리
원석	원 석
동맹하다	동 맹 하 다
녹유	녹 유
변절하다	변 절 하 다
군체	군 체
건발기	건 발 기
마마보이	마 마 보 이
원반	원 반
케이크	케 이 크
쏼라쏼라	쏼 라 쏼 라
안티모니	안 티 모 니
심부름	심 부 름
公式的	公 式 的
역겹다	역 겹 다
세뱃돈	세 뱃 돈
우라누스	우 라 누 스
판관기	판 관 기
군항	군 항
중대하다	중 대 하 다
화지	화 지
전자오락	전 자 오 락
잠간	잠 간
씨뚜아찌야	씨 뚜 아 찌 야
츄잉껌	츄 잉 껌
추다	추 다
운명	운 명
반동분자	반 동 분 자
립법	립 법
보디가드	보 디 가 드
짐작하다	짐 작 하 다
맥	맥
초래하다	초 래 하 다
瑥	瑥
㢇	㢇
볼리비아	볼 리 비 아
체크어	체 크 어
삼신	삼 신
장타율	장 타 율
따님	따 님
기녀	기 녀
몽어	몽 어
더럼	더 럼
이중모음	이 중 모 음
구취	구 취
외우다	외 우 다
간밤	간 밤
위구르어	위 구 르 어
始作	始 作
벗방	벗 방
수다떨다	수 다 떨 다
송쿠	송 쿠
혹여나	혹 여 나
볼셰비키	볼 셰 비 키
등산하다	등 산 하 다
브라더	브 라 더
트란스니스트리아	트 란 스 니 스 트 리 아
편육	편 육
罦	罦
㐇	㐇
강하다	강 하 다
란타넘	란 타 넘
싱어송라이터	싱 어 송 라 이 터
玄米	玄 米
란	란
그대로	그 대 로
왼통	왼 통
짧다	짧 다
점성학	점 성 학
생애	생 애
패전	패 전
엿보다	엿 보 다
問題視	問 題 視
떫디떫다	떫 디 떫 다
미생물학	미 생 물 학
빗	빗
멕시코시티	멕 시 코 시 티
타격수	타 격 수
진랍	진 랍
子宮內裝置	子 宮 內 裝 置
공리	공 리
할아씨	할 아 씨
섭취하다	섭 취 하 다
학습하다	학 습 하 다
노가다	노 가 다
제화	제 화
강간	강 간
鬼接	鬼 接
그루빠	그 루 빠
답안	답 안
각시	각 시
석탄산	석 탄 산
윗다	윗 다
異敎	異 敎
줄곧	줄 곧
선지	선 지
적재	적 재
청탁	청 탁
풋볼	풋 볼
카드뮴	카 드 뮴
자카르타	자 카 르 타
윷	윷
지진학	지 진 학
십일월	십 일 월
잿방어	잿 방 어
-랑	- 랑
유사	유 사
화차	화 차
사본	사 본
다각형	다 각 형
杋	杋
詞華	詞 華
예복	예 복
무용하다	무 용 하 다
숭어	숭 어
萬若	萬 若
요리하다	요 리 하 다
다재	다 재
단디	단 디
관박쥐	관 박 쥐
가산	가 산
霔	霔
피오르	피 오 르
공예품	공 예 품
멍에	멍 에
십오	십 오
-다니	- 다 니
폭정	폭 정
굴	굴
거진	거 진
린우드	린 우 드
써레	써 레
놀아나다	놀 아 나 다
브리텐	브 리 텐
깜박깜박	깜 박 깜 박
뒹굴다	뒹 굴 다
敎皇	敎 皇
편집기	편 집 기
학상	학 상
만장일치	만 장 일 치
틀다	틀 다
씨름	씨 름
대륙검은지빠귀	대 륙 검 은 지 빠 귀
㘘	㘘
海兵	海 兵
비김	비 김
부조리	부 조 리
중하다	중 하 다
병기	병 기
점대칭	점 대 칭
할많하않	할 많 하 않
위생실	위 생 실
세계평화	세 계 평 화
査察	査 察
토란	토 란
靑色	靑 色
고생하다	고 생 하 다
볏섬	볏 섬
시경	시 경
화상	화 상
보잘것없다	보 잘 것 없 다
거절하다	거 절 하 다
개인숭배	개 인 숭 배
노병	노 병
벼락	벼 락
키위	키 위
諮問	諮 問
진찰하다	진 찰 하 다
감탕나무	감 탕 나 무
기하학	기 하 학
배가사리	배 가 사 리
앵무	앵 무
승산	승 산
즉일	즉 일
무의미하다	무 의 미 하 다
응집력	응 집 력
음모론	음 모 론
이따	이 따
얽매다	얽 매 다
긴업	긴 업
키르기스스탄	키 르 기 스 스 탄
入國	入 國
옳바르다	옳 바 르 다
廣東語	廣 東 語
훈고학	훈 고 학
심마니	심 마 니
삼다	삼 다
피라졸	피 라 졸
보배	보 배
카우치	카 우 치
후연	후 연
경멸적	경 멸 적
監査	監 査
말라빠지다	말 라 빠 지 다
만유인력	만 유 인 력
과물	과 물
독어	독 어
땡볕	땡 볕
덕후	덕 후
학생소년궁전	학 생 소 년 궁 전
헷갈리다	헷 갈 리 다
붉은사슴	붉 은 사 슴
경악	경 악
퀴나졸린	퀴 나 졸 린
물어떼다	물 어 떼 다
미지수	미 지 수
여과기	여 과 기
자유분방	자 유 분 방
동맹국	동 맹 국
빙퇴석	빙 퇴 석
社會的	社 會 的
공공	공 공
옛한글	옛 한 글
사울	사 울
홀씨	홀 씨
백합	백 합
크레용	크 레 용
서인	서 인
㣹	㣹
알타이	알 타 이
䢘	䢘
단락	단 락
온대	온 대
걱정스럽다	걱 정 스 럽 다
뵈다	뵈 다
고지리학	고 지 리 학
해석하다	해 석 하 다
스웨덴어	스 웨 덴 어
행방	행 방
허수	허 수
북동	북 동
평의회	평 의 회
연말	연 말
하냥	하 냥
自業自得	自 業 自 得
강풍	강 풍
축제일	축 제 일
諪	諪
명제	명 제
환율	환 율
목마름	목 마 름
번영하다	번 영 하 다
왤케	왤 케
구찮다	구 찮 다
巬	巬
뺑뺑이	뺑 뺑 이
赴戰嶺	赴 戰 嶺
구씨-흐루스딸리니	구 씨 - 흐 루 스 딸 리 니
母音調和	母 音 調 和
근질근질하다	근 질 근 질 하 다
주판	주 판
빤쯔	빤 쯔
유스호스텔	유 스 호 스 텔
날짜	날 짜
감색	감 색
어불성설	어 불 성 설
활시위	활 시 위
부서지다	부 서 지 다
남행	남 행
진동수	진 동 수
탐지기	탐 지 기
뿔종다리	뿔 종 다 리
속옷	속 옷
카게베	카 게 베
찬넬동자개	찬 넬 동 자 개
포옹하다	포 옹 하 다
삼족	삼 족
똥꼬	똥 꼬
형성	형 성
전업	전 업
지하도	지 하 도
수원	수 원
두만강	두 만 강
낚시하다	낚 시 하 다
문화주택	문 화 주 택
일신론	일 신 론
베네딕토	베 네 딕 토
늪살무사	늪 살 무 사
입쌀	입 쌀
고산병	고 산 병
려행	려 행
마귀	마 귀
가다붙다	가 다 붙 다
외로	외 로
매릴랜드	매 릴 랜 드
수음하다	수 음 하 다
발가락	발 가 락
도우미	도 우 미
폴리네시아	폴 리 네 시 아
휴가	휴 가
퐁당퐁당	퐁 당 퐁 당
주시하다	주 시 하 다
杜絶	杜 絶
육십	육 십
희곡집	희 곡 집
부뚜막	부 뚜 막
사화산	사 화 산
平和主義	平 和 主 義
휘파람	휘 파 람
담요	담 요
발트해	발 트 해
니호늄	니 호 늄
들쭉날쭉하다	들 쭉 날 쭉 하 다
보어	보 어
비스켓	비 스 켓
-꺼정	- 꺼 정
미뢰	미 뢰
실망시키다	실 망 시 키 다
반항	반 항
業所	業 所
노리다	노 리 다
델라웨어	델 라 웨 어
두절	두 절
편하다	편 하 다
붉은부리갈매기	붉 은 부 리 갈 매 기
뱀머리돌고래	뱀 머 리 돌 고 래
버거	버 거
陰數	陰 數
眞짜	眞 짜
따르다	따 르 다
용접하다	용 접 하 다
속성음식	속 성 음 식
날갯죽지	날 갯 죽 지
나마리	나 마 리
거룩하다	거 룩 하 다
나룻배	나 룻 배
악마	악 마
-처럼	- 처 럼
마마	마 마
굼적	굼 적
혹성	혹 성
쓸개즙	쓸 개 즙
輪廻	輪 廻
약혼자	약 혼 자
착륙하다	착 륙 하 다
쓸쓸하다	쓸 쓸 하 다
-댔-	- 댔 -
줘	줘
나침반	나 침 반
팔극권	팔 극 권
짼지	짼 지
뇨소	뇨 소
-으이	- 으 이
타피르	타 피 르
추워지다	추 워 지 다
일터	일 터
허파	허 파
청취자	청 취 자
김정일화	김 정 일 화
最長	最 長
기판	기 판
-음직	- 음 직
-에다가	- 에 다 가
굴욕감	굴 욕 감
살찌우다	살 찌 우 다
전자메일	전 자 메 일
취리히	취 리 히
확증편향	확 증 편 향
몸가짐	몸 가 짐
목적론	목 적 론
恐喝	恐 喝
행인	행 인
똥차	똥 차
협	협
대역죄	대 역 죄
기억하다	기 억 하 다
해장	해 장
일리	일 리
능동태	능 동 태
애원하다	애 원 하 다
사장	사 장
불륜하다	불 륜 하 다
끝말	끝 말
길다	길 다
생사람	생 사 람
不淨腐敗	不 淨 腐 敗
쿨럭	쿨 럭
-ㅂ	- ㅂ
금수	금 수
폴다	폴 다
무시하다	무 시 하 다
체육	체 육
햄스터	햄 스 터
개땡깔	개 땡 깔
마름모	마 름 모
며	며
진행하다	진 행 하 다
원기둥	원 기 둥
잡수다	잡 수 다
異性愛者	異 性 愛 者
감수하다	감 수 하 다
전율하다	전 율 하 다
분식류	분 식 류
부	부
땀	땀
실적	실 적
콘센트	콘 센 트
두루미	두 루 미
비	비
푹	푹
살	살
남녀	남 녀
전남	전 남
폴이	폴 이
잉여	잉 여
기부	기 부
하노이	하 노 이
공정거래	공 정 거 래
스스로	스 스 로
피지	피 지
억	억
연결	연 결
조작	조 작
유월	유 월
토르	토 르
먼지	먼 지
질타	질 타
조식	조 식
자해	자 해
살	살
돈	돈
빌딩	빌 딩
통계	통 계
빨리	빨 리
악	악
라운딩	라 운 딩
분석	분 석
코로나바이러스	코 로 나 바 이 러 스
우주비행사	우 주 비 행 사
불륜	불 륜
전문가	전 문 가
참고	참 고
분	분
탭	탭
모터	모 터
카페	카 페
제출	제 출
영혼	영 혼
장사	장 사
게이트	게 이 트
에어컨	에 어 컨
충남	충 남
차	차
단편영화	단 편 영 화
카페	카 페
비교적	비 교 적
처리	처 리
품질	품 질
외면	외 면
판타지	판 타 지
화성	화 성
의의	의 의
마스크	마 스 크
이전	이 전
탈	탈
수수께끼	수 수 께 끼
기록	기 록
케이블	케 이 블
예언자	예 언 자
필수	필 수
변한	변 한
가식	가 식
이달	이 달
성장	성 장
최고	최 고
고백	고 백
반면	반 면
기록	기 록
차	차
십이지장	십 이 지 장
장관	장 관
계열	계 열
숙소	숙 소
전기	전 기
초보자	초 보 자
위	위
눈길	눈 길
고민	고 민
소개	소 개
나비	나 비
십자가	십 자 가
기도	기 도
트위터	트 위 터
새삼	새 삼
경기	경 기
세계화	세 계 화
시스템	시 스 템
스페인어	스 페 인 어
은퇴	은 퇴
삼국지	삼 국 지
백업	백 업
너무나	너 무 나
기록	기 록
청소년	청 소 년
보드카	보 드 카
조작	조 작
부여	부 여
관심	관 심
산소	산 소
조금	조 금
폭탄	폭 탄
확률	확 률
부상	부 상
핵심	핵 심
개통	개 통
처리	처 리
달리	달 리
혹은	혹 은
오히려	오 히 려
숙박	숙 박
진출	진 출
모델	모 델
더불어	더 불 어
별도	별 도
변동	변 동
구입처	구 입 처
바이러스	바 이 러 스
비난	비 난
의상	의 상
레오	레 오
숙박	숙 박
사이즈	사 이 즈
스카프	스 카 프
아시아	아 시 아
하기	하 기
은수저	은 수 저
사쿠라	사 쿠 라
일단	일 단
디자인	디 자 인
도	도
구미	구 미
저가	저 가
조심	조 심
없다	없 다
지구	지 구
경기도	경 기 도
도움	도 움
회담	회 담
그렇지	그 렇 지
떼	떼
이란	이 란
주지	주 지
미	미
레오	레 오
아동	아 동
사례	사 례
셋째	셋 째
자메이카	자 메 이 카
주위	주 위
직경	직 경
돈	돈
족집게	족 집 게
스코어보드	스 코 어 보 드
경기	경 기
비건	비 건
가슴	가 슴
사회적	사 회 적
혹은	혹 은
달리	달 리
떨다	떨 다
특정	특 정
반면	반 면
플라스틱	플 라 스 틱
누가	누 가
논문집	논 문 집
하락하다	하 락 하 다
지명	지 명
하기	하 기
태그	태 그
수명	수 명
영광	영 광
접속	접 속
특정	특 정
경기	경 기
상자	상 자
보행	보 행
때때로	때 때 로
한마디	한 마 디
오히려	오 히 려
포켓	포 켓
경기도	경 기 도
베이징	베 이 징
요즘	요 즘
금	금
경기	경 기
팔자	팔 자
뭘	뭘
종	종
사료	사 료
아무	아 무
강세	강 세
동굴	동 굴
삼성	삼 성
인건비	인 건 비
해방	해 방
강원도	강 원 도
램	램
손잡이	손 잡 이
어제	어 제
겸	겸
구글	구 글
태그	태 그
조치	조 치
백두산	백 두 산
청소년	청 소 년
앰프	앰 프
스와질란드	스 와 질 란 드
실적	실 적
모델	모 델
브러시	브 러 시
타	타
덜	덜
반면	반 면
아까	아 까
오히려	오 히 려
일상생활	일 상 생 활
분석	분 석
대단히	대 단 히
애비	애 비
산업	산 업
고급	고 급
진짜	진 짜
목이	목 이
납품	납 품
정기	정 기
해요	해 요
기꺼이	기 꺼 이
여전히	여 전 히
스스로	스 스 로
불법	불 법
확률	확 률
주지	주 지
판타지	판 타 지
시대	시 대
진짜	진 짜
백	백
위안부	위 안 부
휴대폰	휴 대 폰
이주	이 주
변호사	변 호 사
들	들
회사	회 사
마지막	마 지 막
보호	보 호
의료	의 료
특정	특 정
상담	상 담
양말	양 말
질문	질 문
함부로	함 부 로
휴대폰	휴 대 폰
아시아	아 시 아
전차	전 차
수평	수 평
기아	기 아
조금	조 금
핵심	핵 심
여기	여 기
마지막	마 지 막
개수	개 수
야근	야 근
얌차	얌 차
깜짝	깜 짝
충남	충 남
반주	반 주
유서	유 서
카페	카 페
캠프	캠 프
필명	필 명
방금	방 금
방법론	방 법 론
매출	매 출
감리교	감 리 교
페이지	페 이 지
시스템	시 스 템
폰	폰
매	매
여기	여 기
방역	방 역
아까	아 까
아시아	아 시 아
달	달
품질	품 질
안과	안 과
솔로	솔 로
법사	법 사
도착	도 착
금	금
시스템	시 스 템
괴	괴
진출	진 출
금번	금 번
한글	한 글
하노이	하 노 이
티켓	티 켓
실적	실 적
넷째	넷 째
혁신	혁 신
타	타
버전	버 전
개국	개 국
분대	분 대
속편	속 편
하기	하 기
고양이	고 양 이
배지	배 지
도	도
종합	종 합
변호사	변 호 사
유	유
파라다이스	파 라 다 이 스
셋째	셋 째
마지막	마 지 막
지성	지 성
정찰	정 찰
분간	분 간
치료	치 료
진짜	진 짜
공지	공 지
캐릭터	캐 릭 터
다이어트	다 이 어 트
밥상	밥 상
스포츠	스 포 츠
굳이	굳 이
그리스	그 리 스
수출	수 출
구글	구 글
케이블	케 이 블
수출	수 출
습득	습 득
공동	공 동
간호	간 호
때때로	때 때 로
히	히
더불어	더 불 어
혹은	혹 은
전망	전 망
공격	공 격
진짜	진 짜
삼성	삼 성
최고	최 고
통계	통 계
스스로	스 스 로
여전히	여 전 히
의의	의 의
잡화	잡 화
기꺼이	기 꺼 이
디자인	디 자 인
비핵화	비 핵 화
재상	재 상
충전기	충 전 기
마지막	마 지 막
웃음	웃 음
여전히	여 전 히
성공	성 공
페이지	페 이 지
들	들
프린스턴	프 린 스 턴
연극	연 극
설계	설 계
주지	주 지
시대	시 대
스포츠	스 포 츠
분석	분 석
노선	노 선
달리	달 리
삼성	삼 성
원주	원 주
품질	품 질
저가	저 가
생존	생 존
파라다이스	파 라 다 이 스
처리	처 리
경기도	경 기 도
실존주의	실 존 주 의
스스로	스 스 로
없다	없 다
충남	충 남
다루다	다 루 다
불교	불 교
순	순
그릇	그 릇
건축	건 축
수십	수 십
썰	썰
시스템	시 스 템
목사	목 사
아파트	아 파 트
참고	참 고
여기	여 기
조치	조 치
성장	성 장
아궁이	아 궁 이
평소	평 소
페이지	페 이 지
수평	수 평
객체	객 체
넷째	넷 째
동원	동 원
이전	이 전
사례	사 례
분석	분 석
연극	연 극
라인	라 인
각기	각 기
연속	연 속
모차렐라	모 차 렐 라
간혹	간 혹
라인	라 인
뭘	뭘
썰	썰
임금	임 금
조금	조 금
제휴	제 휴
고급	고 급
분	분
사고	사 고
가득	가 득
윤리학	윤 리 학
아파트	아 파 트
소개	소 개
강수량	강 수 량
진짜	진 짜
간단	간 단
탭	탭
변호사	변 호 사
조금	조 금
케이블	케 이 블
달	달
생방송	생 방 송
발급	발 급
처리	처 리
비핵화	비 핵 화
핵	핵
탑승	탑 승
삽화	삽 화
우표	우 표
신용	신 용
본명	본 명
섭	섭
경기	경 기
풍속	풍 속
어플	어 플
청소년	청 소 년
백악기	백 악 기
진출	진 출
난민	난 민
카페	카 페
더불어	더 불 어
여기	여 기
첫째	첫 째
서도	서 도
비	비
조금	조 금
이전	이 전
정상	정 상
비건	비 건
목	목
도난	도 난
미로	미 로
사이즈	사 이 즈
ㅎㅎ	ㅎ ㅎ
겨우	겨 우
예술가	예 술 가
오해	오 해
비	비
나라	나 라
장사	장 사
환경	환 경
신학	신 학
서자	서 자
참고	참 고
드라마	드 라 마
회사	회 사
없다	없 다
그만	그 만
남녀	남 녀
동생	동 생
반면	반 면
조폭	조 폭
공지	공 지
회사	회 사
조작	조 작
샌드위치	샌 드 위 치
상대적	상 대 적
토기	토 기
성장	성 장
이달	이 달
보건소	보 건 소
빨리	빨 리
백화점	백 화 점
되게	되 게
나라	나 라
갈래	갈 래
장편소설	장 편 소 설
인상	인 상
도	도
바깥	바 깥
인식	인 식
밥	밥
강정	강 정
공동	공 동
자소서	자 소 서
버전	버 전
바람	바 람
학회	학 회
별거	별 거
삼성	삼 성
관심	관 심
시스템	시 스 템
바로가기	바 로 가 기
허용	허 용
잡화	잡 화
극장	극 장
별도	별 도
ㄱㄱ	ㄱ ㄱ
즐거움	즐 거 움
전망	전 망
냄비	냄 비
반면	반 면
미	미
연간	연 간
일단	일 단
바로가기	바 로 가 기
예후	예 후
청년	청 년
백업	백 업
겸	겸
직구	직 구
공동	공 동
쌀	쌀
교육학	교 육 학
경기	경 기
술	술
은퇴	은 퇴
분석	분 석
통과	통 과
경기	경 기
자유	자 유
해킹	해 킹
재질	재 질
금연	금 연
위치	위 치
사망	사 망
전망	전 망
비난	비 난
뭘	뭘
하기	하 기
어제	어 제
사람들	사 람 들
캐릭터	캐 릭 터
카페	카 페
사조	사 조
형법	형 법
위치	위 치
그렇지	그 렇 지
협회	협 회
오히려	오 히 려
멜버른	멜 버 른
구글	구 글
담백	담 백
맥주	맥 주
휴대폰	휴 대 폰
으뜸	으 뜸
수사	수 사
가죽	가 죽
혁신	혁 신
진짜	진 짜
저가	저 가
장작	장 작
계	계
양상	양 상
불행히	불 행 히
전망	전 망
표기	표 기
노선	노 선
한글	한 글
비행기	비 행 기
파라다이스	파 라 다 이 스
청소년	청 소 년
뮌헨	뮌 헨
귀걸이	귀 걸 이
코로나바이러스	코 로 나 바 이 러 스
도대체	도 대 체
행사	행 사
전시	전 시
누군가	누 군 가
남쪽	남 쪽
처	처
댓글	댓 글
인증	인 증
으뜸	으 뜸
질의	질 의
시카고	시 카 고
편	편
노비	노 비
도라지	도 라 지
차원	차 원
연속극	연 속 극
스포츠	스 포 츠
계획	계 획
딜	딜
환경	환 경
차	차
건조기	건 조 기
드라마	드 라 마
상무	상 무
혹은	혹 은
팔꿈치	팔 꿈 치
겸	겸
내내	내 내
보호	보 호
비잔티움	비 잔 티 움
가람	가 람
여전히	여 전 히
쓰나미	쓰 나 미
위성	위 성
아무런	아 무 런
에어컨	에 어 컨
오히려	오 히 려
부동산	부 동 산
소득	소 득
최고	최 고
최고	최 고
그릇	그 릇
교두보	교 두 보
스스로	스 스 로
도서관	도 서 관
영향	영 향
질소	질 소
스크랩	스 크 랩
조작	조 작
도박	도 박
육군	육 군
그저	그 저
다스	다 스
상호작용	상 호 작 용
그렇지	그 렇 지
진화	진 화
연애	연 애
소시지	소 시 지
성장	성 장
하기	하 기
비교적	비 교 적
매출	매 출
뮤지컬	뮤 지 컬
영향	영 향
장단점	장 단 점
통화	통 화
디자인	디 자 인
삼진	삼 진
플라스틱	플 라 스 틱
최고	최 고
핸들	핸 들
흔히	흔 히
일단	일 단
시나리오	시 나 리 오
겸	겸
차	차
최고	최 고
월급	월 급
일단	일 단
상담	상 담
선상	선 상
간체자	간 체 자
고급	고 급
특보	특 보
허락	허 락
대회	대 회
라면	라 면
보건	보 건
시대	시 대
스포츠	스 포 츠
기록	기 록
근본	근 본
응원	응 원
아웃	아 웃
링크	링 크
면접	면 접
저장	저 장
설계	설 계
영역	영 역
구어	구 어
점수	점 수
저장	저 장
최고	최 고
분석	분 석
청소	청 소
대회	대 회
성장	성 장
끈	끈
하기	하 기
달	달
디자인	디 자 인
썰	썰
정육점	정 육 점
장관	장 관
소품	소 품
성장	성 장
스카프	스 카 프
방파제	방 파 제
인증	인 증
카페	카 페
카페	카 페
뽀뽀	뽀 뽀
토지	토 지
유	유
벌기	벌 기
레	레
자동판매기	자 동 판 매 기
숙박	숙 박
간지	간 지
태극기	태 극 기
표결	표 결
마지막	마 지 막
전시	전 시
코너	코 너
숫자	숫 자
성곽	성 곽
음식점	음 식 점
알루미늄	알 루 미 늄
연탄	연 탄
사회적	사 회 적
도	도
이란	이 란
형광펜	형 광 펜
필수적	필 수 적
회	회
문제	문 제
응용	응 용
아파트	아 파 트
고발하다	고 발 하 다
책임감	책 임 감
달리	달 리
애니	애 니
츤데레	츤 데 레
층	층
알루미늄	알 루 미 늄
진짜	진 짜
속도	속 도
명소	명 소
아시아	아 시 아
말기	말 기
시스템	시 스 템
코로나	코 로 나
부장	부 장
도착	도 착
돈	돈
검정	검 정
구글	구 글
탈	탈
명소	명 소
탈	탈
타	타
포함	포 함
경기도	경 기 도
만행	만 행
성공	성 공
청소년	청 소 년
조각	조 각
가스	가 스
바닷길	바 닷 길
열넷	열 넷
딸	딸
어린애	어 린 애
디자인	디 자 인
아시아	아 시 아
바람	바 람
표면	표 면
벤치마크	벤 치 마 크
한글	한 글
야근	야 근
문제	문 제
직접적	직 접 적
사태	사 태
출연	출 연
식탁보	식 탁 보
목적지	목 적 지
전기	전 기
관계없이	관 계 없 이
드라마	드 라 마
목	목
도착	도 착
연습	연 습
포함	포 함
제작	제 작
널리	널 리
학명	학 명
반면	반 면
더불어	더 불 어
두바이	두 바 이
도박	도 박
캐릭터	캐 릭 터
도움	도 움
나라	나 라
차량	차 량
드라마	드 라 마
관광	관 광
극장	극 장
너무나	너 무 나
해부	해 부
사회적	사 회 적
바깥	바 깥
전시	전 시
도움	도 움
여전히	여 전 히
주사위	주 사 위
전한	전 한
욱	욱
고급	고 급
인증	인 증
변동	변 동
상황	상 황
트레이닝	트 레 이 닝
케이블	케 이 블
여전히	여 전 히
숙박	숙 박
스스로	스 스 로
도	도
언어	언 어
진짜	진 짜
문제	문 제
나라	나 라
댓글	댓 글
탭	탭
생략	생 략
소식	소 식
명소	명 소
댓글	댓 글
오히려	오 히 려
아시아	아 시 아
죄다	죄 다
경기	경 기
불평등	불 평 등
각주	각 주
여전히	여 전 히
식초	식 초
경기	경 기
위	위
강력	강 력
타월	타 월
주택	주 택
딜	딜
본선	본 선
톤	톤
세금	세 금
점차	점 차
피임	피 임
급기야	급 기 야
사극	사 극
생태계	생 태 계
복	복
하기	하 기
상담	상 담
스포츠	스 포 츠
확률	확 률
변경	변 경
삼성	삼 성
뭘	뭘
초	초
ㅇㅇ	ㅇ ㅇ
스포츠	스 포 츠
강원도	강 원 도
아르메니아	아 르 메 니 아
드라마	드 라 마
종합	종 합
게이트	게 이 트
혹은	혹 은
전시	전 시
연속	연 속
심야	심 야
아파트	아 파 트
가슴	가 슴
핵심	핵 심
한글	한 글
아시아	아 시 아
이사야	이 사 야
연속	연 속
사회적	사 회 적
썰	썰
달	달
치료	치 료
도박	도 박
소개	소 개
차량	차 량
해킹	해 킹
방사능	방 사 능
사망	사 망
페이지	페 이 지
한국어	한 국 어
중학교	중 학 교
특별시	특 별 시
경기	경 기
차	차
의회	의 회
강원도	강 원 도
별로	별 로
해방	해 방
전남	전 남
시스템	시 스 템
매년	매 년
징역	징 역
전직	전 직
랑	랑
돈	돈
관광	관 광
캐나다	캐 나 다
변호사	변 호 사
캐나다	캐 나 다
내리	내 리
인식	인 식
우라늄	우 라 늄
포함	포 함
오히려	오 히 려
법인	법 인
해고	해 고
연인	연 인
대회	대 회
편취	편 취
금	금
하자	하 자
낙엽	낙 엽
돈	돈
특정	특 정
필수	필 수
경기도	경 기 도
병역	병 역
스텝	스 텝
명인	명 인
가변	가 변
자유	자 유
자유	자 유
아시아	아 시 아
들	들
확률	확 률
뮤지컬	뮤 지 컬
음식점	음 식 점
돈	돈
역량	역 량
장관	장 관
조식	조 식
겸	겸
순	순
따라하다	따 라 하 다
분	분
초	초
도박	도 박
엄마	엄 마
삼성	삼 성
인상	인 상
쌀	쌀
포유류	포 유 류
아이콘	아 이 콘
태그	태 그
초보자	초 보 자
사학	사 학
후임	후 임
푹	푹
누구	누 구
영역	영 역
대회	대 회
알루미늄	알 루 미 늄
경기도	경 기 도
시대	시 대
드라마	드 라 마
확률	확 률
차원	차 원
예문	예 문
모델	모 델
묻다	묻 다
전망	전 망
달리	달 리
키예프	키 예 프
예수	예 수
ㅎㅎ	ㅎ ㅎ
저가	저 가
파일	파 일
분석	분 석
글라스	글 라 스
술	술
남녀	남 녀
포함	포 함
협정	협 정
너무나	너 무 나
비판	비 판
논문집	논 문 집
포함	포 함
부에노스아이레스	부 에 노 스 아 이 레 스
혐의	혐 의
디자인	디 자 인
이달	이 달
댓글	댓 글
상자	상 자
변경	변 경
생략	생 략
집안	집 안
미	미
제휴	제 휴
첫째	첫 째
지성	지 성
자율	자 율
하기	하 기
세월	세 월
특정	특 정
소개	소 개
라인	라 인
목사	목 사
오히려	오 히 려
접속	접 속
수입	수 입
드라마	드 라 마
불법	불 법
니콜라스	니 콜 라 스
취소	취 소
아동	아 동
예수	예 수
배경	배 경
조절	조 절
마작	마 작
진짜	진 짜
분	분
포함	포 함
바베이도스	바 베 이 도 스
금연	금 연
수색	수 색
방어	방 어
글쎄	글 쎄
마지막	마 지 막
분	분
비교적	비 교 적
삼나무	삼 나 무
견적	견 적
누나	누 나
ㅎㅎ	ㅎ ㅎ
썰	썰
여전히	여 전 히
학부	학 부
수출	수 출
싱가포르	싱 가 포 르
수표	수 표
계획	계 획
노인	노 인
예수	예 수
드라마	드 라 마
접시	접 시
도	도
성장	성 장
전시	전 시
공지	공 지
강원도	강 원 도
역할	역 할
쌀	쌀
목사	목 사
바륨	바 륨
문맥	문 맥
강수량	강 수 량
여전히	여 전 히
정신과	정 신 과
여호와	여 호 와
사회적	사 회 적
중요	중 요
하기	하 기
마지막	마 지 막
이대로	이 대 로
그저	그 저
상자	상 자
심포지엄	심 포 지 엄
대단히	대 단 히
자유	자 유
타	타
특정	특 정
별도	별 도
외면	외 면
세탁기	세 탁 기
그날	그 날
과거	과 거
여전히	여 전 히
진짜	진 짜
탐험	탐 험
구분	구 분
문제	문 제
유적	유 적
타	타
바로가기	바 로 가 기
가슴	가 슴
제외	제 외
레이다	레 이 다
반면	반 면
문제	문 제
허락	허 락
수천	수 천
고구려	고 구 려
초	초
단맛	단 맛
함부로	함 부 로
바이러스	바 이 러 스
ㄱㄱ	ㄱ ㄱ
시대	시 대
돈	돈
어서	어 서
산업	산 업
조치	조 치
이전	이 전
교원	교 원
분석	분 석
지대	지 대
실적	실 적
핵심	핵 심
삽입	삽 입
민지	민 지
소식	소 식
임금	임 금
전직	전 직
삽화	삽 화
철도역	철 도 역
전기	전 기
우리들	우 리 들
태그	태 그
충전기	충 전 기
연애	연 애
기부	기 부
ㅎㅎ	ㅎ ㅎ
안주	안 주
통계	통 계
위치	위 치
진출	진 출
위원장	위 원 장
필수	필 수
상황	상 황
얼굴	얼 굴
노력	노 력
스포츠	스 포 츠
합성어	합 성 어
정신과	정 신 과
일본인	일 본 인
구분	구 분
수요	수 요
뒷면	뒷 면
그거	그 거
도박	도 박
인력	인 력
한글	한 글
청소기	청 소 기
대단히	대 단 히
사회적	사 회 적
국경일	국 경 일
나라	나 라
일원	일 원
발단	발 단
조식	조 식
마카	마 카
자유	자 유
비옷	비 옷
발기부전	발 기 부 전
도착	도 착
혹은	혹 은
문어다리	문 어 다 리
시스템	시 스 템
음식점	음 식 점
전철	전 철
최고	최 고
너무나	너 무 나
타입	타 입
하자	하 자
회전	회 전
사계	사 계
브리핑	브 리 핑
목재	목 재
확률	확 률
시스템	시 스 템
영향	영 향
문제	문 제
티비	티 비
개정	개 정
면접	면 접
언어	언 어
나라	나 라
함부로	함 부 로
달	달
독립	독 립
상처	상 처
분석	분 석
구청	구 청
돌궐	돌 궐
브루나이	브 루 나 이
고급	고 급
마지막	마 지 막
라임	라 임
장인	장 인
독립	독 립
부동산	부 동 산
전사	전 사
코로나	코 로 나
깁스	깁 스
충남	충 남
숙박	숙 박
품질	품 질
너머로	너 머 로
포트	포 트
공지	공 지
전망	전 망
혹여	혹 여
이전	이 전
비	비
블라우스	블 라 우 스
혹은	혹 은
제외	제 외
이중	이 중
포함	포 함
아웃	아 웃
열람	열 람
녀	녀
조금	조 금
정기	정 기
숙박	숙 박
고민	고 민
속도	속 도
성장	성 장
그린란드	그 린 란 드
이전	이 전
일제시대	일 제 시 대
댓글	댓 글
개입	개 입
무명	무 명
사회적	사 회 적
품질	품 질
옛말	옛 말
이달	이 달
파라다이스	파 라 다 이 스
니켈	니 켈
혁신	혁 신
하자	하 자
두건	두 건
해킹	해 킹
예수	예 수
기아	기 아
금연	금 연
웃음	웃 음
글쓴이	글 쓴 이
최고	최 고
행복하다	행 복 하 다
방사성	방 사 성
제작	제 작
발급	발 급
위증	위 증
영광	영 광
수십	수 십
포트	포 트
통산	통 산
변경	변 경
변함없이	변 함 없 이
장애	장 애
속도	속 도
엄마	엄 마
삼성	삼 성
대학생	대 학 생
명문	명 문
회사	회 사
백화점	백 화 점
그게	그 게
점차	점 차
위	위
게스트하우스	게 스 트 하 우 스
타워	타 워
주택	주 택
도대체	도 대 체
학술	학 술
백수	백 수
디자인	디 자 인
에어컨	에 어 컨
석방	석 방
내내	내 내
톤	톤
가혹	가 혹
삼성	삼 성
여기	여 기
소개	소 개
풍요	풍 요
지구의	지 구 의
달	달
사회적	사 회 적
의회	의 회
명상	명 상
경기도	경 기 도
주택	주 택
인턴	인 턴
공동	공 동
런던	런 던
상기	상 기
항생제	항 생 제
영구	영 구
중개인	중 개 인
불법	불 법
딜	딜
반면	반 면
캐릭터	캐 릭 터
회사	회 사
고양이	고 양 이
한국어	한 국 어
성공	성 공
별로	별 로
지지	지 지
유	유
종	종
강원도	강 원 도
곡	곡
정원	정 원
바이러스	바 이 러 스
카페인	카 페 인
하와이	하 와 이
해킹	해 킹
절강	절 강
카페	카 페
위원장	위 원 장
신경	신 경
애정	애 정
원피스	원 피 스
샌드위치	샌 드 위 치
외국어	외 국 어
숙박	숙 박
성우	성 우
스캔들	스 캔 들
최고	최 고
실적	실 적
링크	링 크
오이	오 이
페이지	페 이 지
위치	위 치
나라	나 라
산업	산 업
파견	파 견
본선	본 선
실적	실 적
카자흐스탄	카 자 흐 스 탄
구글	구 글
포함	포 함
일정	일 정
물개	물 개
이외	이 외
여전히	여 전 히
중학교	중 학 교
불어	불 어
자살	자 살
수천	수 천
댓글	댓 글
이전	이 전
탱크	탱 크
체육관	체 육 관
육체	육 체
마스크	마 스 크
초승달	초 승 달
성공	성 공
산업	산 업
마지막	마 지 막
비행기	비 행 기
돈	돈
아니다	아 니 다
성공	성 공
알레르기성	알 레 르 기 성
부동산	부 동 산
전한	전 한
분석	분 석
응용	응 용
뿌리	뿌 리
시대	시 대
백색	백 색
반전	반 전
금연	금 연
제출	제 출
저출산	저 출 산
지지	지 지
실적	실 적
평소	평 소
조금	조 금
너무나	너 무 나
세월	세 월
젊음	젊 음
분	분
응용	응 용
노력	노 력
사탕	사 탕
널리	널 리
민화	민 화
마른	마 른
장애	장 애
연극	연 극
전남	전 남
은하	은 하
카페	카 페
외면	외 면
무작위	무 작 위
매출	매 출
포트	포 트
안타	안 타
사설	사 설
핵	핵
산업	산 업
매체	매 체
분석	분 석
남쪽	남 쪽
숙박	숙 박
링크	링 크
사고	사 고
표기	표 기
오히려	오 히 려
페이지	페 이 지
자궁	자 궁
확률	확 률
여전히	여 전 히
신경	신 경
비상	비 상
재	재
다양하다	다 양 하 다
더불어	더 불 어
일단	일 단
증명	증 명
분	분
이탈리아어	이 탈 리 아 어
올림픽	올 림 픽
증명	증 명
구글	구 글
부임	부 임
들	들
쌍	쌍
웨스턴	웨 스 턴
널리	널 리
붕어	붕 어
미	미
식당	식 당
증인	증 인
위	위
기도	기 도
독립	독 립
고양이	고 양 이
부동산	부 동 산
공지	공 지
점차	점 차
빨리	빨 리
둘	둘
태그	태 그
나라	나 라
궁극적	궁 극 적
이중	이 중
이전	이 전
자해	자 해
사태	사 태
소시지	소 시 지
충남	충 남
콜라보레이션	콜 라 보 레 이 션
드라마	드 라 마
페이지	페 이 지
오하이오	오 하 이 오
우즈베키스탄	우 즈 베 키 스 탄
바로가기	바 로 가 기
문제	문 제
응원	응 원
강원도	강 원 도
박사	박 사
언어	언 어
품질	품 질
자유	자 유
사례	사 례
내내	내 내
이달	이 달
얼굴	얼 굴
타이어	타 이 어
사설	사 설
회사	회 사
매출	매 출
질문	질 문
케이블	케 이 블
저런	저 런
심장	심 장
댓글	댓 글
파일	파 일
화려	화 려
적당량	적 당 량
마스크	마 스 크
접속	접 속
필라테스	필 라 테 스
애도	애 도
민사	민 사
오히려	오 히 려
초	초
필수	필 수
살	살
철거	철 거
ㅎㅎ	ㅎ ㅎ
물결	물 결
아파트	아 파 트
수출	수 출
고대	고 대
요즘	요 즘
반면	반 면
디자인	디 자 인
인턴	인 턴
최고	최 고
조작	조 작
구글	구 글
감자	감 자
참고	참 고
전남	전 남
개정	개 정
보호	보 호
보호	보 호
케이블	케 이 블
도움	도 움
구애	구 애
캡	캡
장편소설	장 편 소 설
카페	카 페
흰색	흰 색
고려	고 려
진동	진 동
사고	사 고
금	금
자궁	자 궁
사설	사 설
부동산	부 동 산
평소	평 소
오히려	오 히 려
이중	이 중
필수	필 수
이러다	이 러 다
좌지우지	좌 지 우 지
산소	산 소
노인	노 인
탐험	탐 험
애플	애 플
브로커	브 로 커
아벨	아 벨
숙박	숙 박
스페인	스 페 인
특별	특 별
필수적	필 수 적
악력계	악 력 계
포함	포 함
금	금
목재	목 재
흔히	흔 히
드라마	드 라 마
태그	태 그
월요일	월 요 일
그렇지	그 렇 지
이중	이 중
모니터	모 니 터
없다	없 다
소식	소 식
평소	평 소
디자인	디 자 인
폭발	폭 발
등락	등 락
다큐멘터리	다 큐 멘 터 리
현관	현 관
생수	생 수
경기	경 기
고향	고 향
한마디	한 마 디
댓글	댓 글
목	목
매출	매 출
아테네	아 테 네
숙박	숙 박
상자	상 자
청소기	청 소 기
백	백
차	차
대회	대 회
행사	행 사
반면	반 면
캠프	캠 프
개정	개 정
기아	기 아
혹은	혹 은
포부	포 부
탱크	탱 크
돈	돈
스스로	스 스 로
단기	단 기
혁신	혁 신
가정교사	가 정 교 사
예컨대	예 컨 대
도착	도 착
품질	품 질
청년	청 년
파견	파 견
성장	성 장
축일	축 일
기꺼이	기 꺼 이
분간	분 간
성장	성 장
바이러스	바 이 러 스
탑재	탑 재
종합	종 합
나라	나 라
조금	조 금
행사	행 사
청소년	청 소 년
강가	강 가
카페	카 페
그게	그 게
빨리	빨 리
그러니까	그 러 니 까
고대	고 대
달리	달 리
비교적	비 교 적
가스	가 스
진동	진 동
여전히	여 전 히
바오로	바 오 로
휴게실	휴 게 실
필	필
사고	사 고
벤젠	벤 젠
교실	교 실
픽	픽
흰색	흰 색
산업	산 업
금연	금 연
진짜	진 짜
도대체	도 대 체
디자인	디 자 인
여전히	여 전 히
모델	모 델
성장	성 장
차	차
성장	성 장
뭘	뭘
해제	해 제
달리	달 리
메디케어	메 디 케 어
지지	지 지
웃음	웃 음
행사	행 사
시대	시 대
살	살
살	살
악	악
회사	회 사
보트	보 트
요즘	요 즘
필수	필 수
이주	이 주
하기	하 기
전한	전 한
미	미
장애	장 애
허용	허 용
사이즈	사 이 즈
환경	환 경
태그	태 그
기관총	기 관 총
이원	이 원
노력	노 력
비	비
명소	명 소
모델	모 델
근본	근 본
인식	인 식
레	레
외지	외 지
위원장	위 원 장
사설	사 설
한국어	한 국 어
여럿	여 럿
배당	배 당
미끄럽다	미 끄 럽 다
부동산	부 동 산
다이아몬드	다 이 아 몬 드
계	계
어서	어 서
가짜	가 짜
연속	연 속
사망	사 망
생방송	생 방 송
종합	종 합
종합	종 합
금	금
이듬해	이 듬 해
드라마	드 라 마
분석	분 석
혐의	혐 의
열병	열 병
하기	하 기
브로커	브 로 커
다이아몬드	다 이 아 몬 드
칼슘	칼 슘
웃음	웃 음
오라	오 라
매년	매 년
혹은	혹 은
조금	조 금
카멜레온	카 멜 레 온
아나운서	아 나 운 서
회사	회 사
살아가다	살 아 가 다
서서히	서 서 히
최선	최 선
교통사고	교 통 사 고
독립	독 립
통계	통 계
엔	엔
댕댕이	댕 댕 이
마지막	마 지 막
월급	월 급
포함	포 함
그리스	그 리 스
의장	의 장
상황	상 황
후드	후 드
다스	다 스
구리	구 리
정원	정 원
건축	건 축
손가락	손 가 락
변수	변 수
최고	최 고
탄약	탄 약
본선	본 선
위	위
일류	일 류
핵심	핵 심
사실무근	사 실 무 근
달리	달 리
식초	식 초
청년	청 년
대학수학능력시험	대 학 수 학 능 력 시 험
증명	증 명
방어	방 어
벼	벼
다이어트	다 이 어 트
상기	상 기
첼로	첼 로
위	위
노인	노 인
웃음	웃 음
진짜	진 짜
마지막	마 지 막
질문	질 문
혈장	혈 장
공동	공 동
필수	필 수
후드	후 드
이슬람	이 슬 람
간수	간 수
정류장	정 류 장
미사	미 사
최적	최 적
사설	사 설
단순	단 순
난로	난 로
아티스트	아 티 스 트
포세이돈	포 세 이 돈
시대	시 대
기모노	기 모 노
진짜	진 짜
시금치	시 금 치
그저	그 저
소개	소 개
코로나바이러스	코 로 나 바 이 러 스
먼지	먼 지
바로가기	바 로 가 기
위성	위 성
만나다	만 나 다
아티스트	아 티 스 트
관심	관 심
영향	영 향
특정	특 정
밀라노	밀 라 노
연습	연 습
윌리엄	윌 리 엄
슬슬	슬 슬
라인	라 인
빨리	빨 리
돈	돈
기독	기 독
너네	너 네
에어컨	에 어 컨
트레이닝	트 레 이 닝
조금	조 금
누가	누 가
묻다	묻 다
영향	영 향
통화	통 화
살	살
아파트	아 파 트
상자	상 자
구글	구 글
도박	도 박
너머로	너 머 로
부동산	부 동 산
나라	나 라
과거	과 거
미각	미 각
소식	소 식
처리	처 리
도움말	도 움 말
실적	실 적
사람들	사 람 들
이전	이 전
티켓	티 켓
조금	조 금
빌딩	빌 딩
첫째	첫 째
클래스	클 래 스
스스로	스 스 로
돈	돈
숙박	숙 박
오페라	오 페 라
습격	습 격
사설	사 설
도서관	도 서 관
조작	조 작
차	차
돈	돈
사료	사 료
플러그	플 러 그
빈민가	빈 민 가
체육관	체 육 관
마이크로프로세서	마 이 크 로 프 로 세 서
변경	변 경
호떡	호 떡
모델	모 델
청년	청 년
사회적	사 회 적
그만	그 만
제휴	제 휴
뮤직	뮤 직
존엄사	존 엄 사
협회	협 회
역량	역 량
연결	연 결
흉내	흉 내
전류	전 류
하부	하 부
복	복
숙박	숙 박
공격	공 격
아시아	아 시 아
습도	습 도
아파트	아 파 트
한파	한 파
장관	장 관
마지막	마 지 막
산업	산 업
행사	행 사
아무	아 무
근대	근 대
디자인	디 자 인
최고	최 고
공동	공 동
위	위
파라다이스	파 라 다 이 스
대단히	대 단 히
충남	충 남
해제	해 제
일본어	일 본 어
사이즈	사 이 즈
마지막	마 지 막
최고	최 고
도착	도 착
명소	명 소
남부	남 부
클래스	클 래 스
제작	제 작
결석	결 석
조각가	조 각 가
하트	하 트
사고	사 고
매년	매 년
수녀	수 녀
쓰레기통	쓰 레 기 통
교정	교 정
엄마	엄 마
이달	이 달
성장	성 장
여전히	여 전 히
주택	주 택
드라마	드 라 마
분석	분 석
아르헨티나	아 르 헨 티 나
저게	저 게
돈	돈
연두	연 두
물총새	물 총 새
오히려	오 히 려
신경	신 경
미적	미 적
체리	체 리
특별	특 별
루이	루 이
구내식당	구 내 식 당
비	비
도	도
시나리오	시 나 리 오
좌우	좌 우
마지막	마 지 막
회사	회 사
일정	일 정
미	미
조치	조 치
가래	가 래
웃음	웃 음
편	편
인식	인 식
비난	비 난
도움	도 움
살	살
도막	도 막
아테네	아 테 네
글쓴이	글 쓴 이
상기	상 기
응용	응 용
탈퇴	탈 퇴
시스템	시 스 템
응원	응 원
이달	이 달
평소	평 소
별것	별 것
가슴	가 슴
커뮤니티	커 뮤 니 티
지지	지 지
왕후	왕 후
소개	소 개
음식점	음 식 점
달리	달 리
모델	모 델
살	살
청색	청 색
견해	견 해
스테이크	스 테 이 크
위치	위 치
취소	취 소
다이어트	다 이 어 트
외환	외 환
언어	언 어
중립	중 립
초	초
갓	갓
낭비	낭 비
성공	성 공
연필	연 필
안주	안 주
스포츠	스 포 츠
386	3 8 6
목소리	목 소 리
금발	금 발
오히려	오 히 려
세월	세 월
필수	필 수
스스로	스 스 로
평소	평 소
북위	북 위
뿌리	뿌 리
도박	도 박
달리	달 리
개방	개 방
백	백
고구려	고 구 려
중학교	중 학 교
사회적	사 회 적
전사	전 사
뽀뽀	뽀 뽀
드라마	드 라 마
아비	아 비
보호자	보 호 자
조세	조 세
저장	저 장
스스로	스 스 로
아테네	아 테 네
포함	포 함
선글라스	선 글 라 스
사례	사 례
관심	관 심
패션쇼	패 션 쇼
빨리	빨 리
산스크리트어	산 스 크 리 트 어
스포츠	스 포 츠
일단	일 단
행사	행 사
액세서리	액 세 서 리
아파트	아 파 트
평소	평 소
독서	독 서
사막화	사 막 화
확인하다	확 인 하 다
디자인	디 자 인
스포츠	스 포 츠
아파트	아 파 트
그게	그 게
하늘길	하 늘 길
애플	애 플
마지막	마 지 막
저가	저 가
보물	보 물
겨우	겨 우
널	널
방금	방 금
목	목
다양하다	다 양 하 다
빌딩	빌 딩
금	금
다문화	다 문 화
불사조	불 사 조
물놀이장	물 놀 이 장
없다	없 다
진짜	진 짜
스스로	스 스 로
파라다이스	파 라 다 이 스
십자가	십 자 가
파란색	파 란 색
맹꽁이	맹 꽁 이
커뮤니티	커 뮤 니 티
댓글	댓 글
마침	마 침
파라다이스	파 라 다 이 스
매출	매 출
인력	인 력
간선도로	간 선 도 로
해방	해 방
티켓	티 켓
문제	문 제
빨리	빨 리
저장	저 장
이슬	이 슬
문제	문 제
속도	속 도
살	살
수표	수 표
핵심	핵 심
보호	보 호
명소	명 소
웃음	웃 음
연속	연 속
허투루	허 투 루
소나기	소 나 기
사람들	사 람 들
샘플	샘 플
차량	차 량
비교적	비 교 적
전직	전 직
진출	진 출
금	금
도박	도 박
연속	연 속
간혹	간 혹
설계	설 계
청색	청 색
역량	역 량
누구	누 구
분	분
일단	일 단
교복	교 복
하기	하 기
어제	어 제
숙박	숙 박
도	도
자물쇠	자 물 쇠
고양이	고 양 이
사이즈	사 이 즈
전직	전 직
청년	청 년
위안부	위 안 부
모교	모 교
자외선	자 외 선
케이블	케 이 블
치료	치 료
오토바이	오 토 바 이
굽	굽
소득	소 득
조금	조 금
폭발	폭 발
목사	목 사
코코아	코 코 아
도	도
대단히	대 단 히
일단	일 단
교	교
단무지	단 무 지
녹차	녹 차
어플	어 플
보호	보 호
거문도	거 문 도
명란	명 란
갈대	갈 대
진짜	진 짜
블라인드	블 라 인 드
관심	관 심
방역	방 역
모델	모 델
언어	언 어
기어	기 어
별도	별 도
일본인	일 본 인
발급	발 급
무섭다	무 섭 다
별도	별 도
설마	설 마
차	차
저런	저 런
단기	단 기
혹은	혹 은
평소	평 소
빨리	빨 리
링크	링 크
폰	폰
경주	경 주
쇼케이스	쇼 케 이 스
도착	도 착
전망	전 망
일단	일 단
혁신	혁 신
마지막	마 지 막
심장	심 장
곱창	곱 창
디자인	디 자 인
음식점	음 식 점
인상	인 상
사설	사 설
원피스	원 피 스
현대적	현 대 적
격납고	격 납 고
우크라이나	우 크 라 이 나
청소년	청 소 년
아비	아 비
원피스	원 피 스
마지막	마 지 막
어린애	어 린 애
돈	돈
무작위	무 작 위
무조건	무 조 건
마스크	마 스 크
굳이	굳 이
조금	조 금
합의	합 의
비	비
술	술
성공	성 공
백화점	백 화 점
디자인	디 자 인
디자인	디 자 인
심장	심 장
마이크로폰	마 이 크 로 폰
변수	변 수
특성	특 성
영역	영 역
정제	정 제
처리	처 리
시대	시 대
아시아	아 시 아
과거	과 거
신종	신 종
없다	없 다
산업	산 업
머피	머 피
소개	소 개
누구	누 구
녀	녀
연결	연 결
투척	투 척
연간	연 간
전시	전 시
전망	전 망
문제	문 제
고대	고 대
제우스	제 우 스
독서실	독 서 실
비핵화	비 핵 화
남동	남 동
가득	가 득
이달	이 달
실적	실 적
파일	파 일
녹음	녹 음
관광객	관 광 객
그렇지	그 렇 지
버전	버 전
케이블	케 이 블
달리	달 리
현대적	현 대 적
예수	예 수
상황	상 황
커뮤니티	커 뮤 니 티
계열	계 열
반면	반 면
일기장	일 기 장
청년	청 년
들	들
숙박	숙 박
동쪽	동 쪽
회의록	회 의 록
일축	일 축
조금	조 금
평소	평 소
스스로	스 스 로
두루	두 루
식단	식 단
너머로	너 머 로
옴	옴
가스	가 스
설계	설 계
파란색	파 란 색
지지	지 지
아브라함	아 브 라 함
스포츠	스 포 츠
원피스	원 피 스
청주	청 주
아파트	아 파 트
웃음	웃 음
항소	항 소
안아키	안 아 키
도깨비	도 깨 비
숙소	숙 소
조금	조 금
쇼케이스	쇼 케 이 스
교육학	교 육 학
마지막	마 지 막
성장	성 장
슬기	슬 기
도착	도 착
처리	처 리
매출	매 출
여	여
토론	토 론
애정	애 정
낙원	낙 원
불법	불 법
가죽	가 죽
명성	명 성
분	분
차	차
니제르	니 제 르
대회	대 회
전기	전 기
고급	고 급
초	초
경기도	경 기 도
관심	관 심
분석	분 석
자유	자 유
시스템	시 스 템
매년	매 년
분석	분 석
애플	애 플
강추	강 추
고급	고 급
경기	경 기
분	분
행사	행 사
이중	이 중
불법	불 법
도착하다	도 착 하 다
아동	아 동
경주	경 주
도착	도 착
고객님	고 객 님
흔히	흔 히
행사	행 사
아래층	아 래 층
비	비
알루미늄	알 루 미 늄
달리	달 리
선고	선 고
무조건	무 조 건
전사	전 사
불법	불 법
수평선	수 평 선
특성	특 성
위	위
가죽	가 죽
나라	나 라
생태계	생 태 계
수사	수 사
치료제	치 료 제
변경	변 경
케이블	케 이 블
전시	전 시
의료	의 료
선율	선 율
아빠	아 빠
한국어	한 국 어
서서히	서 서 히
신동	신 동
스크랩	스 크 랩
이주	이 주
미	미
영향	영 향
롤	롤
시스템	시 스 템
합계	합 계
명소	명 소
숙박	숙 박
군사	군 사
모델	모 델
트레이닝	트 레 이 닝
주택	주 택
고대	고 대
무조건	무 조 건
차마	차 마
스포츠	스 포 츠
여전히	여 전 히
태그	태 그
손가락	손 가 락
대단히	대 단 히
아무	아 무
백화점	백 화 점
용사	용 사
미	미
종합	종 합
인치	인 치
탑재	탑 재
매	매
드라마	드 라 마
후드	후 드
캐나다	캐 나 다
진짜	진 짜
캐나다	캐 나 다
인쇄기	인 쇄 기
차량	차 량
디자인	디 자 인
매년	매 년
진출	진 출
바베이도스	바 베 이 도 스
링크	링 크
종합	종 합
더불어	더 불 어
사쿠라	사 쿠 라
종합	종 합
합계	합 계
조리	조 리
여전히	여 전 히
금발	금 발
점차	점 차
성장	성 장
회사	회 사
생태계	생 태 계
귀걸이	귀 걸 이
거인	거 인
위	위
어제	어 제
차량	차 량
난로	난 로
달	달
재채기	재 채 기
별도	별 도
변경	변 경
어플	어 플
권	권
그게	그 게
여전히	여 전 히
월요일	월 요 일
밥	밥
공격	공 격
라그나로크	라 그 나 로 크
이전	이 전
오히려	오 히 려
푹	푹
까치	까 치
숙박	숙 박
라면	라 면
공지	공 지
임신부	임 신 부
개정	개 정
예수	예 수
치료	치 료
간식	간 식
바이러스	바 이 러 스
졸업식	졸 업 식
자궁	자 궁
댓글	댓 글
노래방	노 래 방
월급	월 급
그릇	그 릇
하기	하 기
뭘	뭘
웃음	웃 음
조선시대	조 선 시 대
디자인	디 자 인
한국전쟁	한 국 전 쟁
구분	구 분
이전	이 전
연속	연 속
이란	이 란
포함	포 함
즐거움	즐 거 움
건축	건 축
돈	돈
박사	박 사
어른	어 른
벌기	벌 기
깡통	깡 통
라인	라 인
노선	노 선
혹은	혹 은
자율	자 율
분	분
광구	광 구
강원도	강 원 도
마우스	마 우 스
저장	저 장
지명	지 명
저장	저 장
별로	별 로
부문	부 문
작풍	작 풍
한잔	한 잔
파라다이스	파 라 다 이 스
도움	도 움
최저임금	최 저 임 금
사람들	사 람 들
실적	실 적
실적	실 적
분	분
부정적	부 정 적
기어	기 어
함부로	함 부 로
인증	인 증
검정	검 정
어제	어 제
분석	분 석
강원도	강 원 도
보호	보 호
與件	與 件
관계없이	관 계 없 이
시스템	시 스 템
장로교	장 로 교
부문	부 문
학술	학 술
링크	링 크
혹은	혹 은
진화	진 화
시나리오	시 나 리 오
누가	누 가
종	종
구호	구 호
파랑새	파 랑 새
비타민	비 타 민
공격	공 격
야채	야 채
최저임금	최 저 임 금
누가	누 가
처리	처 리
정기	정 기
세네갈	세 네 갈
위치	위 치
바깥	바 깥
수요	수 요
초	초
캔자스	캔 자 스
익사	익 사
위	위
디자인	디 자 인
사설	사 설
유로	유 로
전남	전 남
이전	이 전
가로막	가 로 막
런던	런 던
톤	톤
보관소	보 관 소
생태계	생 태 계
페이지	페 이 지
자그마치	자 그 마 치
청년	청 년
돈	돈
확률	확 률
특성	특 성
영업	영 업
아르메니아	아 르 메 니 아
빗자루	빗 자 루
코로나	코 로 나
지구	지 구
분대	분 대
고정	고 정
스페인	스 페 인
디자인	디 자 인
후드	후 드
운영하다	운 영 하 다
공지	공 지
산업	산 업
일단	일 단
스포츠	스 포 츠
안식일	안 식 일
확산	확 산
툰드라	툰 드 라
회의록	회 의 록
매년	매 년
아무런	아 무 런
디자인	디 자 인
가득	가 득
그만	그 만
충남	충 남
티켓	티 켓
한글	한 글
저장	저 장
이란	이 란
내내	내 내
고기	고 기
불법	불 법
가짜	가 짜
사설	사 설
마지막	마 지 막
경기도	경 기 도
지지	지 지
제조업	제 조 업
사회적	사 회 적
바람	바 람
그만	그 만
밀림	밀 림
아야	아 야
평소	평 소
충남	충 남
비판	비 판
사회적	사 회 적
상기	상 기
위치	위 치
수입	수 입
역도	역 도
달리	달 리
재	재
수사	수 사
파라다이스	파 라 다 이 스
사망	사 망
전기	전 기
수지	수 지
지지	지 지
장수	장 수
삼성	삼 성
도움	도 움
널리	널 리
가득	가 득
정원	정 원
여기	여 기
여	여
히트	히 트
확률	확 률
첫째	첫 째
성우	성 우
징역	징 역
에스페란토	에 스 페 란 토
목	목
미	미
대회	대 회
문제	문 제
도박	도 박
페이지	페 이 지
스포츠	스 포 츠
정음	정 음
권투	권 투
조작	조 작
이대로	이 대 로
하기	하 기
흔히	흔 히
자유	자 유
더불어	더 불 어
이분	이 분
규소	규 소
성장	성 장
기선	기 선
혹은	혹 은
트뤼도	트 뤼 도
지진	지 진
의의	의 의
가죽	가 죽
니켈	니 켈
조각상	조 각 상
확률	확 률
파일	파 일
환경	환 경
전세	전 세
연속	연 속
급기야	급 기 야
각목	각 목
화장실	화 장 실
보호	보 호
숙박	숙 박
목사	목 사
두루	두 루
임금	임 금
분	분
공지	공 지
위치	위 치
독립	독 립
써	써
누가	누 가
언덕	언 덕
횡단	횡 단
밴쿠버	밴 쿠 버
생명보험	생 명 보 험
인력	인 력
탈퇴	탈 퇴
복날	복 날
상담	상 담
사회적	사 회 적
링크	링 크
해고	해 고
인턴	인 턴
대학생	대 학 생
스스로	스 스 로
샹들리에	샹 들 리 에
바람	바 람
아빠	아 빠
기증	기 증
정상	정 상
더불어	더 불 어
계열	계 열
눈뜨다	눈 뜨 다
박사	박 사
부	부
공지	공 지
제휴	제 휴
경기	경 기
런던	런 던
달	달
주가	주 가
연극	연 극
일단	일 단
알레르기성	알 레 르 기 성
전시	전 시
유	유
처리	처 리
일단	일 단
어플리케이션	어 플 리 케 이 션
대포	대 포
저거	저 거
파견	파 견
노래방	노 래 방
물건	물 건
모델	모 델
박스	박 스
개정	개 정
장발	장 발
칼슘	칼 슘
재질	재 질
리히텐슈타인	리 히 텐 슈 타 인
구분	구 분
최고	최 고
지지	지 지
추후	추 후
마우스	마 우 스
단순	단 순
육군	육 군
스펀지	스 펀 지
별로	별 로
긴장	긴 장
소득	소 득
출판	출 판
여전히	여 전 히
아동	아 동
유머	유 머
소식	소 식
하기	하 기
돈	돈
둘	둘
파견	파 견
웃음	웃 음
넷째	넷 째
타이완	타 이 완
의장	의 장
무사	무 사
아티스트	아 티 스 트
견적	견 적
하기	하 기
모터	모 터
보건	보 건
런던	런 던
발급	발 급
공지	공 지
없다	없 다
사람들	사 람 들
누리집	누 리 집
추후	추 후
돈	돈
삼성	삼 성
성장	성 장
그저	그 저
쇼	쇼
아나운서	아 나 운 서
전망	전 망
달	달
카페	카 페
위성	위 성
분	분
원피스	원 피 스
괴	괴
사고	사 고
글쓴이	글 쓴 이
전대	전 대
북위	북 위
사회적	사 회 적
보호	보 호
분석	분 석
아홉	아 홉
임신	임 신
돈	돈
둘째	둘 째
행사	행 사
정원	정 원
임마누엘	임 마 누 엘
청소	청 소
견적	견 적
산업	산 업
더불어	더 불 어
혹은	혹 은
심부전	심 부 전
원자로	원 자 로
그러니까	그 러 니 까
도대체	도 대 체
익월	익 월
보건	보 건
조작	조 작
이탈리아어	이 탈 리 아 어
조절	조 절
여전히	여 전 히
새삼	새 삼
고급	고 급
갈래	갈 래
조각	조 각
숙박	숙 박
사망	사 망
수출	수 출
써	써
초	초
경기	경 기
고기	고 기
아쉽다	아 쉽 다
차량	차 량
빌딩	빌 딩
공동	공 동
스스로	스 스 로
요지	요 지
핫스팟	핫 스 팟
비	비
멱살	멱 살
시스템	시 스 템
숙박	숙 박
사회적	사 회 적
야채	야 채
톈진	톈 진
감자튀김	감 자 튀 김
아동	아 동
그리스	그 리 스
엔	엔
해킹	해 킹
연속	연 속
반전	반 전
후추	후 추
회사	회 사
굳이	굳 이
숙박	숙 박
특정	특 정
습도	습 도
토론	토 론
공지	공 지
공식적	공 식 적
나라	나 라
혹은	혹 은
환상적	환 상 적
바늘	바 늘
부문	부 문
캡	캡
되게	되 게
역할	역 할
구청	구 청
청년	청 년
염기	염 기
단기	단 기
성공	성 공
심포지엄	심 포 지 엄
전기	전 기
티켓	티 켓
돈	돈
소개	소 개
해킹	해 킹
법원	법 원
감자	감 자
달	달
즐겁다	즐 겁 다
더불어	더 불 어
특성	특 성
베이징	베 이 징
언어	언 어
한글	한 글
박사	박 사
탈출기	탈 출 기
당신들	당 신 들
경기	경 기
시스템	시 스 템
소다	소 다
싱가포르	싱 가 포 르
삼성	삼 성
스페인	스 페 인
의향	의 향
월경	월 경
서커스	서 커 스
진짜	진 짜
웹사이트	웹 사 이 트
제출	제 출
속편	속 편
경기	경 기
한국어	한 국 어
불교	불 교
기아	기 아
보호	보 호
설마	설 마
학부	학 부
너무나	너 무 나
시나리오	시 나 리 오
신학	신 학
삭	삭
위	위
프라이팬	프 라 이 팬
마지막	마 지 막
목소리	목 소 리
맥주	맥 주
마지막	마 지 막
순	순
커피메이커	커 피 메 이 커
라인	라 인
비교적	비 교 적
부동산	부 동 산
내내	내 내
핵	핵
마지막	마 지 막
사회적	사 회 적
관광객	관 광 객
방콕	방 콕
마침	마 침
십자가	십 자 가
장인	장 인
별도	별 도
속도	속 도
처	처
전압	전 압
뮤직	뮤 직
금	금
수상자	수 상 자
솔로	솔 로
사례	사 례
공지	공 지
시대	시 대
여름철	여 름 철
증오	증 오
필수	필 수
엉덩이	엉 덩 이
각주	각 주
허들	허 들
선수	선 수
쇼	쇼
누군가	누 군 가
바이러스	바 이 러 스
동해	동 해
느그	느 그
코로나	코 로 나
도서관	도 서 관
눈알	눈 알
일단	일 단
다문화	다 문 화
맞다	맞 다
웹사이트	웹 사 이 트
그러니까	그 러 니 까
만나다	만 나 다
연못	연 못
방금	방 금
회사	회 사
제휴	제 휴
소개	소 개
공동	공 동
블라인드	블 라 인 드
댓글	댓 글
개입	개 입
XX	X X
선글라스	선 글 라 스
이전	이 전
목사	목 사
나라	나 라
트위터	트 위 터
도난	도 난
공동	공 동
계열	계 열
남쪽	남 쪽
쌀	쌀
최고	최 고
후드	후 드
웨스턴	웨 스 턴
부상	부 상
수출	수 출
남부	남 부
기도	기 도
정상	정 상
없다	없 다
신학	신 학
보고자	보 고 자
유라시아	유 라 시 아
중요	중 요
티켓	티 켓
다문화	다 문 화
순	순
웃음	웃 음
나라	나 라
살	살
오히려	오 히 려
대학생	대 학 생
상식	상 식
전세	전 세
배역	배 역
공식적	공 식 적
도대체	도 대 체
그저	그 저
노선	노 선
계획	계 획
노크	노 크
파일	파 일
묶음	묶 음
최고	최 고
가짜	가 짜
특성	특 성
가죽	가 죽
우려	우 려
상황	상 황
혐의	혐 의
구석구석	구 석 구 석
소개	소 개
댓글	댓 글
모델	모 델
분	분
숙박	숙 박
페이지	페 이 지
피지	피 지
본인	본 인
외면	외 면
빌딩	빌 딩
관문	관 문
본선	본 선
식당	식 당
서서히	서 서 히
변환	변 환
교실	교 실
개정	개 정
부동산	부 동 산
굳이	굳 이
미네소타	미 네 소 타
반짝	반 짝
디자인	디 자 인
고취	고 취
사망	사 망
표범	표 범
흔히	흔 히
핵심	핵 심
사회적	사 회 적
켜다	켜 다
최악	최 악
파일	파 일
인치	인 치
트레이닝	트 레 이 닝
욱	욱
청소년	청 소 년
위증	위 증
전망	전 망
스스로	스 스 로
태그	태 그
망고	망 고
군주	군 주
조금	조 금
공지	공 지
반면	반 면
둘째	둘 째
ㅎㅎ	ㅎ ㅎ
수입	수 입
ㅎㅎ	ㅎ ㅎ
운송	운 송
변동	변 동
분석	분 석
실적	실 적
달리	달 리
둘	둘
후드	후 드
생활용품	생 활 용 품
영역	영 역
복	복
보행자	보 행 자
더불어	더 불 어
예컨대	예 컨 대
소나기	소 나 기
특정	특 정
처	처
요즘	요 즘
위니펙	위 니 펙
제휴	제 휴
탭	탭
귀환	귀 환
분	분
숙박	숙 박
계단	계 단
통화	통 화
돈	돈
이전	이 전
전기	전 기
조작	조 작
수사	수 사
평행	평 행
문제	문 제
대학생	대 학 생
국	국
둘	둘
안과	안 과
공동	공 동
혁신	혁 신
경기도	경 기 도
선언하다	선 언 하 다
아무	아 무
중학교	중 학 교
감미료	감 미 료
콘도르	콘 도 르
롤	롤
댓글	댓 글
부정적	부 정 적
해킹	해 킹
널리	널 리
통산	통 산
상자	상 자
명문	명 문
게스트하우스	게 스 트 하 우 스
부동산	부 동 산
공지	공 지
타	타
한도	한 도
바로가기	바 로 가 기
일광욕	일 광 욕
부문	부 문
중요	중 요
타이어	타 이 어
명주	명 주
후드	후 드
속도	속 도
최저임금	최 저 임 금
파는	파 는
태그	태 그
산업	산 업
목사	목 사
요오드	요 오 드
편	편
몰디브	몰 디 브
누리집	누 리 집
전남	전 남
주인	주 인
위치	위 치
겸	겸
핸드폰	핸 드 폰
서서히	서 서 히
심장	심 장
중요	중 요
도	도
탈	탈
전남	전 남
여	여
경기	경 기
남쪽	남 쪽
사담	사 담
태그	태 그
사이즈	사 이 즈
차량	차 량
인치	인 치
연속	연 속
밥	밥
톱	톱
역도	역 도
스포츠	스 포 츠
베개	베 개
스포츠	스 포 츠
라면	라 면
경상남도	경 상 남 도
뮤직	뮤 직
문제	문 제
조금	조 금
요즘	요 즘
비판	비 판
강원도	강 원 도
변경	변 경
돈	돈
변한	변 한
더불어	더 불 어
조각	조 각
매출	매 출
차	차
각기	각 기
소질	소 질
고객님	고 객 님
메터	메 터
창궐	창 궐
무명	무 명
그렇지	그 렇 지
기둥	기 둥
부활주일	부 활 주 일
모로코	모 로 코
달리	달 리
아시아	아 시 아
자연인	자 연 인
수세미	수 세 미
감각	감 각
이대로	이 대 로
시스템	시 스 템
마지막	마 지 막
조선시대	조 선 시 대
부동산	부 동 산
타입	타 입
라운딩	라 운 딩
성장	성 장
필수	필 수
염려	염 려
박치기	박 치 기
생활용품	생 활 용 품
쪽빛	쪽 빛
필수	필 수
이렇다	이 렇 다
관심	관 심
품질	품 질
손잡이	손 잡 이
식당	식 당
숟가락	숟 가 락
록	록
아니다	아 니 다
주의	주 의
오히려	오 히 려
경호원	경 호 원
사고	사 고
아니다	아 니 다
페이지	페 이 지
연간	연 간
과거	과 거
수취인	수 취 인
한국어	한 국 어
킬로그램	킬 로 그 램
록	록
상황	상 황
적외선	적 외 선
드라마	드 라 마
골프채	골 프 채
갠지스	갠 지 스
소품	소 품
영역	영 역
둘째	둘 째
비교적	비 교 적
보건	보 건
특정	특 정
세금	세 금
마지막	마 지 막
내내	내 내
건축	건 축
하기	하 기
듀엣	듀 엣
유	유
조식	조 식
카메룬	카 메 룬
요	요
속도	속 도
환경	환 경
진출	진 출
마지막	마 지 막
사라지다	사 라 지 다
호평	호 평
스테이크	스 테 이 크
소개	소 개
삼성	삼 성
넷째	넷 째
저런	저 런
상담	상 담
억새	억 새
근대	근 대
여럿	여 럿
차량	차 량
숙박	숙 박
언니	언 니
상황	상 황
민폐	민 폐
점차	점 차
ㅇ	ㅇ
별도	별 도
일정	일 정
공학	공 학
파라다이스	파 라 다 이 스
파견	파 견
스페인어	스 페 인 어
디자인	디 자 인
회	회
어제	어 제
둘	둘
과거	과 거
진짜	진 짜
더불어	더 불 어
장관	장 관
파일	파 일
목재	목 재
쇼	쇼
지지	지 지
하기	하 기
플라스틱	플 라 스 틱
전문가	전 문 가
필	필
낮다	낮 다
목사	목 사
진짜	진 짜
도박	도 박
개방	개 방
취	취
도움	도 움
월요일	월 요 일
제트기	제 트 기
정상	정 상
그리스	그 리 스
도착	도 착
편	편
오트밀	오 트 밀
화장실	화 장 실
사고	사 고
도착	도 착
타워	타 워
비	비
이달	이 달
파일	파 일
광학	광 학
전기	전 기
의료	의 료
들	들
오히려	오 히 려
문제	문 제
시스템	시 스 템
브리핑	브 리 핑
산술	산 술
경기도	경 기 도
디자인	디 자 인
청년	청 년
특성	특 성
응용	응 용
아빠	아 빠
한국어	한 국 어
피해자	피 해 자
행사	행 사
스스로	스 스 로
합의	합 의
고급	고 급
직접적	직 접 적
그렇지	그 렇 지
허용	허 용
영향	영 향
다이아몬드	다 이 아 몬 드
올림픽	올 림 픽
소개	소 개
감자튀김	감 자 튀 김
타입	타 입
빨리	빨 리
묶음	묶 음
은하계	은 하 계
너머로	너 머 로
바로가기	바 로 가 기
음량	음 량
목	목
캐나다	캐 나 다
댓글	댓 글
그거	그 거
오랜만	오 랜 만
내내	내 내
역할	역 할
취소	취 소
솔로	솔 로
사례	사 례
금	금
목적지	목 적 지
빨리	빨 리
사망	사 망
다큐멘터리	다 큐 멘 터 리
마이크로파	마 이 크 로 파
교육학	교 육 학
고대	고 대
살	살
의장	의 장
하기	하 기
왈	왈
영업	영 업
스포츠	스 포 츠
식당	식 당
백	백
빨리	빨 리
수천	수 천
고시	고 시
활활	활 활
앰프	앰 프
액세서리	액 세 서 리
아니다	아 니 다
이민	이 민
늪	늪
분석	분 석
민중	민 중
어렵사리	어 렵 사 리
개정	개 정
자극	자 극
푸틴	푸 틴
필수	필 수
대뇌	대 뇌
단란주점	단 란 주 점
요부	요 부
진짜	진 짜
타	타
희귀	희 귀
빨리	빨 리
연간	연 간
도착	도 착
모닥불	모 닥 불
귀환	귀 환
각기	각 기
제외	제 외
얼굴	얼 굴
구글	구 글
영향	영 향
혐의	혐 의
경기	경 기
숙박	숙 박
이전	이 전
오히려	오 히 려
케이블	케 이 블
공격	공 격
여	여
홍	홍
수다	수 다
목	목
기부	기 부
주택	주 택
초	초
핸들	핸 들
조식	조 식
모델	모 델
중학교	중 학 교
수출	수 출
라인	라 인
백악기	백 악 기
이렇다	이 렇 다
살	살
캐나다	캐 나 다
반면	반 면
타	타
아무런	아 무 런
환경	환 경
댓글	댓 글
밀라노	밀 라 노
사회적	사 회 적
마지막	마 지 막
영주	영 주
숙박	숙 박
연구자	연 구 자
후쿠시마	후 쿠 시 마
공동	공 동
파일	파 일
행사	행 사
성장	성 장
돈	돈
성장	성 장
경기	경 기
부장	부 장
드라마	드 라 마
댓글	댓 글
여	여
모르다	모 르 다
치료	치 료
세월	세 월
ㅎㅎ	ㅎ ㅎ
도착	도 착
영향	영 향
통계	통 계
섬나라	섬 나 라
배경	배 경
하기	하 기
협회	협 회
한글	한 글
음료	음 료
봉착	봉 착
하기	하 기
제압	제 압
아동	아 동
자소서	자 소 서
언어	언 어
장막	장 막
음료	음 료
양말	양 말
공인	공 인
조금	조 금
매	매
성장	성 장
정상	정 상
스스로	스 스 로
소식	소 식
본선	본 선
계급	계 급
에어컨	에 어 컨
메달	메 달
백화점	백 화 점
확률	확 률
동쪽	동 쪽
여름철	여 름 철
에어컨	에 어 컨
소식	소 식
이슬람	이 슬 람
너무나	너 무 나
위치	위 치
혹은	혹 은
재	재
위치	위 치
사설	사 설
핵심	핵 심
스페인	스 페 인
월요일	월 요 일
사회적	사 회 적
일광욕	일 광 욕
박사	박 사
감자	감 자
흰색	흰 색
히트	히 트
비	비
수지	수 지
그저	그 저
수입	수 입
짜장면	짜 장 면
농어	농 어
수풀	수 풀
취소	취 소
벨	벨
케이블	케 이 블
뮤직	뮤 직
속도	속 도
왕자	왕 자
사례	사 례
차림	차 림
망고	망 고
최고	최 고
마우스	마 우 스
플로리다	플 로 리 다
시스템	시 스 템
사회적	사 회 적
요즘	요 즘
버전	버 전
영역	영 역
철새	철 새
바이러스	바 이 러 스
스스로	스 스 로
히트	히 트
고양이	고 양 이
ㅇㅇ	ㅇ ㅇ
전망	전 망
개정	개 정
화보	화 보
랩	랩
동생	동 생
최고	최 고
행사	행 사
조작	조 작
더불어	더 불 어
세네갈	세 네 갈
물건	물 건
가짜	가 짜
주의	주 의
여전히	여 전 히
치료	치 료
반면	반 면
스스로	스 스 로
연속	연 속
간혹	간 혹
상자	상 자
인치	인 치
매체	매 체
숙소	숙 소
성욕	성 욕
무슬림	무 슬 림
지레	지 레
코로나	코 로 나
명소	명 소
금	금
설계	설 계
부문	부 문
진짜	진 짜
별로	별 로
조치	조 치
터널	터 널
부문	부 문
비핵화	비 핵 화
남돌	남 돌
스포츠	스 포 츠
형제자매	형 제 자 매
가득	가 득
글쓰기	글 쓰 기
소식	소 식
곧장	곧 장
하이퍼링크	하 이 퍼 링 크
여기	여 기
-라	- 라
고용	고 용
프러포즈	프 러 포 즈
민감	민 감
황혼	황 혼
비핵화	비 핵 화
강점	강 점
횡성	횡 성
전남	전 남
너무나	너 무 나
수출	수 출
의상	의 상
덜	덜
드라이기	드 라 이 기
엄마	엄 마
조금	조 금
의장	의 장
그거	그 거
여	여
트위터	트 위 터
옷걸이	옷 걸 이
슈트	슈 트
모델	모 델
코로나바이러스	코 로 나 바 이 러 스
삼성	삼 성
링크	링 크
중간	중 간
그릴	그 릴
박사	박 사
그린란드	그 린 란 드
혹은	혹 은
수출	수 출
해요	해 요
카페	카 페
후드	후 드
둘	둘
시스템	시 스 템
사람들	사 람 들
특성	특 성
파라다이스	파 라 다 이 스
아니다	아 니 다
투르크메니스탄	투 르 크 메 니 스 탄
공지	공 지
나라	나 라
누군가	누 군 가
각막	각 막
범주	범 주
독서	독 서
누가	누 가
진짜	진 짜
위	위
탁	탁
굳이	굳 이
기아	기 아
다이어트	다 이 어 트
그만	그 만
합의	합 의
디자인	디 자 인
귀신	귀 신
링크	링 크
불법	불 법
확산	확 산
야채	야 채
경향	경 향
어플	어 플
쐐기	쐐 기
거꾸로	거 꾸 로
음식점	음 식 점
혹은	혹 은
레오	레 오
마스크	마 스 크
조금	조 금
제출	제 출
사회적	사 회 적
처벌	처 벌
솔기	솔 기
아파트	아 파 트
구글	구 글
도대체	도 대 체
밀도	밀 도
화성	화 성
개국	개 국
스페인	스 페 인
사고	사 고
암호	암 호
부동산	부 동 산
부처님	부 처 님
깜짝	깜 짝
이민	이 민
분	분
누가	누 가
옴	옴
누구	누 구
매년	매 년
부정적	부 정 적
목사	목 사
마지막	마 지 막
스스로	스 스 로
목	목
생강	생 강
권	권
ㅇ	ㅇ
드라마	드 라 마
베이징	베 이 징
제작	제 작
처리	처 리
성병	성 병
그날	그 날
디카	디 카
결함	결 함
밥	밥
버전	버 전
전기	전 기
마누라	마 누 라
최고	최 고
스스로	스 스 로
결핵	결 핵
아무런	아 무 런
탐험	탐 험
응용	응 용
위	위
제작	제 작
한글	한 글
덜	덜
장애	장 애
비교적	비 교 적
이전	이 전
스스로	스 스 로
자두	자 두
가변	가 변
타입	타 입
둘째	둘 째
은퇴	은 퇴
동공	동 공
누가	누 가
장구	장 구
여기	여 기
일정	일 정
라인	라 인
종족	종 족
금	금
우엉	우 엉
장사	장 사
애니	애 니
가출	가 출
베이징	베 이 징
전직	전 직
부동산	부 동 산
정치인	정 치 인
그만	그 만
조금	조 금
핵심	핵 심
계	계
영역	영 역
소식	소 식
에스테르	에 스 테 르
굴참나무	굴 참 나 무
계획	계 획
피해자	피 해 자
삼성	삼 성
해요	해 요
트위터	트 위 터
대학생	대 학 생
비타민	비 타 민
세균	세 균
캠퍼스	캠 퍼 스
삼성	삼 성
혐의	혐 의
지구의	지 구 의
아파트	아 파 트
성장	성 장
그저	그 저
핵	핵
매출	매 출
라마	라 마
명인	명 인
건축	건 축
수란	수 란
비교적	비 교 적
기병	기 병
공지	공 지
매출	매 출
스페이스	스 페 이 스
진술	진 술
사탕	사 탕
매년	매 년
별도	별 도
경로	경 로
족집게	족 집 게
문제	문 제
교원	교 원
달리	달 리
의상	의 상
시스템	시 스 템
셋째	셋 째
금전	금 전
샘플	샘 플
정원	정 원
어제	어 제
ㅎㅎ	ㅎ ㅎ
계열	계 열
누가	누 가
살	살
역량	역 량
스포츠	스 포 츠
첨부	첨 부
혹은	혹 은
골키퍼	골 키 퍼
최고	최 고
노인	노 인
도착	도 착
도중	도 중
인증	인 증
주택	주 택
환경오염	환 경 오 염
코로나바이러스	코 로 나 바 이 러 스
후회	후 회
이전	이 전
계	계
수요	수 요
외설	외 설
교원	교 원
혹은	혹 은
시대	시 대
마주	마 주
나라	나 라
모델	모 델
살롱	살 롱
통계	통 계
여전히	여 전 히
새삼	새 삼
반지하	반 지 하
엉엉	엉 엉
포함	포 함
특정	특 정
천자	천 자
이대로	이 대 로
최고	최 고
플라스틱	플 라 스 틱
수출	수 출
시베리아	시 베 리 아
상담	상 담
스스로	스 스 로
손가락	손 가 락
분	분
미	미
분석	분 석
시대	시 대
경	경
때때로	때 때 로
부동산	부 동 산
간장	간 장
파견	파 견
변경	변 경
차	차
자두	자 두
사태	사 태
여기	여 기
야한	야 한
참고	참 고
첨부	첨 부
요	요
목소리	목 소 리
생태계	생 태 계
느티나무	느 티 나 무
이란어	이 란 어
아무	아 무
공격	공 격
삼성	삼 성
낭비	낭 비
탁자	탁 자
가늠	가 늠
삼성	삼 성
친우	친 우
낭독	낭 독
숙박	숙 박
라면	라 면
가불	가 불
뭘	뭘
경기	경 기
도착	도 착
이전	이 전
위치	위 치
인력	인 력
개통	개 통
이중	이 중
수저	수 저
제출	제 출
핵심	핵 심
정체	정 체
커뮤니티	커 뮤 니 티
조금	조 금
특정	특 정
막내	막 내
생존	생 존
둘째	둘 째
종합	종 합
아테나	아 테 나
아티스트	아 티 스 트
인증	인 증
의료	의 료
아무	아 무
녹차	녹 차
초신성	초 신 성
혹은	혹 은
충남	충 남
금	금
조식	조 식
반면	반 면
협회	협 회
끈	끈
해방	해 방
특성	특 성
매년	매 년
비	비
가슴	가 슴
조각	조 각
수입	수 입
무조건	무 조 건
저장	저 장
인부	인 부
뮤지컬	뮤 지 컬
실내악	실 내 악
참고	참 고
새삼	새 삼
일정	일 정
감방	감 방
살	살
연간	연 간
용사	용 사
캠핑	캠 핑
응모자	응 모 자
일본어	일 본 어
다이아몬드	다 이 아 몬 드
쌀	쌀
오르간	오 르 간
너무나	너 무 나
구분	구 분
굽	굽
상자	상 자
반면	반 면
세관	세 관
수없이	수 없 이
사태	사 태
계열	계 열
관계없이	관 계 없 이
아파트	아 파 트
사회적	사 회 적
스스로	스 스 로
순	순
사고	사 고
배급	배 급
의인화	의 인 화
혁신	혁 신
참고	참 고
외환	외 환
인증	인 증
청소년	청 소 년
도박	도 박
북경	북 경
시대	시 대
파일	파 일
유출	유 출
고려	고 려
월요일	월 요 일
주제곡	주 제 곡
차량	차 량
기둥	기 둥
도서관	도 서 관
낫	낫
분	분
별도	별 도
변경	변 경
전시	전 시
사람들	사 람 들
달리	달 리
문헌	문 헌
ㅇㅇ	ㅇ ㅇ
본인	본 인
연애	연 애
사설	사 설
분석	분 석
싱가포르	싱 가 포 르
차량	차 량
특정	특 정
파일	파 일
전치사	전 치 사
광학	광 학
밥	밥
강수량	강 수 량
연간	연 간
전문가	전 문 가
주의	주 의
본선	본 선
널	널
온수	온 수
자외선	자 외 선
보행자	보 행 자
스스로	스 스 로
웃음	웃 음
음모	음 모
조치	조 치
반면	반 면
충전기	충 전 기
하기	하 기
삼촌	삼 촌
보호	보 호
도	도
과거	과 거
진짜	진 짜
성공	성 공
심리	심 리
관심	관 심
이중	이 중
문제	문 제
조금	조 금
식초	식 초
아쉽다	아 쉽 다
취소	취 소
변호사	변 호 사
후드	후 드
화려	화 려
개정	개 정
서쪽	서 쪽
핵심	핵 심
해킹	해 킹
상담	상 담
시스템	시 스 템
도착	도 착
프라이팬	프 라 이 팬
모델	모 델
신어	신 어
어르신	어 르 신
매	매
분	분
회사	회 사
시대	시 대
확률	확 률
뻥	뻥
면접	면 접
버전	버 전
습도	습 도
그게	그 게
보름달	보 름 달
표기	표 기
시대	시 대
가짜	가 짜
사고	사 고
섬광	섬 광
선풍기	선 풍 기
수색	수 색
여전히	여 전 히
캐릭터	캐 릭 터
박사	박 사
배경	배 경
동글동글	동 글 동 글
포로	포 로
종합	종 합
관광	관 광
표기	표 기
케이블	케 이 블
캐나다	캐 나 다
달	달
도박	도 박
댓글	댓 글
으뜸	으 뜸
딸	딸
성장	성 장
케이블	케 이 블
전시	전 시
진짜	진 짜
없다	없 다
수록	수 록
득점	득 점
질문	질 문
액세서리	액 세 서 리
모델	모 델
반짝	반 짝
아시아	아 시 아
르네상스	르 네 상 스
모터	모 터
가짜	가 짜
종합	종 합
은신	은 신
간파	간 파
성장	성 장
임신	임 신
매체	매 체
분리	분 리
관개	관 개
중세	중 세
태그	태 그
물건	물 건
점차	점 차
위	위
도움	도 움
에어컨	에 어 컨
회	회
삼국지	삼 국 지
만능	만 능
장관	장 관
알루미늄	알 루 미 늄
자살	자 살
육군	육 군
기절	기 절
사태	사 태
스페인어	스 페 인 어
핵	핵
위치	위 치
아브라함	아 브 라 함
막대기	막 대 기
콩쿠르	콩 쿠 르
개정	개 정
도움	도 움
일단	일 단
매년	매 년
태그	태 그
아줌마	아 줌 마
견해	견 해
커뮤니티	커 뮤 니 티
학생회	학 생 회
포켓	포 켓
둘	둘
구글	구 글
커뮤니티	커 뮤 니 티
성장	성 장
겨우	겨 우
중개인	중 개 인
생가	생 가
반전	반 전
시댁	시 댁
경기도	경 기 도
3루수	3 루 수
세금	세 금
위치	위 치
서서히	서 서 히
널리	널 리
속도	속 도
시스템	시 스 템
한국어	한 국 어
대피	대 피
표면	표 면
살	살
노선	노 선
서서히	서 서 히
박하	박 하
일꾼	일 꾼
법안	법 안
오작동	오 작 동
사람들	사 람 들
오히려	오 히 려
새벽	새 벽
실적	실 적
성장	성 장
바이러스	바 이 러 스
교	교
일단	일 단
음파	음 파
혹은	혹 은
미	미
클래스	클 래 스
숫자	숫 자
역량	역 량
캐나다	캐 나 다
적극적	적 극 적
돈	돈
백	백
딜	딜
서서히	서 서 히
백설탕	백 설 탕
그렇지	그 렇 지
통계	통 계
랩	랩
브로커	브 로 커
시스템	시 스 템
주지	주 지
핵심	핵 심
전광판	전 광 판
밴쿠버	밴 쿠 버
경주	경 주
과거	과 거
회색	회 색
마지막	마 지 막
혹은	혹 은
유	유
관심	관 심
요즘	요 즘
시카고	시 카 고
랩	랩
소식	소 식
조금	조 금
위	위
백서	백 서
바이트	바 이 트
도대체	도 대 체
박사	박 사
식민	식 민
푸젠	푸 젠
발급	발 급
캐릭터	캐 릭 터
물냉이	물 냉 이
일정	일 정
멜버른	멜 버 른
마우스	마 우 스
설계	설 계
보호	보 호
알루미늄	알 루 미 늄
종합	종 합
여전히	여 전 히
웃음	웃 음
비교적	비 교 적
변경	변 경
남방	남 방
이중	이 중
별도	별 도
몽고메리	몽 고 메 리
변호사	변 호 사
여기	여 기
ㅇㅇ	ㅇ ㅇ
원피스	원 피 스
차	차
대학살	대 학 살
진짜	진 짜
사교	사 교
부탁	부 탁
경기	경 기
청소년	청 소 년
내내	내 내
혹은	혹 은
산업	산 업
조절	조 절
세금	세 금
주택	주 택
조금	조 금
디자인	디 자 인
위	위
가감	가 감
댓글	댓 글
어머님	어 머 님
이주자	이 주 자
풍선	풍 선
분석	분 석
위치	위 치
웃음	웃 음
머물다	머 물 다
필수	필 수
기록	기 록
공지	공 지
제휴	제 휴
비구름	비 구 름
심인성	심 인 성
사례	사 례
금	금
감세	감 세
2루수	2 루 수
진자	진 자
성교	성 교
목	목
오히려	오 히 려
질문	질 문
내내	내 내
음료	음 료
온수	온 수
분	분
의료	의 료
장관	장 관
케이블	케 이 블
간호	간 호
구현	구 현
먼지	먼 지
보행	보 행
금연	금 연
푸틴	푸 틴
과거	과 거
홈런	홈 런
맞다	맞 다
식당	식 당
도	도
심장	심 장
육군	육 군
탑재	탑 재
대회	대 회
롤	롤
혹은	혹 은
핵심	핵 심
도	도
사례	사 례
배급	배 급
매복	매 복
아파트	아 파 트
성장	성 장
이전	이 전
사생아	사 생 아
분석	분 석
정제	정 제
목적지	목 적 지
정원	정 원
아시아	아 시 아
잠수함	잠 수 함
세금	세 금
다행히	다 행 히
농어	농 어
특정	특 정
등장인물	등 장 인 물
일정	일 정
여기	여 기
스페이스	스 페 이 스
진짜	진 짜
아교	아 교
별도	별 도
시리아	시 리 아
박사	박 사
에어컨	에 어 컨
자유	자 유
일정	일 정
분석	분 석
버그	버 그
접속	접 속
행사	행 사
품질	품 질
한글	한 글
보호	보 호
사회적	사 회 적
변호사	변 호 사
임금	임 금
소개	소 개
진짜	진 짜
주택	주 택
호떡	호 떡
애플	애 플
애교	애 교
인삼	인 삼
구글	구 글
케이블	케 이 블
계	계
태그	태 그
새벽	새 벽
유머	유 머
처리	처 리
청년	청 년
도중	도 중
간장	간 장
보호	보 호
시댁	시 댁
요즘	요 즘
친지	친 지
어른	어 른
도움	도 움
탱크	탱 크
도착	도 착
댓글	댓 글
회	회
생존	생 존
가슴	가 슴
주지	주 지
왜곡	왜 곡
수요	수 요
서해	서 해
풀버전	풀 버 전
일본인	일 본 인
폴이	폴 이
벨	벨
사회적	사 회 적
들꽃	들 꽃
변경	변 경
고추장	고 추 장
너무나	너 무 나
가스	가 스
심리학	심 리 학
설계	설 계
음식점	음 식 점
셋째	셋 째
미네소타	미 네 소 타
댓글	댓 글
탐구	탐 구
행사	행 사
댓글	댓 글
확률	확 률
성장	성 장
전사	전 사
흠	흠
인증	인 증
단기	단 기
논문집	논 문 집
계획	계 획
여전히	여 전 히
매출	매 출
지혜	지 혜
불법	불 법
어플	어 플
진짜	진 짜
비	비
산업	산 업
페이지	페 이 지
검정	검 정
소식	소 식
구글	구 글
열람실	열 람 실
여전히	여 전 히
캐릭터	캐 릭 터
이어링	이 어 링
역량	역 량
환경	환 경
조식	조 식
성장	성 장
마스크	마 스 크
지구의	지 구 의
시나리오	시 나 리 오
라면	라 면
회사	회 사
사례	사 례
제작	제 작
무색	무 색
해바라기	해 바 라 기
노력	노 력
푹	푹
기아	기 아
근대	근 대
섭취	섭 취
재질	재 질
조치	조 치
사람들	사 람 들
참고	참 고
올바로	올 바 로
고도	고 도
경기	경 기
가득	가 득
부사관	부 사 관
복서	복 서
보물	보 물
치료	치 료
경고하다	경 고 하 다
뮤지컬	뮤 지 컬
연애	연 애
환경	환 경
비	비
시스템	시 스 템
고민	고 민
오페라	오 페 라
시스템	시 스 템
파파라치	파 파 라 치
세금	세 금
금연	금 연
격리	격 리
미	미
위치	위 치
발전소	발 전 소
가출	가 출
문제	문 제
고려	고 려
치료제	치 료 제
그리스	그 리 스
취소	취 소
공포	공 포
디자인	디 자 인
주택	주 택
핵심	핵 심
긴장	긴 장
기이	기 이
연인	연 인
돈	돈
사례	사 례
재작년	재 작 년
역자	역 자
수사	수 사
마지막	마 지 막
그러니까	그 러 니 까
휴대폰	휴 대 폰
익사	익 사
에어컨	에 어 컨
냉면	냉 면
살롱	살 롱
파라다이스	파 라 다 이 스
구글	구 글
반면	반 면
교	교
마지막	마 지 막
여전히	여 전 히
핵심	핵 심
운송	운 송
승화	승 화
웨스턴	웨 스 턴
별도	별 도
북극해	북 극 해
초	초
웹사이트	웹 사 이 트
가득	가 득
어른	어 른
뮤지컬	뮤 지 컬
사제	사 제
의료	의 료
조금	조 금
매출	매 출
들	들
회사	회 사
돈	돈
월별	월 별
문예	문 예
다행히	다 행 히
전망	전 망
응원	응 원
뉴멕시코	뉴 멕 시 코
주의	주 의
손끝	손 끝
기독교도	기 독 교 도
박스	박 스
케이블	케 이 블
성장	성 장
저장	저 장
조치	조 치
성명서	성 명 서
환경	환 경
교통사고	교 통 사 고
카페	카 페
핵심	핵 심
산업	산 업
타이어	타 이 어
고향	고 향
연못	연 못
층	층
마우스	마 우 스
제작	제 작
행사	행 사
상자	상 자
타	타
혹은	혹 은
배경	배 경
인치	인 치
망고	망 고
일단	일 단
귀양	귀 양
성장	성 장
대왕고래	대 왕 고 래
아동	아 동
전문가	전 문 가
토르	토 르
우크라이나	우 크 라 이 나
응원	응 원
스타킹	스 타 킹
청소기	청 소 기
모니터	모 니 터
수식	수 식
삼성	삼 성
경기	경 기
중간	중 간
탈취제	탈 취 제
이외	이 외
인턴	인 턴
비핵화	비 핵 화
무사	무 사
수출	수 출
불교	불 교
빨리	빨 리
관광	관 광
이란	이 란
침공	침 공
바이러스	바 이 러 스
바로가기	바 로 가 기
르네상스	르 네 상 스
반면	반 면
설렁탕	설 렁 탕
청주	청 주
관심	관 심
이전	이 전
이란	이 란
아파트	아 파 트
포함	포 함
없다	없 다
새벽	새 벽
딴	딴
교원	교 원
무한	무 한
기부	기 부
붕어빵	붕 어 빵
주의	주 의
자율	자 율
바깥	바 깥
일정	일 정
아파트	아 파 트
외환	외 환
금연	금 연
강수량	강 수 량
캠프	캠 프
전남	전 남
통화	통 화
포함	포 함
카페	카 페
고급	고 급
조금	조 금
라면	라 면
예컨대	예 컨 대
유니폼	유 니 폼
특정	특 정
제작	제 작
타이어	타 이 어
아파트	아 파 트
목	목
객체	객 체
상어	상 어
특성	특 성
위생	위 생
매출	매 출
일반인	일 반 인
전망	전 망
애플	애 플
도	도
소각	소 각
칙	칙
지혜	지 혜
과거	과 거
발급	발 급
부하	부 하
기록	기 록
객	객
아무	아 무
고정	고 정
서서히	서 서 히
디자인	디 자 인
도	도
대중가요	대 중 가 요
랩	랩
달리	달 리
없다	없 다
꾸다	꾸 다
월경	월 경
청소년	청 소 년
탑승	탑 승
이달	이 달
겸	겸
포함	포 함
디자인	디 자 인
공수	공 수
불법	불 법
라인	라 인
겸	겸
예시	예 시
뭘	뭘
발급	발 급
위치	위 치
위치	위 치
요즘	요 즘
치료	치 료
코로나	코 로 나
시카고	시 카 고
언어	언 어
기온	기 온
역량	역 량
발전소	발 전 소
자궁	자 궁
위	위
특정	특 정
확률	확 률
고르고	고 르 고
마지막	마 지 막
카페	카 페
눈앞	눈 앞
잉여	잉 여
도착	도 착
계획	계 획
풍속	풍 속
진짜	진 짜
수사	수 사
도움	도 움
자외선	자 외 선
고려	고 려
애플	애 플
계획	계 획
-를	- 를
저장	저 장
혹은	혹 은
아까	아 까
신경	신 경
케이블	케 이 블
윌리엄	윌 리 엄
아이콘	아 이 콘
사치품	사 치 품
재	재
로맨스	로 맨 스
혹은	혹 은
사고	사 고
옥수수	옥 수 수
도움	도 움
카페	카 페
상식	상 식
본선	본 선
영향	영 향
포함	포 함
시대	시 대
아무	아 무
가스	가 스
카페	카 페
기온	기 온
평소	평 소
진언	진 언
깜짝	깜 짝
써	써
샴페인	샴 페 인
변경	변 경
분	분
속임수	속 임 수
회사	회 사
끈	끈
목	목
기꺼이	기 꺼 이
돈	돈
제작	제 작
유머	유 머
커	커
이외	이 외
알루미늄	알 루 미 늄
그렇지	그 렇 지
핵심	핵 심
기도	기 도
요	요
휴대폰	휴 대 폰
그리스	그 리 스
톤	톤
분석	분 석
악센트	악 센 트
조금	조 금
아무	아 무
카자흐스탄	카 자 흐 스 탄
확률	확 률
청진	청 진
소매점	소 매 점
일단	일 단
보호	보 호
분석	분 석
층	층
소개	소 개
전망	전 망
노인	노 인
실재	실 재
까먹다	까 먹 다
관광	관 광
실책	실 책
검정	검 정
싱가포르	싱 가 포 르
에어컨	에 어 컨
재산	재 산
대단히	대 단 히
휴대폰	휴 대 폰
백	백
휴게실	휴 게 실
아티스트	아 티 스 트
듀엣	듀 엣
선수	선 수
아나운서	아 나 운 서
빈뇨	빈 뇨
뮤직	뮤 직
숙박	숙 박
일정	일 정
다스	다 스
기온	기 온
각기	각 기
달	달
점수	점 수
만나다	만 나 다
도	도
점차	점 차
둘	둘
달	달
전망	전 망
산업	산 업
명소	명 소
식비	식 비
금	금
포함	포 함
잡초	잡 초
부서	부 서
상무	상 무
계열	계 열
댓글	댓 글
가스	가 스
조금	조 금
분석	분 석
달리	달 리
스스로	스 스 로
열정	열 정
청소기	청 소 기
빨리	빨 리
롤	롤
건축	건 축
사회적	사 회 적
모니터	모 니 터
도대체	도 대 체
해물	해 물
제작	제 작
후퇴	후 퇴
이슬람	이 슬 람
배급	배 급
마니	마 니
점차	점 차
심해	심 해
아이다	아 이 다
음식점	음 식 점
여전히	여 전 히
주지	주 지
커뮤니티	커 뮤 니 티
공격	공 격
달리	달 리
없다	없 다
불법	불 법
재	재
최고	최 고
싱크탱크	싱 크 탱 크
다이어트	다 이 어 트
황혼	황 혼
혹은	혹 은
검정	검 정
잡기	잡 기
시스템	시 스 템
구현	구 현
박사	박 사
표기	표 기
조금	조 금
소피아	소 피 아
덜	덜
빨리	빨 리
말기	말 기
대저	대 저
영역	영 역
이중	이 중
매년	매 년
습도	습 도
해고	해 고
명소	명 소
음식점	음 식 점
하기	하 기
공동	공 동
최고	최 고
유로	유 로
법안	법 안
요즘	요 즘
캐릭터	캐 릭 터
아시아	아 시 아
남쪽	남 쪽
흉내	흉 내
책들	책 들
분석	분 석
후드	후 드
계	계
간호	간 호
믿음	믿 음
남부	남 부
타워	타 워
안과	안 과
마지막	마 지 막
경기	경 기
페이지	페 이 지
형법	형 법
포함	포 함
오히려	오 히 려
엄마	엄 마
캐나다	캐 나 다
록	록
분	분
강점기	강 점 기
핵	핵
사례	사 례
플루오르	플 루 오 르
관광	관 광
자외선	자 외 선
돈	돈
방콕	방 콕
비	비
너무나	너 무 나
백업	백 업
사회적	사 회 적
고급	고 급
살	살
이란	이 란
한마디	한 마 디
방콕	방 콕
아빠	아 빠
제작	제 작
임신	임 신
끝말잇기	끝 말 잇 기
매년	매 년
아랫사람	아 랫 사 람
사상가	사 상 가
원곡	원 곡
램프	램 프
회사	회 사
경기도	경 기 도
비추다	비 추 다
협회	협 회
삼성	삼 성
몽고메리	몽 고 메 리
재	재
다행히	다 행 히
진출	진 출
미	미
은하수	은 하 수
발급	발 급
전시	전 시
티켓	티 켓
계열	계 열
아자	아 자
진짜	진 짜
가짜	가 짜
이전	이 전
분석	분 석
소개	소 개
얼굴	얼 굴
중학교	중 학 교
산소	산 소
인치	인 치
딸	딸
스포츠	스 포 츠
의회	의 회
선수	선 수
오히려	오 히 려
본선	본 선
사망	사 망
사회적	사 회 적
무섭다	무 섭 다
라인	라 인
특정	특 정
히트	히 트
목소리	목 소 리
커	커
도	도
감자	감 자
인식	인 식
겸	겸
일정	일 정
다행히	다 행 히
비판	비 판
땀	땀
밥	밥
아이콘	아 이 콘
상호작용	상 호 작 용
전남	전 남
핀치	핀 치
숙박	숙 박
창원	창 원
산업	산 업
회사	회 사
웹사이트	웹 사 이 트
핵	핵
기록	기 록
하기	하 기
누군가	누 군 가
스포츠	스 포 츠
차마	차 마
전망	전 망
월요일	월 요 일
진짜	진 짜
공학	공 학
어플리케이션	어 플 리 케 이 션
누가	누 가
변함없이	변 함 없 이
자소서	자 소 서
누가	누 가
관계없이	관 계 없 이
디자인	디 자 인
특별	특 별
모터	모 터
임신	임 신
질문	질 문
댓글	댓 글
문제	문 제
중세	중 세
연결	연 결
통찰력	통 찰 력
근대	근 대
국	국
어플리케이션	어 플 리 케 이 션
피임약	피 임 약
별로	별 로
우리들	우 리 들
충남	충 남
조금	조 금
진짜	진 짜
안녕하십니까	안 녕 하 십 니 까
세금	세 금
굳이	굳 이
변경	변 경
심해	심 해
반면	반 면
매년	매 년
위	위
기아	기 아
특정	특 정
경기도	경 기 도
탭	탭
연간	연 간
특별	특 별
연결	연 결
수십	수 십
연필	연 필
목	목
얼굴	얼 굴
액세서리	액 세 서 리
하기	하 기
주가	주 가
한국어	한 국 어
철거	철 거
전차	전 차
댓글	댓 글
돈	돈
셋째	셋 째
매년	매 년
가운뎃소리	가 운 뎃 소 리
별로	별 로
비	비
굽	굽
신경	신 경
흔히	흔 히
플라스틱	플 라 스 틱
의료	의 료
소음	소 음
파라다이스	파 라 다 이 스
목	목
다이아몬드	다 이 아 몬 드
바로가기	바 로 가 기
특별	특 별
너무나	너 무 나
스크랩	스 크 랩
경로	경 로
혹은	혹 은
탐험	탐 험
과거	과 거
불도저	불 도 저
주택	주 택
진짜	진 짜
막부	막 부
금연	금 연
주의	주 의
플로리다	플 로 리 다
아나운서	아 나 운 서
건조기	건 조 기
관광	관 광
일정	일 정
벽돌	벽 돌
엄마	엄 마
커뮤니티	커 뮤 니 티
하기	하 기
살	살
어른	어 른
굳이	굳 이
달리	달 리
비	비
나라	나 라
아산	아 산
가짜	가 짜
과거	과 거
가득	가 득
취소	취 소
밴쿠버	밴 쿠 버
이대로	이 대 로
티켓	티 켓
점포	점 포
시루	시 루
아파트	아 파 트
해킹	해 킹
좌우	좌 우
확률	확 률
차	차
손상	손 상
모델	모 델
소득	소 득
연결	연 결
포함	포 함
만두국	만 두 국
썰	썰
부동산	부 동 산
불법	불 법
부동산	부 동 산
타살	타 살
점차	점 차
비판	비 판
내내	내 내
제휴	제 휴
점수	점 수
출판	출 판
아시아	아 시 아
집안	집 안
이중	이 중
품질	품 질
너무나	너 무 나
아동	아 동
선수	선 수
링크	링 크
처리	처 리
스포츠	스 포 츠
이달	이 달
랑	랑
마른	마 른
정성	정 성
간혹	간 혹
의료	의 료
붕어빵	붕 어 빵
강원도	강 원 도
명란	명 란
ㅎㅎ	ㅎ ㅎ
가을철	가 을 철
급여	급 여
반면	반 면
디자인	디 자 인
