กระถาง	ก ร ะ ถ า ง
ฤาษี	ฤ า ษ ี
การตั้งครรภ์	ก า ร ต ั ้ ง ค ร ร ภ ์
กริยาวิเศษณ์	ก ร ิ ย า ว ิ เ ศ ษ ณ ์
อสุจิ	อ ส ุ จ ิ
ราบัต	ร า บ ั ต
บัลลาสต์	บ ั ล ล า ส ต ์
เก้าเหลี่ยม	เ ก ้ า เ ห ล ี ่ ย ม
ขยับ	ข ย ั บ
เน็กไท	เ น ็ ก ไ ท
เทศมนตรี	เ ท ศ ม น ต ร ี
ตุลาการภิวัตน์	ต ุ ล า ก า ร ภ ิ ว ั ต น ์
ปริ้นเตอร์	ป ร ิ ้ น เ ต อ ร ์
ยมฑูต	ย ม ฑ ู ต
กลองชุด	ก ล อ ง ช ุ ด
โทษะ	โ ท ษ ะ
ทึ่ม	ท ึ ่ ม
น้ำส้มสายชู	น ้ ำ ส ้ ม ส า ย ช ู
อาร์กติก	อ า ร ์ ก ต ิ ก
บ่าว	บ ่ า ว
ซุ้ม	ซ ุ ้ ม
เนื้อเยื่อเกี่ยวพัน	เ น ื ้ อ เ ย ื ่ อ เ ก ี ่ ย ว พ ั น
เป็นลม	เ ป ็ น ล ม
ความกลัว	ค ว า ม ก ล ั ว
กับข้าว	ก ั บ ข ้ า ว
ภัสสะ	ภ ั ส ส ะ
รากษส	ร า ก ษ ส
เวอร์มอนต์	เ ว อ ร ์ ม อ น ต ์
พิมพ์	พ ิ ม พ ์
คิชฌะ	ค ิ ช ฌ ะ
อุทธรณ์	อ ุ ท ธ ร ณ ์
เอาแต่ใจ	เ อ า แ ต ่ ใ จ
แมวทราย	แ ม ว ท ร า ย
เกลา	เ ก ล า
ตะขาบ	ต ะ ข า บ
เคียว	เ ค ี ย ว
บทนำ	บ ท น ำ
กล้ามเนื้อเรียบ	ก ล ้ า ม เ น ื ้ อ เ ร ี ย บ
เส้นรอบวง	เ ส ้ น ร อ บ ว ง
สาปส่ง	ส า ป ส ่ ง
เสด็จพระราชสมภพ	เ ส ด ็ จ พ ร ะ ร า ช ส ม ภ พ
นมแมว	น ม แ ม ว
เครื่องดื่มชูกำลัง	เ ค ร ื ่ อ ง ด ื ่ ม ช ู ก ำ ล ั ง
คนกลาง	ค น ก ล า ง
กระต่ายหมายจันทร์	ก ร ะ ต ่ า ย ห ม า ย จ ั น ท ร ์
เปียงยาง	เ ป ี ย ง ย า ง
ทุกข์ร้อน	ท ุ ก ข ์ ร ้ อ น
หอยเป๋าฮื้อ	ห อ ย เ ป ๋ า ฮ ื ้ อ
สวะ	ส ว ะ
แมสก์	แ ม ส ก ์
เอี๊ยม	เ อ ี ๊ ย ม
ปลิงทะเล	ป ล ิ ง ท ะ เ ล
รูจมูก	ร ู จ ม ู ก
ย้อนแย้ง	ย ้ อ น แ ย ้ ง
เด๊ดสะมอเร่	เ ด ๊ ด ส ะ ม อ เ ร ่
อาราม	อ า ร า ม
ลมบ้าหมู	ล ม บ ้ า ห ม ู
ช่างไม้	ช ่ า ง ไ ม ้
พิษสุนัขบ้า	พ ิ ษ ส ุ น ั ข บ ้ า
จงรักภักดี	จ ง ร ั ก ภ ั ก ด ี
รูบิเดียม	ร ู บ ิ เ ด ี ย ม
สัตว์กินพืช	ส ั ต ว ์ ก ิ น พ ื ช
เมถุน	เ ม ถ ุ น
การช่วยตัวเอง	ก า ร ช ่ ว ย ต ั ว เ อ ง
ดับเบิลเบส	ด ั บ เ บ ิ ล เ บ ส
นาคร	น า ค ร
ไข้รากสาดน้อย	ไ ข ้ ร า ก ส า ด น ้ อ ย
ค่าจ้าง	ค ่ า จ ้ า ง
ออส่วน	อ อ ส ่ ว น
การต่อรอง	ก า ร ต ่ อ ร อ ง
ฉวย	ฉ ว ย
ผักกาด	ผ ั ก ก า ด
หอคอยงาช้าง	ห อ ค อ ย ง า ช ้ า ง
การไล่ตามติดพัน	ก า ร ไ ล ่ ต า ม ต ิ ด พ ั น
การจับผิด	ก า ร จ ั บ ผ ิ ด
ความชั่วช้า	ค ว า ม ช ั ่ ว ช ้ า
คบเพลิง	ค บ เ พ ล ิ ง
มงลง	ม ง ล ง
ข้าวขาหมู	ข ้ า ว ข า ห ม ู
ลัทธิคอมมิวนิสต์	ล ั ท ธ ิ ค อ ม ม ิ ว น ิ ส ต ์
เกย	เ ก ย
ข้าวโอ๊ต	ข ้ า ว โ อ ๊ ต
จุดลูกน้ำ	จ ุ ด ล ู ก น ้ ำ
รอยสัก	ร อ ย ส ั ก
ก็แล้วกัน	ก ็ แ ล ้ ว ก ั น
โฆษณาชวนเชื่อ	โ ฆ ษ ณ า ช ว น เ ช ื ่ อ
เบงกาลี	เ บ ง ก า ล ี
สารบัญ	ส า ร บ ั ญ
ดินแดนแทรก	ด ิ น แ ด น แ ท ร ก
ดองเปรี้ยวดองเค็ม	ด อ ง เ ป ร ี ้ ย ว ด อ ง เ ค ็ ม
หินหลอมเหลว	ห ิ น ห ล อ ม เ ห ล ว
สิ่งมีชีวิต	ส ิ ่ ง ม ี ช ี ว ิ ต
ญวน	ญ ว น
การลงมือ	ก า ร ล ง ม ื อ
หมุด	ห ม ุ ด
เครื่องควบแน่น	เ ค ร ื ่ อ ง ค ว บ แ น ่ น
กัลปาวสาน	ก ั ล ป า ว ส า น
ลูกสูบ	ล ู ก ส ู บ
ความอึด	ค ว า ม อ ึ ด
อนันต์	อ น ั น ต ์
ข้าวกลางวัน	ข ้ า ว ก ล า ง ว ั น
พิหค	พ ิ ห ค
แม่นม	แ ม ่ น ม
อติชน	อ ต ิ ช น
สหพันธ์	ส ห พ ั น ธ ์
บ่าง	บ ่ า ง
ศิวิไลซ์	ศ ิ ว ิ ไ ล ซ ์
ครูบาอาจารย์	ค ร ู บ า อ า จ า ร ย ์
เสล่อ	เ ส ล ่ อ
ลอยตัว	ล อ ย ต ั ว
จ้อง	จ ้ อ ง
เอ็มบริโอ	เ อ ็ ม บ ร ิ โ อ
เมธังกร	เ ม ธ ั ง ก ร
การกัดกร่อน	ก า ร ก ั ด ก ร ่ อ น
หอบ	ห อ บ
จันทน์เทศ	จ ั น ท น ์ เ ท ศ
ความเป็นผู้นำ	ค ว า ม เ ป ็ น ผ ู ้ น ำ
ล่มจม	ล ่ ม จ ม
ความร้อนรน	ค ว า ม ร ้ อ น ร น
แคนตาลูป	แ ค น ต า ล ู ป
ฝาแฝด	ฝ า แ ฝ ด
เลนส์สัมผัส	เ ล น ส ์ ส ั ม ผ ั ส
บันเลง	บ ั น เ ล ง
เจี๋ยมเจี้ยม	เ จ ี ๋ ย ม เ จ ี ้ ย ม
ซอฟต์เสิร์ฟ	ซ อ ฟ ต ์ เ ส ิ ร ์ ฟ
ฟีจี	ฟ ี จ ี
หลอนหู	ห ล อ น ห ู
การเทศนา	ก า ร เ ท ศ น า
คาถา	ค า ถ า
เหิน	เ ห ิ น
คฤห	ค ฤ ห
โกนาคมน	โ ก น า ค ม น
ตอบโต้	ต อ บ โ ต ้
ร่าเริง	ร ่ า เ ร ิ ง
ประเวศน์พระนคร	ป ร ะ เ ว ศ น ์ พ ร ะ น ค ร
ทุ่งนา	ท ุ ่ ง น า
บัตเตอร์สกอตช์	บ ั ต เ ต อ ร ์ ส ก อ ต ช ์
สิ่งแวดล้อม	ส ิ ่ ง แ ว ด ล ้ อ ม
ดีรัจฉาน	ด ี ร ั จ ฉ า น
นั่งร้าน	น ั ่ ง ร ้ า น
ถังแตก	ถ ั ง แ ต ก
ค่าคงที่	ค ่ า ค ง ท ี ่
หัวแม่มือ	ห ั ว แ ม ่ ม ื อ
นาคปรก	น า ค ป ร ก
อากาศพลศาสตร์	อ า ก า ศ พ ล ศ า ส ต ร ์
หน้าฝน	ห น ้ า ฝ น
กำแพงเพชร	ก ำ แ พ ง เ พ ช ร
แบบแผน	แ บ บ แ ผ น
บุรุนดี	บ ุ ร ุ น ด ี
ขัดเกลา	ข ั ด เ ก ล า
ต้มจับฉ่าย	ต ้ ม จ ั บ ฉ ่ า ย
อาขยาน	อ า ข ย า น
ชิงช้าสวรรค์	ช ิ ง ช ้ า ส ว ร ร ค ์
นักไวโอลิน	น ั ก ไ ว โ อ ล ิ น
เมษปิศาจ	เ ม ษ ป ิ ศ า จ
เม้าท์มอย	เ ม ้ า ท ์ ม อ ย
พิราบ	พ ิ ร า บ
เส้นเสียง	เ ส ้ น เ ส ี ย ง
จ้ำจี้	จ ้ ำ จ ี ้
โรคติดต่อทางเพศสัมพันธ์	โ ร ค ต ิ ด ต ่ อ ท า ง เ พ ศ ส ั ม พ ั น ธ ์
มัดจำ	ม ั ด จ ำ
เหน่อ	เ ห น ่ อ
รายจ่าย	ร า ย จ ่ า ย
ข้าวเย็น	ข ้ า ว เ ย ็ น
ลูกช้าง	ล ู ก ช ้ า ง
การปฏิวัติ	ก า ร ป ฏ ิ ว ั ต ิ
หน้าผาก	ห น ้ า ผ า ก
แคริบเบียน	แ ค ร ิ บ เ บ ี ย น
วัสดุก่อสร้าง	ว ั ส ด ุ ก ่ อ ส ร ้ า ง
ชอปปิ้ง	ช อ ป ป ิ ้ ง
อัศว	อ ั ศ ว
แบงค์กาโม่	แ บ ง ค ์ ก า โ ม ่
มายากล	ม า ย า ก ล
การตอนกิ่ง	ก า ร ต อ น ก ิ ่ ง
ความใคร่	ค ว า ม ใ ค ร ่
ถามไถ่	ถ า ม ไ ถ ่
นิมิต	น ิ ม ิ ต
ถูกปาก	ถ ู ก ป า ก
เบิกความ	เ บ ิ ก ค ว า ม
น้ำส้มพริกดอง	น ้ ำ ส ้ ม พ ร ิ ก ด อ ง
ลำไย	ล ำ ไ ย
จอสัมผัส	จ อ ส ั ม ผ ั ส
การบาน	ก า ร บ า น
โอ๊ต	โ อ ๊ ต
สงบสุข	ส ง บ ส ุ ข
น้ำค้าง	น ้ ำ ค ้ า ง
นิว	น ิ ว
ดามัสกัส	ด า ม ั ส ก ั ส
คริสต์มาส	ค ร ิ ส ต ์ ม า ส
รัทเทอร์ฟอร์เดียม	ร ั ท เ ท อ ร ์ ฟ อ ร ์ เ ด ี ย ม
โป๊กเกอร์	โ ป ๊ ก เ ก อ ร ์
ซุ่ม	ซ ุ ่ ม
วรสาร	ว ร ส า ร
เพื่อนร่วมห้อง	เ พ ื ่ อ น ร ่ ว ม ห ้ อ ง
สภาล่าง	ส ภ า ล ่ า ง
หัวโปก	ห ั ว โ ป ก
มุขยประโยค	ม ุ ข ย ป ร ะ โ ย ค
หอกซัด	ห อ ก ซ ั ด
แจซซ์	แ จ ซ ซ ์
น่าอยู่	น ่ า อ ย ู ่
สินธุ์	ส ิ น ธ ุ ์
การทูต	ก า ร ท ู ต
กะลอจี๊	ก ะ ล อ จ ี ๊
ความอัปยศ	ค ว า ม อ ั ป ย ศ
เมื่อไร	เ ม ื ่ อ ไ ร
ยูโรเพียม	ย ู โ ร เ พ ี ย ม
ตัวกั้นระหว่างเลือดกับสมอง	ต ั ว ก ั ้ น ร ะ ห ว ่ า ง เ ล ื อ ด ก ั บ ส ม อ ง
ผศ.	ผ ศ .
พาราโบลา	พ า ร า โ บ ล า
พนง.	พ น ง .
โลด	โ ล ด
ฝ่าบาท	ฝ ่ า บ า ท
น่าสงสาร	น ่ า ส ง ส า ร
หน้าเลือด	ห น ้ า เ ล ื อ ด
กันย์	ก ั น ย ์
การเจอ	ก า ร เ จ อ
เข้าข้าง	เ ข ้ า ข ้ า ง
หมิ่นประมาท	ห ม ิ ่ น ป ร ะ ม า ท
สะดุ้ง	ส ะ ด ุ ้ ง
ดูชานเบ	ด ู ช า น เ บ
หวด	ห ว ด
ตลิ่ง	ต ล ิ ่ ง
นักแต่งกลอน	น ั ก แ ต ่ ง ก ล อ น
แม่น้ำโขง	แ ม ่ น ้ ำ โ ข ง
เสพย์	เ ส พ ย ์
หวล	ห ว ล
สันดาบ	ส ั น ด า บ
โวลเตจ	โ ว ล เ ต จ
ความผอม	ค ว า ม ผ อ ม
แป้ก	แ ป ้ ก
รมต.	ร ม ต .
เอริเทรีย	เ อ ร ิ เ ท ร ี ย
ภูมิศาสตร์การเมือง	ภ ู ม ิ ศ า ส ต ร ์ ก า ร เ ม ื อ ง
สันดอน	ส ั น ด อ น
ดอกฟ้า	ด อ ก ฟ ้ า
วงพาด	ว ง พ า ด
ซี้	ซ ี ้
กระท่อม	ก ร ะ ท ่ อ ม
แหม	แ ห ม
ปรอท	ป ร อ ท
เสียน้ำใจ	เ ส ี ย น ้ ำ ใ จ
บัตรเครดิต	บ ั ต ร เ ค ร ด ิ ต
หัวดับเพลิง	ห ั ว ด ั บ เ พ ล ิ ง
การสัมผัส	ก า ร ส ั ม ผ ั ส
ธรรมกถา	ธ ร ร ม ก ถ า
ก้านควบคุม	ก ้ า น ค ว บ ค ุ ม
ดุดัน	ด ุ ด ั น
ไซบีเรีย	ไ ซ บ ี เ ร ี ย
หมีหมา	ห ม ี ห ม า
นิ้วโป้ง	น ิ ้ ว โ ป ้ ง
ขอบใจ	ข อ บ ใ จ
ทรัพยสิทธิ	ท ร ั พ ย ส ิ ท ธ ิ
นักบิน	น ั ก บ ิ น
อิลลินอยส์	อ ิ ล ล ิ น อ ย ส ์
ขโยง	ข โ ย ง
มิคะ	ม ิ ค ะ
ไส้เลื่อน	ไ ส ้ เ ล ื ่ อ น
ซื่อตรง	ซ ื ่ อ ต ร ง
ดุจ	ด ุ จ
ประจวบคีรีขันธ์	ป ร ะ จ ว บ ค ี ร ี ข ั น ธ ์
ขุนดาบ	ข ุ น ด า บ
เอาคืน	เ อ า ค ื น
รามายณะ	ร า ม า ย ณ ะ
มินต์	ม ิ น ต ์
ทฤษฎีสมคบคิด	ท ฤ ษ ฎ ี ส ม ค บ ค ิ ด
วาทะกรรม	ว า ท ะ ก ร ร ม
โลกาภิวัตน์	โ ล ก า ภ ิ ว ั ต น ์
ม่านตา	ม ่ า น ต า
โอเชียเนีย	โ อ เ ช ี ย เ น ี ย
เส้นทาง	เ ส ้ น ท า ง
พรรค์	พ ร ร ค ์
ประวัติการณ์	ป ร ะ ว ั ต ิ ก า ร ณ ์
แม็กนีเซียม	แ ม ็ ก น ี เ ซ ี ย ม
ตอนเย็น	ต อ น เ ย ็ น
พแนงเชีง	พ แ น ง เ ช ี ง
ปักษิน	ป ั ก ษ ิ น
ละแวก	ล ะ แ ว ก
การชี้แจง	ก า ร ช ี ้ แ จ ง
ทะลุ	ท ะ ล ุ
กาญจนา	ก า ญ จ น า
ปืนกลมือ	ป ื น ก ล ม ื อ
ความมั่ว	ค ว า ม ม ั ่ ว
อัตตาธิปไตย	อ ั ต ต า ธ ิ ป ไ ต ย
บัตรผ่านขึ้นเครื่อง	บ ั ต ร ผ ่ า น ข ึ ้ น เ ค ร ื ่ อ ง
เห็นแก่	เ ห ็ น แ ก ่
เขย่ง	เ ข ย ่ ง
ปทท.	ป ท ท .
ดั่ง	ด ั ่ ง
ข่าวลือ	ข ่ า ว ล ื อ
อสุภ	อ ส ุ ภ
ขุย	ข ุ ย
เหมือง	เ ห ม ื อ ง
ตัวหนอน	ต ั ว ห น อ น
เต็นท์	เ ต ็ น ท ์
เรียม	เ ร ี ย ม
จาบ	จ า บ
การกรอง	ก า ร ก ร อ ง
นักประดิษฐ์	น ั ก ป ร ะ ด ิ ษ ฐ ์
การหัวเราะ	ก า ร ห ั ว เ ร า ะ
บรเทศ	บ ร เ ท ศ
เงินเฟ้อ	เ ง ิ น เ ฟ ้ อ
กำมะหยี่	ก ำ ม ะ ห ย ี ่
นฤมิต	น ฤ ม ิ ต
ครีมกันแดด	ค ร ี ม ก ั น แ ด ด
กลุ่มกระจุกดาราจักร	ก ล ุ ่ ม ก ร ะ จ ุ ก ด า ร า จ ั ก ร
บ้วน	บ ้ ว น
วิทยาการระบาด	ว ิ ท ย า ก า ร ร ะ บ า ด
กล้องถ่ายรูป	ก ล ้ อ ง ถ ่ า ย ร ู ป
ปะระโลกย	ป ะ ร ะ โ ล ก ย
การถวาย	ก า ร ถ ว า ย
เพียง	เ พ ี ย ง
ไซเรน	ไ ซ เ ร น
หมูกรอบ	ห ม ู ก ร อ บ
มารผจญ	ม า ร ผ จ ญ
มะยม	ม ะ ย ม
ลานีญา	ล า น ี ญ า
กินเด็ก	ก ิ น เ ด ็ ก
ความกินใจ	ค ว า ม ก ิ น ใ จ
ฟาย	ฟ า ย
น้ำท่า	น ้ ำ ท ่ า
ปอร์โต-โนโว	ป อ ร ์ โ ต - โ น โ ว
สื่อลามกอนาจาร	ส ื ่ อ ล า ม ก อ น า จ า ร
กระดูกแข้ง	ก ร ะ ด ู ก แ ข ้ ง
โปรดติดตามตอนต่อไป	โ ป ร ด ต ิ ด ต า ม ต อ น ต ่ อ ไ ป
เอเชียอาคเนย์	เ อ เ ช ี ย อ า ค เ น ย ์
เหมันต์	เ ห ม ั น ต ์
ขุนค้อน	ข ุ น ค ้ อ น
โกณฑัญญะ	โ ก ณ ฑ ั ญ ญ ะ
ตระกูลภาษา	ต ร ะ ก ู ล ภ า ษ า
โชคชะตา	โ ช ค ช ะ ต า
คราง	ค ร า ง
เบงกอล	เ บ ง ก อ ล
เมรุ	เ ม ร ุ
ต้นหน	ต ้ น ห น
อิหม่าม	อ ิ ห ม ่ า ม
ธนู	ธ น ู
ตอด	ต อ ด
จิงโจ้น้ำ	จ ิ ง โ จ ้ น ้ ำ
โคลอมเบีย	โ ค ล อ ม เ บ ี ย
บรัสเซลส์	บ ร ั ส เ ซ ล ส ์
หยิ่ง	ห ย ิ ่ ง
ตรีศูล	ต ร ี ศ ู ล
นาฬิกาข้อมือ	น า ฬ ิ ก า ข ้ อ ม ื อ
ความมั่งคั่ง	ค ว า ม ม ั ่ ง ค ั ่ ง
คำทับศัพท์	ค ำ ท ั บ ศ ั พ ท ์
วัตถุนิยม	ว ั ต ถ ุ น ิ ย ม
ปมด้อย	ป ม ด ้ อ ย
วัจมรรค	ว ั จ ม ร ร ค
กางเกงใน	ก า ง เ ก ง ใ น
เสียดสี	เ ส ี ย ด ส ี
แรงตึงผิว	แ ร ง ต ึ ง ผ ิ ว
นิรโทษกรรม	น ิ ร โ ท ษ ก ร ร ม
สันดร	ส ั น ด ร
สุจิตรา	ส ุ จ ิ ต ร า
เลสเบี้ยน	เ ล ส เ บ ี ้ ย น
นักล้วงกระเป๋า	น ั ก ล ้ ว ง ก ร ะ เ ป ๋ า
ตาบอด	ต า บ อ ด
ชู้สาว	ช ู ้ ส า ว
คำขวัญ	ค ำ ข ว ั ญ
คอร์ด	ค อ ร ์ ด
ม้าลาย	ม ้ า ล า ย
ตีพิมพ์	ต ี พ ิ ม พ ์
เศรษฐีนี	เ ศ ร ษ ฐ ี น ี
ผ้าพันแผล	ผ ้ า พ ั น แ ผ ล
ไรเฟิล	ไ ร เ ฟ ิ ล
ข้าราชการตุลาการ	ข ้ า ร า ช ก า ร ต ุ ล า ก า ร
คอด	ค อ ด
แบบสอบถาม	แ บ บ ส อ บ ถ า ม
อนุภาค	อ น ุ ภ า ค
รฦก	ร ฦ ก
นักดนตรี	น ั ก ด น ต ร ี
ฝาย	ฝ า ย
ผู้หลักผู้ใหญ่	ผ ู ้ ห ล ั ก ผ ู ้ ใ ห ญ ่
ไอศวรรย์	ไ อ ศ ว ร ร ย ์
การอัญเชิญ	ก า ร อ ั ญ เ ช ิ ญ
สระน้ำ	ส ร ะ น ้ ำ
ให้สัญญา	ใ ห ้ ส ั ญ ญ า
แผลเป็น	แ ผ ล เ ป ็ น
แสนปม	แ ส น ป ม
ทวิตเตอร์	ท ว ิ ต เ ต อ ร ์
ปล่อยวาง	ป ล ่ อ ย ว า ง
การเพาะ	ก า ร เ พ า ะ
ความร้อน	ค ว า ม ร ้ อ น
ความพิโรธ	ค ว า ม พ ิ โ ร ธ
กล้วยไม้	ก ล ้ ว ย ไ ม ้
ทุ่นแรง	ท ุ ่ น แ ร ง
คางคก	ค า ง ค ก
ทบิลีซี	ท บ ิ ล ี ซ ี
ยี่สิบเอ็ด	ย ี ่ ส ิ บ เ อ ็ ด
คอก	ค อ ก
ครู	ค ร ู
เกลียดชัง	เ ก ล ี ย ด ช ั ง
นักขัต	น ั ก ข ั ต
พุทธศาสนิกชน	พ ุ ท ธ ศ า ส น ิ ก ช น
การฉิบหาย	ก า ร ฉ ิ บ ห า ย
ปาด	ป า ด
วาจา	ว า จ า
เผ็ดร้อน	เ ผ ็ ด ร ้ อ น
ตะปู	ต ะ ป ู
สับปะรด	ส ั บ ป ะ ร ด
แกมเบีย	แ ก ม เ บ ี ย
สูญ	ส ู ญ
คร่อม	ค ร ่ อ ม
แก้วตาโบ๋	แ ก ้ ว ต า โ บ ๋
ทรงพระกรุณา	ท ร ง พ ร ะ ก ร ุ ณ า
พวกคุณ	พ ว ก ค ุ ณ
ซูรินาเม	ซ ู ร ิ น า เ ม
โรคศิลปะ	โ ร ค ศ ิ ล ป ะ
ปืนลูกซอง	ป ื น ล ู ก ซ อ ง
ตีลังกา	ต ี ล ั ง ก า
ฦกซึ้ง	ฦ ก ซ ึ ้ ง
ชาวเน็ท	ช า ว เ น ็ ท
กาแฟเย็น	ก า แ ฟ เ ย ็ น
ความผิดพลาด	ค ว า ม ผ ิ ด พ ล า ด
ควัก	ค ว ั ก
ราดหน้า	ร า ด ห น ้ า
แก้วมังกร	แ ก ้ ว ม ั ง ก ร
มุสลิม	ม ุ ส ล ิ ม
พ่อบ้าน	พ ่ อ บ ้ า น
วิศวกรรม	ว ิ ศ ว ก ร ร ม
จิระ	จ ิ ร ะ
คาซัคสถาน	ค า ซ ั ค ส ถ า น
ล้าสมัย	ล ้ า ส ม ั ย
เหลา	เ ห ล า
จิ๊กซอว์	จ ิ ๊ ก ซ อ ว ์
สนธิ	ส น ธ ิ
การปิดหีบ	ก า ร ป ิ ด ห ี บ
สี่เหลี่ยม	ส ี ่ เ ห ล ี ่ ย ม
ทึกทัก	ท ึ ก ท ั ก
อนาคตกาล	อ น า ค ต ก า ล
เยาวราช	เ ย า ว ร า ช
สายดือ	ส า ย ด ื อ
พลอง	พ ล อ ง
เครื่องบินกระดาษ	เ ค ร ื ่ อ ง บ ิ น ก ร ะ ด า ษ
สิ่ว	ส ิ ่ ว
คูเวต	ค ู เ ว ต
เชอร์รี	เ ช อ ร ์ ร ี
นายกเทศมนตรี	น า ย ก เ ท ศ ม น ต ร ี
กบไสไม้	ก บ ไ ส ไ ม ้
โบรชัวร์	โ บ ร ช ั ว ร ์
ใหม่เอี่ยม	ใ ห ม ่ เ อ ี ่ ย ม
อวน	อ ว น
ลงดาบ	ล ง ด า บ
เมล็ดพันธุ์	เ ม ล ็ ด พ ั น ธ ุ ์
สมเพช	ส ม เ พ ช
ลูกบ้าน	ล ู ก บ ้ า น
บ่อน้ำ	บ ่ อ น ้ ำ
คาร์เมลทาไซท์	ค า ร ์ เ ม ล ท า ไ ซ ท ์
พายัพ	พ า ย ั พ
เฮก	เ ฮ ก
ไฟแช็ก	ไ ฟ แ ช ็ ก
เบี้ย	เ บ ี ้ ย
การบวก	ก า ร บ ว ก
เทพยดา	เ ท พ ย ด า
ภุชงค์	ภ ุ ช ง ค ์
คดโกง	ค ด โ ก ง
นรีเวชวิทยา	น ร ี เ ว ช ว ิ ท ย า
ข้าวสาร	ข ้ า ว ส า ร
ปาเลา	ป า เ ล า
จุมพฏ	จ ุ ม พ ฏ
ข้อห้าม	ข ้ อ ห ้ า ม
เบิ้ม	เ บ ิ ้ ม
นครลำภาง	น ค ร ล ำ ภ า ง
เกี๊ยะ	เ ก ี ๊ ย ะ
ลูกหลวง	ล ู ก ห ล ว ง
แหวก	แ ห ว ก
หน่วง	ห น ่ ว ง
อ่อนข้อ	อ ่ อ น ข ้ อ
วางไข่	ว า ง ไ ข ่
ที่สิบสี่	ท ี ่ ส ิ บ ส ี ่
การผงะ	ก า ร ผ ง ะ
ความย้อนแย้ง	ค ว า ม ย ้ อ น แ ย ้ ง
มนุษย์กบ	ม น ุ ษ ย ์ ก บ
เซ็นเซอร์	เ ซ ็ น เ ซ อ ร ์
น้ำสังข์	น ้ ำ ส ั ง ข ์
นักเปียโน	น ั ก เ ป ี ย โ น
บันดาร์เสรีเบกาวัน	บ ั น ด า ร ์ เ ส ร ี เ บ ก า ว ั น
สมรส	ส ม ร ส
ยอมหักไม่ยอมงอ	ย อ ม ห ั ก ไ ม ่ ย อ ม ง อ
หมั้น	ห ม ั ้ น
เป็นแผล	เ ป ็ น แ ผ ล
ทายาท	ท า ย า ท
แหลก	แ ห ล ก
ผู้ริเริ่ม	ผ ู ้ ร ิ เ ร ิ ่ ม
เข้าเฝ้า	เ ข ้ า เ ฝ ้ า
เคเบิล	เ ค เ บ ิ ล
นิรันดร	น ิ ร ั น ด ร
รัฐชาติ	ร ั ฐ ช า ต ิ
การเบิก	ก า ร เ บ ิ ก
ฟันปลอม	ฟ ั น ป ล อ ม
ธุระ	ธ ุ ร ะ
ชักภาพ	ช ั ก ภ า พ
อัตตา	อ ั ต ต า
ค้ฤๅนคฤก	ค ้ ฤ ๅ น ค ฤ ก
การพยายาม	ก า ร พ ย า ย า ม
การอุทธรณ์	ก า ร อ ุ ท ธ ร ณ ์
การคร่า	ก า ร ค ร ่ า
กระดึ๊บ	ก ร ะ ด ึ ๊ บ
เศร้าใจ	เ ศ ร ้ า ใ จ
ง้อ	ง ้ อ
การบล็อก	ก า ร บ ล ็ อ ก
แบดเจอร์	แ บ ด เ จ อ ร ์
ดาวเคราะห์	ด า ว เ ค ร า ะ ห ์
อธิปัตย์	อ ธ ิ ป ั ต ย ์
โอเดสซา	โ อ เ ด ส ซ า
เจตนารมย์	เ จ ต น า ร ม ย ์
จามจุรี	จ า ม จ ุ ร ี
สายรุ้ง	ส า ย ร ุ ้ ง
ศาลเตี้ย	ศ า ล เ ต ี ้ ย
ใส่เดี่ยว	ใ ส ่ เ ด ี ่ ย ว
เอมิเรต	เ อ ม ิ เ ร ต
ยั่วเย้า	ย ั ่ ว เ ย ้ า
มารยาท	ม า ร ย า ท
โค้ก	โ ค ้ ก
ประสูติ	ป ร ะ ส ู ต ิ
แคลิฟอร์เนียม	แ ค ล ิ ฟ อ ร ์ เ น ี ย ม
ทะเลสาบปล่องภูเขาไฟ	ท ะ เ ล ส า บ ป ล ่ อ ง ภ ู เ ข า ไ ฟ
ไขควง	ไ ข ค ว ง
กล้ามเนื้อหัวใจ	ก ล ้ า ม เ น ื ้ อ ห ั ว ใ จ
พ่อแม่พี่น้อง	พ ่ อ แ ม ่ พ ี ่ น ้ อ ง
ตัวยง	ต ั ว ย ง
ลูบ	ล ู บ
โอษฐ์	โ อ ษ ฐ ์
เรื่องตลก	เ ร ื ่ อ ง ต ล ก
สัตว์กินนม	ส ั ต ว ์ ก ิ น น ม
ศรีราชา	ศ ร ี ร า ช า
อินทรียวัตถุ	อ ิ น ท ร ี ย ว ั ต ถ ุ
ละเว้น	ล ะ เ ว ้ น
มินสก์	ม ิ น ส ก ์
มรสุม	ม ร ส ุ ม
เอางาน	เ อ า ง า น
แก๊สน้ำตา	แ ก ๊ ส น ้ ำ ต า
อาสาสมัคร	อ า ส า ส ม ั ค ร
สีสรรค์	ส ี ส ร ร ค ์
พรหมแดน	พ ร ห ม แ ด น
ฝังเข็ม	ฝ ั ง เ ข ็ ม
ทั้งบ้านทั้งเมือง	ท ั ้ ง บ ้ า น ท ั ้ ง เ ม ื อ ง
ได้ใจ	ไ ด ้ ใ จ
หนังสือวลี	ห น ั ง ส ื อ ว ล ี
ไถล	ไ ถ ล
นักออกแบบ	น ั ก อ อ ก แ บ บ
แป้นพิมพ์	แ ป ้ น พ ิ ม พ ์
เหง้า	เ ห ง ้ า
โอไมครอน	โ อ ไ ม ค ร อ น
โมเต็ล	โ ม เ ต ็ ล
ศอก	ศ อ ก
โอเอซิส	โ อ เ อ ซ ิ ส
วอชิงตัน	ว อ ช ิ ง ต ั น
แม่โขง	แ ม ่ โ ข ง
หางจระเข้	ห า ง จ ร ะ เ ข ้
ดวงอาทิตย์	ด ว ง อ า ท ิ ต ย ์
หน้าซีด	ห น ้ า ซ ี ด
หลับใน	ห ล ั บ ใ น
เหล็กกล้า	เ ห ล ็ ก ก ล ้ า
สโลธ	ส โ ล ธ
มหา	ม ห า
ช่องโหว่	ช ่ อ ง โ ห ว ่
กรรปุระ	ก ร ร ป ุ ร ะ
อาชา	อ า ช า
สัมทับ	ส ั ม ท ั บ
ความสัตย์	ค ว า ม ส ั ต ย ์
ลิตร	ล ิ ต ร
เซาท์ดาโคตา	เ ซ า ท ์ ด า โ ค ต า
ดาวฤกษ์	ด า ว ฤ ก ษ ์
ฮอกกี้	ฮ อ ก ก ี ้
ต้นฝ้าย	ต ้ น ฝ ้ า ย
มะตะบะ	ม ะ ต ะ บ ะ
ป่าเถื่อน	ป ่ า เ ถ ื ่ อ น
ตัวเมีย	ต ั ว เ ม ี ย
ไม้ประดับ	ไ ม ้ ป ร ะ ด ั บ
เครื่องครัว	เ ค ร ื ่ อ ง ค ร ั ว
ไก่งวง	ไ ก ่ ง ว ง
สุชาต	ส ุ ช า ต
ด้านประกอบมุมฉาก	ด ้ า น ป ร ะ ก อ บ ม ุ ม ฉ า ก
จนกรอบ	จ น ก ร อ บ
หัตถินี	ห ั ต ถ ิ น ี
คัพเค้ก	ค ั พ เ ค ้ ก
เกย์	เ ก ย ์
ขรรม	ข ร ร ม
ความเร็วแสง	ค ว า ม เ ร ็ ว แ ส ง
โปโล	โ ป โ ล
รัฐในอารักขา	ร ั ฐ ใ น อ า ร ั ก ข า
นางแบบ	น า ง แ บ บ
เหน็บ	เ ห น ็ บ
กระสอบ	ก ร ะ ส อ บ
ชวด	ช ว ด
ใจดำ	ใ จ ด ำ
ยูทูปเบอร์	ย ู ท ู ป เ บ อ ร ์
กระเบน	ก ร ะ เ บ น
บี้	บ ี ้
พืชไร่	พ ื ช ไ ร ่
งอมพระราม	ง อ ม พ ร ะ ร า ม
ลิ้นหัวใจ	ล ิ ้ น ห ั ว ใ จ
จำนวนจริง	จ ำ น ว น จ ร ิ ง
มัสกัต	ม ั ส ก ั ต
เงรุลมุด	เ ง ร ุ ล ม ุ ด
แฟรนเซียม	แ ฟ ร น เ ซ ี ย ม
ฆราวาส	ฆ ร า ว า ส
บัตรประชาชน	บ ั ต ร ป ร ะ ช า ช น
แท็กซี่	แ ท ็ ก ซ ี ่
ส่วนแบ่ง	ส ่ ว น แ บ ่ ง
หน้าสิ่วหน้าขวาน	ห น ้ า ส ิ ่ ว ห น ้ า ข ว า น
ความเค็ม	ค ว า ม เ ค ็ ม
เครื่องหมายวรรคตอน	เ ค ร ื ่ อ ง ห ม า ย ว ร ร ค ต อ น
แลนทานัม	แ ล น ท า น ั ม
ชาวตะวันตก	ช า ว ต ะ ว ั น ต ก
โหระพา	โ ห ร ะ พ า
ฉกรรจ์	ฉ ก ร ร จ ์
สัตว์เลี้ยงลูกด้วยเงิน	ส ั ต ว ์ เ ล ี ้ ย ง ล ู ก ด ้ ว ย เ ง ิ น
ทิวลิป	ท ิ ว ล ิ ป
นมเปรี้ยว	น ม เ ป ร ี ้ ย ว
หมาง	ห ม า ง
ละเลง	ล ะ เ ล ง
แผ่ว	แ ผ ่ ว
โกลาหล	โ ก ล า ห ล
จรัส	จ ร ั ส
ระบบอัตโนมัติ	ร ะ บ บ อ ั ต โ น ม ั ต ิ
ค่าง	ค ่ า ง
ตะไกร	ต ะ ไ ก ร
เพื่อนร่วมชั้น	เ พ ื ่ อ น ร ่ ว ม ช ั ้ น
หนืด	ห น ื ด
อัญขยม	อ ั ญ ข ย ม
โรงเรียนอนุบาล	โ ร ง เ ร ี ย น อ น ุ บ า ล
กระดูกโอบอก	ก ร ะ ด ู ก โ อ บ อ ก
ขมุ	ข ม ุ
นักโลดโผน	น ั ก โ ล ด โ ผ น
งอก	ง อ ก
เสียผี	เ ส ี ย ผ ี
สมทบ	ส ม ท บ
ฟักทอง	ฟ ั ก ท อ ง
ปิดทองหลังพระ	ป ิ ด ท อ ง ห ล ั ง พ ร ะ
ทำใจ	ท ำ ใ จ
โลกันตร์	โ ล ก ั น ต ร ์
มีอยู่	ม ี อ ย ู ่
สว่าน	ส ว ่ า น
หอศาสตราคม	ห อ ศ า ส ต ร า ค ม
หนอง	ห น อ ง
พุกาม	พ ุ ก า ม
ระอา	ร ะ อ า
ดาวหาง	ด า ว ห า ง
บุคคลนิติสมมติ	บ ุ ค ค ล น ิ ต ิ ส ม ม ต ิ
กาตาร์	ก า ต า ร ์
มัลดีฟส์	ม ั ล ด ี ฟ ส ์
จงกล	จ ง ก ล
การพระราชทาน	ก า ร พ ร ะ ร า ช ท า น
เศร้า	เ ศ ร ้ า
ลูกทุ่ง	ล ู ก ท ุ ่ ง
สวิง	ส ว ิ ง
อนุสาวรีย์	อ น ุ ส า ว ร ี ย ์
กฎข้อบังคับ	ก ฎ ข ้ อ บ ั ง ค ั บ
ออกลูก	อ อ ก ล ู ก
สะระแหน่	ส ะ ร ะ แ ห น ่
การดอง	ก า ร ด อ ง
เทพดา	เ ท พ ด า
มะลิ	ม ะ ล ิ
ได้หน้า	ไ ด ้ ห น ้ า
เลอะเลือน	เ ล อ ะ เ ล ื อ น
เส้นตื้น	เ ส ้ น ต ื ้ น
หักเห	ห ั ก เ ห
ป่วน	ป ่ ว น
ประสพการณ์	ป ร ะ ส พ ก า ร ณ ์
จิ๊ก	จ ิ ๊ ก
กระเชา	ก ร ะ เ ช า
นวม	น ว ม
เปลือกไม้	เ ป ล ื อ ก ไ ม ้
เคนทักกี	เ ค น ท ั ก ก ี
เยื่อ	เ ย ื ่ อ
กิตติคุณ	ก ิ ต ต ิ ค ุ ณ
ปรางค์	ป ร า ง ค ์
อาวรณ์	อ า ว ร ณ ์
ช่องคลอด	ช ่ อ ง ค ล อ ด
ขาดใจ	ข า ด ใ จ
หมื่นณครร	ห ม ื ่ น ณ ค ร ร
ขอบฟ้า	ข อ บ ฟ ้ า
การเพิกถอน	ก า ร เ พ ิ ก ถ อ น
กรงขัง	ก ร ง ข ั ง
ผู้ดี	ผ ู ้ ด ี
เทควันโด	เ ท ค ว ั น โ ด
ไมโทคอนเดรีย	ไ ม โ ท ค อ น เ ด ร ี ย
สปีชีส์	ส ป ี ช ี ส ์
นาเคศ	น า เ ค ศ
จุลมงกุฎ	จ ุ ล ม ง ก ุ ฎ
ข้าวผัด	ข ้ า ว ผ ั ด
เต้าทึง	เ ต ้ า ท ึ ง
วาด	ว า ด
ปังปุริเย่	ป ั ง ป ุ ร ิ เ ย ่
คั่วกลิ้ง	ค ั ่ ว ก ล ิ ้ ง
ข้าพระองค์	ข ้ า พ ร ะ อ ง ค ์
มนุษยวิทยา	ม น ุ ษ ย ว ิ ท ย า
นินจา	น ิ น จ า
ยอดเงิน	ย อ ด เ ง ิ น
ม็อบ	ม ็ อ บ
โอรส	โ อ ร ส
ฦๅชา	ฦ ๅ ช า
เปรู	เ ป ร ู
กะจั๊ว	ก ะ จ ั ๊ ว
แฮมเบอร์เกอร์	แ ฮ ม เ บ อ ร ์ เ ก อ ร ์
เดโช	เ ด โ ช
บิ้ว	บ ิ ้ ว
เวทมนตร์	เ ว ท ม น ต ร ์
สุขี	ส ุ ข ี
ปีใหม่	ป ี ใ ห ม ่
เกมโชว์	เ ก ม โ ช ว ์
ทานข้าว	ท า น ข ้ า ว
หวานใจ	ห ว า น ใ จ
ต้นตอ	ต ้ น ต อ
ความเสร่อ	ค ว า ม เ ส ร ่ อ
แนวความคิด	แ น ว ค ว า ม ค ิ ด
ธรณี	ธ ร ณ ี
มรณสัน	ม ร ณ ส ั น
แกงเผ็ด	แ ก ง เ ผ ็ ด
เครื่องหมายคำถาม	เ ค ร ื ่ อ ง ห ม า ย ค ำ ถ า ม
ผู้รับพินัยกรรม	ผ ู ้ ร ั บ พ ิ น ั ย ก ร ร ม
หัวหด	ห ั ว ห ด
นั่งพิจารณา	น ั ่ ง พ ิ จ า ร ณ า
เต๋า	เ ต ๋ า
ขนัด	ข น ั ด
เกสร	เ ก ส ร
เส้นประ	เ ส ้ น ป ร ะ
คร้าน	ค ร ้ า น
ชิว	ช ิ ว
ผลึก	ผ ล ึ ก
น้ำค้างแข็ง	น ้ ำ ค ้ า ง แ ข ็ ง
ลิกเตนสไตน์	ล ิ ก เ ต น ส ไ ต น ์
กำกวม	ก ำ ก ว ม
เก็บกด	เ ก ็ บ ก ด
เส้นสาย	เ ส ้ น ส า ย
รากศัพท์	ร า ก ศ ั พ ท ์
ผิดผี	ผ ิ ด ผ ี
เข็มกลัด	เ ข ็ ม ก ล ั ด
โดพามีน	โ ด พ า ม ี น
ดังก้อง	ด ั ง ก ้ อ ง
กะลาสี	ก ะ ล า ส ี
การล้อ	ก า ร ล ้ อ
สมองตาย	ส ม อ ง ต า ย
เทพนิยาย	เ ท พ น ิ ย า ย
ข้าเจ้า	ข ้ า เ จ ้ า
นักคร่าพรหมจรรย์	น ั ก ค ร ่ า พ ร ห ม จ ร ร ย ์
ฟักเหลือง	ฟ ั ก เ ห ล ื อ ง
นากหญ้า	น า ก ห ญ ้ า
มัจฉา	ม ั จ ฉ า
พระยาประเทศราช	พ ร ะ ย า ป ร ะ เ ท ศ ร า ช
นักถ่ายภาพ	น ั ก ถ ่ า ย ภ า พ
พ่อผัว	พ ่ อ ผ ั ว
เคยชิน	เ ค ย ช ิ น
ยาปฏิชีวนะ	ย า ป ฏ ิ ช ี ว น ะ
นัยน์	น ั ย น ์
ความวิบัติ	ค ว า ม ว ิ บ ั ต ิ
กินล้างกินผลาญ	ก ิ น ล ้ า ง ก ิ น ผ ล า ญ
น้ำป่า	น ้ ำ ป ่ า
ความร้ายแรง	ค ว า ม ร ้ า ย แ ร ง
ปลอดภัยไว้ก่อน	ป ล อ ด ภ ั ย ไ ว ้ ก ่ อ น
ระบอบ	ร ะ บ อ บ
สวรรคต	ส ว ร ร ค ต
ผู้เลือกตั้ง	ผ ู ้ เ ล ื อ ก ต ั ้ ง
บูดาเปสต์	บ ู ด า เ ป ส ต ์
หูเบา	ห ู เ บ า
พอลินีเชีย	พ อ ล ิ น ี เ ช ี ย
กุญชร	ก ุ ญ ช ร
เครื่องฉายดาว	เ ค ร ื ่ อ ง ฉ า ย ด า ว
ผู้ฟัง	ผ ู ้ ฟ ั ง
ดอกผล	ด อ ก ผ ล
โดมิโน	โ ด ม ิ โ น
ป้ายสี	ป ้ า ย ส ี
กั้ง	ก ั ้ ง
ตะกั่ว	ต ะ ก ั ่ ว
ริดสีดวงทวาร	ร ิ ด ส ี ด ว ง ท ว า ร
หนอก	ห น อ ก
ยาพิษ	ย า พ ิ ษ
พอใช้	พ อ ใ ช ้
แพนเค้ก	แ พ น เ ค ้ ก
แม้ว	แ ม ้ ว
อิตเทอร์เบียม	อ ิ ต เ ท อ ร ์ เ บ ี ย ม
ซีฟู้ด	ซ ี ฟ ู ้ ด
เล็บขบ	เ ล ็ บ ข บ
ลักษณะนาม	ล ั ก ษ ณ ะ น า ม
รักต่างเพศ	ร ั ก ต ่ า ง เ พ ศ
กกต.	ก ก ต .
โบราณคดี	โ บ ร า ณ ค ด ี
จาม	จ า ม
คิริบาส	ค ิ ร ิ บ า ส
มะเมีย	ม ะ เ ม ี ย
เลือก	เ ล ื อ ก
ไม้ขีด	ไ ม ้ ข ี ด
กล้ำกลืน	ก ล ้ ำ ก ล ื น
อุตมรัฐ	อ ุ ต ม ร ั ฐ
ลำไส้	ล ำ ไ ส ้
แขนง	แ ข น ง
ปลดปล่อย	ป ล ด ป ล ่ อ ย
สังเวียน	ส ั ง เ ว ี ย น
ความเท่	ค ว า ม เ ท ่
วิวัฒนาการ	ว ิ ว ั ฒ น า ก า ร
ฆาฏ	ฆ า ฏ
แฟนสาว	แ ฟ น ส า ว
ละหุ่ง	ล ะ ห ุ ่ ง
การหายใจ	ก า ร ห า ย ใ จ
โรคภัย	โ ร ค ภ ั ย
กระดอง	ก ร ะ ด อ ง
การหารือ	ก า ร ห า ร ื อ
สมเด็จเจ้าพระยา	ส ม เ ด ็ จ เ จ ้ า พ ร ะ ย า
ว่ายน้ำ	ว ่ า ย น ้ ำ
ตะวันตกเฉียงเหนือ	ต ะ ว ั น ต ก เ ฉ ี ย ง เ ห น ื อ
หัวหน้าพ่อครัว	ห ั ว ห น ้ า พ ่ อ ค ร ั ว
ช้างตายทั้งตัวเอาใบบัวมาปิด	ช ้ า ง ต า ย ท ั ้ ง ต ั ว เ อ า ใ บ บ ั ว ม า ป ิ ด
เครื่องราง	เ ค ร ื ่ อ ง ร า ง
ลิควิด	ล ิ ค ว ิ ด
แตรรถ	แ ต ร ร ถ
หมูแดง	ห ม ู แ ด ง
คำขอโทษ	ค ำ ข อ โ ท ษ
โกนาคมนะ	โ ก น า ค ม น ะ
ระทด	ร ะ ท ด
การทำแท้ง	ก า ร ท ำ แ ท ้ ง
กู่ฉิน	ก ู ่ ฉ ิ น
นิติเวชศาสตร์	น ิ ต ิ เ ว ช ศ า ส ต ร ์
ไฮยีน่า	ไ ฮ ย ี น ่ า
ว่องไว	ว ่ อ ง ไ ว
บลัชออน	บ ล ั ช อ อ น
นำร่อง	น ำ ร ่ อ ง
ทันต์	ท ั น ต ์
กตัญญุตา	ก ต ั ญ ญ ุ ต า
สนง.	ส น ง .
แรงโน้มถ่วง	แ ร ง โ น ้ ม ถ ่ ว ง
ญาณวิทยา	ญ า ณ ว ิ ท ย า
กระแส	ก ร ะ แ ส
การหลับนอน	ก า ร ห ล ั บ น อ น
ชวดศก	ช ว ด ศ ก
เกลียว	เ ก ล ี ย ว
เก๋า	เ ก ๋ า
ธรรมาภิบาล	ธ ร ร ม า ภ ิ บ า ล
กะทัดรัด	ก ะ ท ั ด ร ั ด
นักต้มตุ๋น	น ั ก ต ้ ม ต ุ ๋ น
หย่อง	ห ย ่ อ ง
ปานามา	ป า น า ม า
อัครมหาเสนาบดี	อ ั ค ร ม ห า เ ส น า บ ด ี
น้ำอบ	น ้ ำ อ บ
อธิการบดี	อ ธ ิ ก า ร บ ด ี
แพนด้าแดง	แ พ น ด ้ า แ ด ง
จอมบงการ	จ อ ม บ ง ก า ร
เฉียด	เ ฉ ี ย ด
ผ้าใบ	ผ ้ า ใ บ
นักวิทยาศาสตร์	น ั ก ว ิ ท ย า ศ า ส ต ร ์
คอนลีย์	ค อ น ล ี ย ์
จุดบกพร่อง	จ ุ ด บ ก พ ร ่ อ ง
ความหล่อ	ค ว า ม ห ล ่ อ
ทำอาหาร	ท ำ อ า ห า ร
บุคคลธรรมดา	บ ุ ค ค ล ธ ร ร ม ด า
สามสิบห้า	ส า ม ส ิ บ ห ้ า
ชีวประวัติ	ช ี ว ป ร ะ ว ั ต ิ
ปณิธาน	ป ณ ิ ธ า น
ชักว่าว	ช ั ก ว ่ า ว
จำบัง	จ ำ บ ั ง
สมมุติ	ส ม ม ุ ต ิ
กว่า	ก ว ่ า
สายฟ้า	ส า ย ฟ ้ า
เครื่องช่วยฟัง	เ ค ร ื ่ อ ง ช ่ ว ย ฟ ั ง
ลมสุริยะ	ล ม ส ุ ร ิ ย ะ
เอกอัครสมณทูต	เ อ ก อ ั ค ร ส ม ณ ท ู ต
หกเหลี่ยม	ห ก เ ห ล ี ่ ย ม
ขยิบ	ข ย ิ บ
ว่าราชการ	ว ่ า ร า ช ก า ร
เฮง	เ ฮ ง
ภูมิประเทศ	ภ ู ม ิ ป ร ะ เ ท ศ
อีเก้ง	อ ี เ ก ้ ง
การจ่าย	ก า ร จ ่ า ย
ชักดาบ	ช ั ก ด า บ
การนัดพร้อม	ก า ร น ั ด พ ร ้ อ ม
เยือกเย็น	เ ย ื อ ก เ ย ็ น
ตลาดมืด	ต ล า ด ม ื ด
สาธารณชน	ส า ธ า ร ณ ช น
ทิชชู่	ท ิ ช ช ู ่
แม่ครัว	แ ม ่ ค ร ั ว
เจือ	เ จ ื อ
นอยด์	น อ ย ด ์
สหพันธรัฐ	ส ห พ ั น ธ ร ั ฐ
บาร์เบโดส	บ า ร ์ เ บ โ ด ส
คำแหง	ค ำ แ ห ง
อุปมา	อ ุ ป ม า
ก้าบ	ก ้ า บ
ทอเรียม	ท อ เ ร ี ย ม
เลอเวือะ	เ ล อ เ ว ื อ ะ
ลำพูน	ล ำ พ ู น
ยี่สิบสี่	ย ี ่ ส ิ บ ส ี ่
พยากรณ์อากาศ	พ ย า ก ร ณ ์ อ า ก า ศ
แอละแบมา	แ อ ล ะ แ บ ม า
ดีเด่น	ด ี เ ด ่ น
เถาหยวน	เ ถ า ห ย ว น
ราคะ	ร า ค ะ
แลง	แ ล ง
เพียงพอน	เ พ ี ย ง พ อ น
คาบสมุทร	ค า บ ส ม ุ ท ร
ผงฟู	ผ ง ฟ ู
สมภพ	ส ม ภ พ
ปรองดอง	ป ร อ ง ด อ ง
โป้ง	โ ป ้ ง
อักษรสาสน์	อ ั ก ษ ร ส า ส น ์
เครื่องเทศ	เ ค ร ื ่ อ ง เ ท ศ
ความกล้าหาญ	ค ว า ม ก ล ้ า ห า ญ
มาร์มอต	ม า ร ์ ม อ ต
ภาษีบาป	ภ า ษ ี บ า ป
ถลาง	ถ ล า ง
นักบุญ	น ั ก บ ุ ญ
ภูเฃา	ภ ู เ ฃ า
นิดหน่อย	น ิ ด ห น ่ อ ย
ท้วม	ท ้ ว ม
ตอบ	ต อ บ
การนับ	ก า ร น ั บ
รีมูฟเวอร์	ร ี ม ู ฟ เ ว อ ร ์
คูหา	ค ู ห า
มงกุฏ	ม ง ก ุ ฏ
อาย	อ า ย
กระเป๋าเงิน	ก ร ะ เ ป ๋ า เ ง ิ น
ปืนไฟ	ป ื น ไ ฟ
ความลวงโลก	ค ว า ม ล ว ง โ ล ก
การหักเห	ก า ร ห ั ก เ ห
เถ้าแก่	เ ถ ้ า แ ก ่
หลอดทดลอง	ห ล อ ด ท ด ล อ ง
การพิโรธ	ก า ร พ ิ โ ร ธ
เทือกเขา	เ ท ื อ ก เ ข า
ถุงน้ำดี	ถ ุ ง น ้ ำ ด ี
ใบพัด	ใ บ พ ั ด
หมกเม็ด	ห ม ก เ ม ็ ด
พิลิปดา	พ ิ ล ิ ป ด า
ประหลาดใจ	ป ร ะ ห ล า ด ใ จ
ฝัด	ฝ ั ด
ความมหัศจรรย์	ค ว า ม ม ห ั ศ จ ร ร ย ์
นิติบุคคล	น ิ ต ิ บ ุ ค ค ล
บรรณานุกรม	บ ร ร ณ า น ุ ก ร ม
บุญธรรม	บ ุ ญ ธ ร ร ม
ลิงไม่มีหาง	ล ิ ง ไ ม ่ ม ี ห า ง
ผู้หญิงยิงเรือ	ผ ู ้ ห ญ ิ ง ย ิ ง เ ร ื อ
กระดูกต้นแขน	ก ร ะ ด ู ก ต ้ น แ ข น
คูคลักซ์แคลน	ค ู ค ล ั ก ซ ์ แ ค ล น
กลุ่มอาการ	ก ล ุ ่ ม อ า ก า ร
นางพระยา	น า ง พ ร ะ ย า
เด็ดเดี่ยว	เ ด ็ ด เ ด ี ่ ย ว
กรีก	ก ร ี ก
ที่สิบแปด	ท ี ่ ส ิ บ แ ป ด
กเทย	ก เ ท ย
วิปัสสนา	ว ิ ป ั ส ส น า
วายชนม์	ว า ย ช น ม ์
กลั้ว	ก ล ั ้ ว
เป็นต้นว่า	เ ป ็ น ต ้ น ว ่ า
ห้าบาทสิบบาท	ห ้ า บ า ท ส ิ บ บ า ท
เข้าเมือง	เ ข ้ า เ ม ื อ ง
สายพาน	ส า ย พ า น
การนิยาม	ก า ร น ิ ย า ม
ปอกกล้วยเข้าปาก	ป อ ก ก ล ้ ว ย เ ข ้ า ป า ก
บุรพบท	บ ุ ร พ บ ท
ความสงบสุข	ค ว า ม ส ง บ ส ุ ข
บะหมี่	บ ะ ห ม ี ่
ตัวทำละลาย	ต ั ว ท ำ ล ะ ล า ย
ใจหิน	ใ จ ห ิ น
โดนัท	โ ด น ั ท
การทรมาน	ก า ร ท ร ม า น
มือเติบ	ม ื อ เ ต ิ บ
การแบ่งแยก	ก า ร แ บ ่ ง แ ย ก
หมูหมากาไก่	ห ม ู ห ม า ก า ไ ก ่
เครื่องหมายการค้า	เ ค ร ื ่ อ ง ห ม า ย ก า ร ค ้ า
วิบัติ	ว ิ บ ั ต ิ
เวรัมภ	เ ว ร ั ม ภ
เกรปฟรูต	เ ก ร ป ฟ ร ู ต
ครุฑ	ค ร ุ ฑ
ไขมันไม่อิ่มตัว	ไ ข ม ั น ไ ม ่ อ ิ ่ ม ต ั ว
ดูแล	ด ู แ ล
ซีตา	ซ ี ต า
ชิงทรัพย์	ช ิ ง ท ร ั พ ย ์
หน่วยอภิบาล	ห น ่ ว ย อ ภ ิ บ า ล
เข็ญใจ	เ ข ็ ญ ใ จ
น้ำหนักลด	น ้ ำ ห น ั ก ล ด
ตามัว	ต า ม ั ว
ปราณี	ป ร า ณ ี
เดรัจฉาน	เ ด ร ั จ ฉ า น
นมข้าว	น ม ข ้ า ว
ตรินิแดดและโตเบโก	ต ร ิ น ิ แ ด ด แ ล ะ โ ต เ บ โ ก
ยูกลีนา	ย ู ก ล ี น า
ติมอร์ตะวันออก	ต ิ ม อ ร ์ ต ะ ว ั น อ อ ก
มิงค์	ม ิ ง ค ์
ทัปเปอร์แวร์	ท ั ป เ ป อ ร ์ แ ว ร ์
รีโมต	ร ี โ ม ต
ตรรกะวิบัติ	ต ร ร ก ะ ว ิ บ ั ต ิ
ห้าแยก	ห ้ า แ ย ก
สุหนัต	ส ุ ห น ั ต
แคร์รอต	แ ค ร ์ ร อ ต
ความเกียจคร้าน	ค ว า ม เ ก ี ย จ ค ร ้ า น
อนุกรมวิธาน	อ น ุ ก ร ม ว ิ ธ า น
รอมะฎอน	ร อ ม ะ ฎ อ น
ทอดพระเนตร	ท อ ด พ ร ะ เ น ต ร
ยาเบื่อหนู	ย า เ บ ื ่ อ ห น ู
ประเทศราช	ป ร ะ เ ท ศ ร า ช
ต่อมน้ำเหลือง	ต ่ อ ม น ้ ำ เ ห ล ื อ ง
โฮมเพจ	โ ฮ ม เ พ จ
กลับลำ	ก ล ั บ ล ำ
อาจารย์ใหญ่	อ า จ า ร ย ์ ใ ห ญ ่
ทิวาสวัสดิ์	ท ิ ว า ส ว ั ส ด ิ ์
การเห็นชอบ	ก า ร เ ห ็ น ช อ บ
แก้วลืมคอน	แ ก ้ ว ล ื ม ค อ น
วิบาก	ว ิ บ า ก
เอ๋ง	เ อ ๋ ง
การกินใจ	ก า ร ก ิ น ใ จ
เมธ	เ ม ธ
นอร์ทดาโคตา	น อ ร ์ ท ด า โ ค ต า
ดัชต์	ด ั ช ต ์
ภมุ	ภ ม ุ
หวัดดี	ห ว ั ด ด ี
กระต่ายตื่นตูม	ก ร ะ ต ่ า ย ต ื ่ น ต ู ม
ถอนใจ	ถ อ น ใ จ
ฝนกรด	ฝ น ก ร ด
ชนกลุ่มน้อย	ช น ก ล ุ ่ ม น ้ อ ย
อู๊ด	อ ู ๊ ด
ท่อยาง	ท ่ อ ย า ง
ดอกจิก	ด อ ก จ ิ ก
เลื่อยยนต์	เ ล ื ่ อ ย ย น ต ์
อำแดง	อ ำ แ ด ง
ผู้ร้าย	ผ ู ้ ร ้ า ย
สวิตช์	ส ว ิ ต ช ์
การสืบทอด	ก า ร ส ื บ ท อ ด
ฮัมมิงเบิร์ด	ฮ ั ม ม ิ ง เ บ ิ ร ์ ด
ผู้ลี้ภัย	ผ ู ้ ล ี ้ ภ ั ย
หลอม	ห ล อ ม
ดักแด้	ด ั ก แ ด ้
อเมริกาเหนือ	อ เ ม ร ิ ก า เ ห น ื อ
โน้มน้าว	โ น ้ ม น ้ า ว
การสวด	ก า ร ส ว ด
อโนมทัสสี	อ โ น ม ท ั ส ส ี
สฟิงซ์	ส ฟ ิ ง ซ ์
เกด	เ ก ด
สันตาลี	ส ั น ต า ล ี
เต้นรำ	เ ต ้ น ร ำ
เพกา	เ พ ก า
ซุก	ซ ุ ก
ถ้วย	ถ ้ ว ย
อำนาจบาตรใหญ่	อ ำ น า จ บ า ต ร ใ ห ญ ่
ยัติภังค์	ย ั ต ิ ภ ั ง ค ์
ขันหมาก	ข ั น ห ม า ก
เปลี่ยวใจ	เ ป ล ี ่ ย ว ใ จ
กรรตุการก	ก ร ร ต ุ ก า ร ก
เค็ตชัป	เ ค ็ ต ช ั ป
ลักเซมเบิร์ก	ล ั ก เ ซ ม เ บ ิ ร ์ ก
เบราว์เซอร์	เ บ ร า ว ์ เ ซ อ ร ์
อุปถัมภ์	อ ุ ป ถ ั ม ภ ์
เครื่อง‍แต่ง‍กาย	เ ค ร ื ่ อ ง ‍ แ ต ่ ง ‍ ก า ย
หลุมศพ	ห ล ุ ม ศ พ
ฮิระงะนะ	ฮ ิ ร ะ ง ะ น ะ
ห้าว	ห ้ า ว
โหร	โ ห ร
ถือสา	ถ ื อ ส า
เมนเดลีเวียม	เ ม น เ ด ล ี เ ว ี ย ม
ตรีโกณมิติ	ต ร ี โ ก ณ ม ิ ต ิ
การห้าม	ก า ร ห ้ า ม
นกเขาเล็ก	น ก เ ข า เ ล ็ ก
ปทานุกรม	ป ท า น ุ ก ร ม
ไฟนอล	ไ ฟ น อ ล
ยอดเขา	ย อ ด เ ข า
ตับแลบ	ต ั บ แ ล บ
บำเรอ	บ ำ เ ร อ
เขิน	เ ข ิ น
หงอ	ห ง อ
เยี่ยง	เ ย ี ่ ย ง
ถวาย	ถ ว า ย
กระทะใบบัว	ก ร ะ ท ะ ใ บ บ ั ว
ปลอกคอ	ป ล อ ก ค อ
นางเงือก	น า ง เ ง ื อ ก
ชุดว่ายน้ำ	ช ุ ด ว ่ า ย น ้ ำ
แรงหนีศูนย์กลาง	แ ร ง ห น ี ศ ู น ย ์ ก ล า ง
อะมีบา	อ ะ ม ี บ า
มัชฌิม	ม ั ช ฌ ิ ม
เสียสละ	เ ส ี ย ส ล ะ
พราง	พ ร า ง
อิเควทอเรียลกินี	อ ิ เ ค ว ท อ เ ร ี ย ล ก ิ น ี
ภริยา	ภ ร ิ ย า
ทิ่ม	ท ิ ่ ม
ขวาง	ข ว า ง
พิจิตร	พ ิ จ ิ ต ร
ทอดผ้าป่า	ท อ ด ผ ้ า ป ่ า
วัตถุระเบิด	ว ั ต ถ ุ ร ะ เ บ ิ ด
เปิ่น	เ ป ิ ่ น
ไม้อัด	ไ ม ้ อ ั ด
ประชวร	ป ร ะ ช ว ร
ไพ่นกกระจอก	ไ พ ่ น ก ก ร ะ จ อ ก
จวน	จ ว น
ความใจดำ	ค ว า ม ใ จ ด ำ
พ่อตา	พ ่ อ ต า
การอวสาน	ก า ร อ ว ส า น
วิปโยค	ว ิ ป โ ย ค
ฦๅ	ฦ ๅ
หยัก	ห ย ั ก
โทรม	โ ท ร ม
เยื่อหุ้มสมอง	เ ย ื ่ อ ห ุ ้ ม ส ม อ ง
นิรุกติ	น ิ ร ุ ก ต ิ
หลายใจ	ห ล า ย ใ จ
แอนติกาและบาร์บูดา	แ อ น ต ิ ก า แ ล ะ บ า ร ์ บ ู ด า
บุพทิศ	บ ุ พ ท ิ ศ
ปล่องควัน	ป ล ่ อ ง ค ว ั น
เวสต์เวอร์จิเนีย	เ ว ส ต ์ เ ว อ ร ์ จ ิ เ น ี ย
ขึ้นทะเบียน	ข ึ ้ น ท ะ เ บ ี ย น
เสื้อขนสัตว์	เ ส ื ้ อ ข น ส ั ต ว ์
ยุกระบัด	ย ุ ก ร ะ บ ั ด
แซ้บ	แ ซ ้ บ
บงการ	บ ง ก า ร
สนม	ส น ม
ความชั่ว	ค ว า ม ช ั ่ ว
สังฆราช	ส ั ง ฆ ร า ช
ตราบาป	ต ร า บ า ป
นักเทนนิส	น ั ก เ ท น น ิ ส
แมลงชีปะขาว	แ ม ล ง ช ี ป ะ ข า ว
หัวข่าว	ห ั ว ข ่ า ว
ระบาดวิทยา	ร ะ บ า ด ว ิ ท ย า
โพรงเยื่อหุ้มปอดมีอากาศ	โ พ ร ง เ ย ื ่ อ ห ุ ้ ม ป อ ด ม ี อ า ก า ศ
ทหารราบ	ท ห า ร ร า บ
สายตาเอียง	ส า ย ต า เ อ ี ย ง
มานุษยวิทยา	ม า น ุ ษ ย ว ิ ท ย า
ดอกไม้ไฟ	ด อ ก ไ ม ้ ไ ฟ
ตีนกา	ต ี น ก า
โล่งอก	โ ล ่ ง อ ก
ภรตวรรษ	ภ ร ต ว ร ร ษ
ปูนปลาสเตอร์	ป ู น ป ล า ส เ ต อ ร ์
บอมเบย์	บ อ ม เ บ ย ์
มุ่งหวัง	ม ุ ่ ง ห ว ั ง
ถก	ถ ก
สมมาตร	ส ม ม า ต ร
ปริ๊นท์	ป ร ิ ๊ น ท ์
ผลประโยชน์ทับซ้อน	ผ ล ป ร ะ โ ย ช น ์ ท ั บ ซ ้ อ น
เชิงเทียน	เ ช ิ ง เ ท ี ย น
หมายเรียก	ห ม า ย เ ร ี ย ก
ประพันธ์	ป ร ะ พ ั น ธ ์
ทรงคล้ายทรงกลม	ท ร ง ค ล ้ า ย ท ร ง ก ล ม
นัด	น ั ด
พจนานุกรม	พ จ น า น ุ ก ร ม
กระได	ก ร ะ ไ ด
การพิบัติ	ก า ร พ ิ บ ั ต ิ
ถ่อมตัว	ถ ่ อ ม ต ั ว
บุหลัน	บ ุ ห ล ั น
ก้านชูเกสรตัวเมีย	ก ้ า น ช ู เ ก ส ร ต ั ว เ ม ี ย
วงกบ	ว ง ก บ
ยกเมฆ	ย ก เ ม ฆ
เพจเจอร์	เ พ จ เ จ อ ร ์
เส้นใหญ่	เ ส ้ น ใ ห ญ ่
สะโพน	ส ะ โ พ น
ความซื่อ	ค ว า ม ซ ื ่ อ
ภูริ	ภ ู ร ิ
สีกา	ส ี ก า
ผู้สำเร็จราชการแทนพระองค์	ผ ู ้ ส ำ เ ร ็ จ ร า ช ก า ร แ ท น พ ร ะ อ ง ค ์
วันหยุดยาว	ว ั น ห ย ุ ด ย า ว
แปลไทยเป็นไทย	แ ป ล ไ ท ย เ ป ็ น ไ ท ย
ปืนกล	ป ื น ก ล
สมาชิกวุฒิสภา	ส ม า ช ิ ก ว ุ ฒ ิ ส ภ า
หย่าร้าง	ห ย ่ า ร ้ า ง
กะรัง	ก ะ ร ั ง
ถอดใจ	ถ อ ด ใ จ
กุดัง	ก ุ ด ั ง
วากยสัมพันธ์	ว า ก ย ส ั ม พ ั น ธ ์
เขี่ย	เ ข ี ่ ย
เศร้าสร้อย	เ ศ ร ้ า ส ร ้ อ ย
การสวนสนาม	ก า ร ส ว น ส น า ม
จุ้ม	จ ุ ้ ม
หนวด	ห น ว ด
อภิชนาธิปไตย	อ ภ ิ ช น า ธ ิ ป ไ ต ย
มิสซูรี	ม ิ ส ซ ู ร ี
ชิงสุกก่อนห่าม	ช ิ ง ส ุ ก ก ่ อ น ห ่ า ม
นฤบดินทร	น ฤ บ ด ิ น ท ร
จุลินทรีย์	จ ุ ล ิ น ท ร ี ย ์
ชี	ช ี
จำนวนอตรรกยะ	จ ำ น ว น อ ต ร ร ก ย ะ
ฟันตัด	ฟ ั น ต ั ด
ต้นคอ	ต ้ น ค อ
เกลือก	เ ก ล ื อ ก
คารวะ	ค า ร ว ะ
ซอมซ่อ	ซ อ ม ซ ่ อ
ปฤจฉาสรรพนาม	ป ฤ จ ฉ า ส ร ร พ น า ม
โดฮา	โ ด ฮ า
หึ่ง	ห ึ ่ ง
ตระบัด	ต ร ะ บ ั ด
ชะอม	ช ะ อ ม
อาน	อ า น
ทราก	ท ร า ก
แผนที่เล่ม	แ ผ น ท ี ่ เ ล ่ ม
เนื้อไม้	เ น ื ้ อ ไ ม ้
โรฮิงญา	โ ร ฮ ิ ง ญ า
ละเลย	ล ะ เ ล ย
ราชอาณาจักรเกรตบริเตน	ร า ช อ า ณ า จ ั ก ร เ ก ร ต บ ร ิ เ ต น
กระบี่กระบอง	ก ร ะ บ ี ่ ก ร ะ บ อ ง
คลี่	ค ล ี ่
คริกเก็ต	ค ร ิ ก เ ก ็ ต
ซอบั้ง	ซ อ บ ั ้ ง
คะนอง	ค ะ น อ ง
สร้อยข้อมือ	ส ร ้ อ ย ข ้ อ ม ื อ
งูสวัด	ง ู ส ว ั ด
กาฐมาณฑุ	ก า ฐ ม า ณ ฑ ุ
ชายรักร่วมเพศ	ช า ย ร ั ก ร ่ ว ม เ พ ศ
ตั่ง	ต ั ่ ง
ปฏิสสาร	ป ฏ ิ ส ส า ร
ความทุกข์	ค ว า ม ท ุ ก ข ์
มัคคุเทศก์	ม ั ค ค ุ เ ท ศ ก ์
ตอก	ต อ ก
มือที่สาม	ม ื อ ท ี ่ ส า ม
เตหะราน	เ ต ห ะ ร า น
เลโซโท	เ ล โ ซ โ ท
บริบาล	บ ร ิ บ า ล
หัวเมือง	ห ั ว เ ม ื อ ง
กีดขวาง	ก ี ด ข ว า ง
ขุนหมื่น	ข ุ น ห ม ื ่ น
ตะกร้า	ต ะ ก ร ้ า
สหประชาชาติ	ส ห ป ร ะ ช า ช า ต ิ
โกศ	โ ก ศ
ป่าช้า	ป ่ า ช ้ า
ขาอ่อน	ข า อ ่ อ น
แถวตรง	แ ถ ว ต ร ง
ตาสว่าง	ต า ส ว ่ า ง
ราชันย์	ร า ช ั น ย ์
ความเหี้ย	ค ว า ม เ ห ี ้ ย
แช่เย็น	แ ช ่ เ ย ็ น
ผูก	ผ ู ก
อาร์กอน	อ า ร ์ ก อ น
เฉื่อย	เ ฉ ื ่ อ ย
ครุศาสตร์	ค ร ุ ศ า ส ต ร ์
ภูมิอากาศ	ภ ู ม ิ อ า ก า ศ
ขรุขระ	ข ร ุ ข ร ะ
มัลแวร์	ม ั ล แ ว ร ์
ยีนส์	ย ี น ส ์
หนังตะลุง	ห น ั ง ต ะ ล ุ ง
ลูกปรายหิมะ	ล ู ก ป ร า ย ห ิ ม ะ
คลอน	ค ล อ น
ของกลาง	ข อ ง ก ล า ง
โอริยา	โ อ ร ิ ย า
บังอาจ	บ ั ง อ า จ
กล้องจุลทรรศน์	ก ล ้ อ ง จ ุ ล ท ร ร ศ น ์
ตะไบเล็บ	ต ะ ไ บ เ ล ็ บ
ชมพู่	ช ม พ ู ่
หักห้าม	ห ั ก ห ้ า ม
หลั่ง	ห ล ั ่ ง
ระลอก	ร ะ ล อ ก
สหาย	ส ห า ย
ฮอลแลนด์	ฮ อ ล แ ล น ด ์
มกุฎราชกุมาร	ม ก ุ ฎ ร า ช ก ุ ม า ร
คีชีเนา	ค ี ช ี เ น า
ผู้ประกาศ	ผ ู ้ ป ร ะ ก า ศ
พลัม	พ ล ั ม
โคมระย้า	โ ค ม ร ะ ย ้ า
ไอเสีย	ไ อ เ ส ี ย
ทั้งกลม	ท ั ้ ง ก ล ม
การกลัวดอกพิกุลจะร่วง	ก า ร ก ล ั ว ด อ ก พ ิ ก ุ ล จ ะ ร ่ ว ง
ตั้งเป้าหมาย	ต ั ้ ง เ ป ้ า ห ม า ย
การเข้าเฝ้า	ก า ร เ ข ้ า เ ฝ ้ า
ผ้าเช็ดตัว	ผ ้ า เ ช ็ ด ต ั ว
แม่เหล็กไฟฟ้า	แ ม ่ เ ห ล ็ ก ไ ฟ ฟ ้ า
ซิดนีย์	ซ ิ ด น ี ย ์
ท่าดีทีเหลว	ท ่ า ด ี ท ี เ ห ล ว
อนุกรม	อ น ุ ก ร ม
ฉมวก	ฉ ม ว ก
ยื้อ	ย ื ้ อ
จอบ	จ อ บ
เล็บมือนาง	เ ล ็ บ ม ื อ น า ง
รายรับ	ร า ย ร ั บ
จุลศักราช	จ ุ ล ศ ั ก ร า ช
กลบบัตร	ก ล บ บ ั ต ร
อุทกศาสตร์	อ ุ ท ก ศ า ส ต ร ์
การถีบ	ก า ร ถ ี บ
โคมูตร	โ ค ม ู ต ร
รัตนา	ร ั ต น า
ผู้ขับ	ผ ู ้ ข ั บ
ครีมเทียม	ค ร ี ม เ ท ี ย ม
อาทิตยวาร	อ า ท ิ ต ย ว า ร
เอือม	เ อ ื อ ม
เยื่อพรหมจารี	เ ย ื ่ อ พ ร ห ม จ า ร ี
เอว	เ อ ว
นาฏ	น า ฏ
ปัญญาจารย์	ป ั ญ ญ า จ า ร ย ์
ฮัจญ์	ฮ ั จ ญ ์
กระยาหาร	ก ร ะ ย า ห า ร
เวียนเทียน	เ ว ี ย น เ ท ี ย น
ลาดหน้า	ล า ด ห น ้ า
สังคมนิยม	ส ั ง ค ม น ิ ย ม
การตลาด	ก า ร ต ล า ด
ชวร	ช ว ร
น้ำเชื่อม	น ้ ำ เ ช ื ่ อ ม
อาหรับ	อ า ห ร ั บ
มนุษยธรรม	ม น ุ ษ ย ธ ร ร ม
บุรุษไปรษณีย์	บ ุ ร ุ ษ ไ ป ร ษ ณ ี ย ์
ฮูก	ฮ ู ก
ปาล์ม	ป า ล ์ ม
เกย์ไพรด์	เ ก ย ์ ไ พ ร ด ์
ผู้ประศาสน์การ	ผ ู ้ ป ร ะ ศ า ส น ์ ก า ร
กฤษณา	ก ฤ ษ ณ า
ดาแกโรไทป์	ด า แ ก โ ร ไ ท ป ์
คู่จิ้น	ค ู ่ จ ิ ้ น
ละหาน	ล ะ ห า น
ก้นครัว	ก ้ น ค ร ั ว
อัตวินิบาต	อ ั ต ว ิ น ิ บ า ต
ถือตัว	ถ ื อ ต ั ว
ครึกครื้น	ค ร ึ ก ค ร ื ้ น
พนัญเชิง	พ น ั ญ เ ช ิ ง
อริย	อ ร ิ ย
สาธารณรัฐเช็ก	ส า ธ า ร ณ ร ั ฐ เ ช ็ ก
อัมพาต	อ ั ม พ า ต
เปลือย	เ ป ล ื อ ย
การกินเด็ก	ก า ร ก ิ น เ ด ็ ก
ลูกดก	ล ู ก ด ก
วิชัย	ว ิ ช ั ย
นางรม	น า ง ร ม
นักษัตร	น ั ก ษ ั ต ร
ไอ้หยา	ไ อ ้ ห ย า
ชมพูทวีป	ช ม พ ู ท ว ี ป
ปริ๊นต์	ป ร ิ ๊ น ต ์
การทุ่มตลาด	ก า ร ท ุ ่ ม ต ล า ด
มลาบรี	ม ล า บ ร ี
ลึกลับ	ล ึ ก ล ั บ
อะไรวะ	อ ะ ไ ร ว ะ
ตัวตลก	ต ั ว ต ล ก
ขูด	ข ู ด
คัดค้าน	ค ั ด ค ้ า น
ต.ต.ต.	ต . ต . ต .
เหย้า	เ ห ย ้ า
ลบล้าง	ล บ ล ้ า ง
โปร่งใจ	โ ป ร ่ ง ใ จ
น้ำมันประกอบอาหาร	น ้ ำ ม ั น ป ร ะ ก อ บ อ า ห า ร
โปรดเกล้าโปรดกระหม่อม	โ ป ร ด เ ก ล ้ า โ ป ร ด ก ร ะ ห ม ่ อ ม
กระเพาะปัสสาวะ	ก ร ะ เ พ า ะ ป ั ส ส า ว ะ
ท่อไอเสีย	ท ่ อ ไ อ เ ส ี ย
ตัวคูณร่วมน้อย	ต ั ว ค ู ณ ร ่ ว ม น ้ อ ย
รำชั่วโทษพากย์	ร ำ ช ั ่ ว โ ท ษ พ า ก ย ์
รับสั่ง	ร ั บ ส ั ่ ง
ผ้าปูเตียง	ผ ้ า ป ู เ ต ี ย ง
จ.ศ.	จ . ศ .
รูเล็ตต์	ร ู เ ล ็ ต ต ์
การทำให้เป็นอาณานิคม	ก า ร ท ำ ใ ห ้ เ ป ็ น อ า ณ า น ิ ค ม
ไก่ตัวผู้	ไ ก ่ ต ั ว ผ ู ้
โผน	โ ผ น
อุษา	อ ุ ษ า
บ้านผีสิง	บ ้ า น ผ ี ส ิ ง
มะงุมมะงาหรา	ม ะ ง ุ ม ม ะ ง า ห ร า
อะโบมาซัม	อ ะ โ บ ม า ซ ั ม
ยูกันดา	ย ู ก ั น ด า
ยี่	ย ี ่
รนหาที่	ร น ห า ท ี ่
จับจ่าย	จ ั บ จ ่ า ย
กรัง	ก ร ั ง
ซาฮาลิน	ซ า ฮ า ล ิ น
แปรพักตร์	แ ป ร พ ั ก ต ร ์
วอมแบต	ว อ ม แ บ ต
น่ารังเกียจ	น ่ า ร ั ง เ ก ี ย จ
แรงต้านสนามไฟฟ้า	แ ร ง ต ้ า น ส น า ม ไ ฟ ฟ ้ า
พีช	พ ี ช
ศาลอุทธรณ์	ศ า ล อ ุ ท ธ ร ณ ์
หวาดกลัว	ห ว า ด ก ล ั ว
เอื้อม	เ อ ื ้ อ ม
การเห็น	ก า ร เ ห ็ น
ตะแลงแกง	ต ะ แ ล ง แ ก ง
ซานา	ซ า น า
รังแก	ร ั ง แ ก
ไนโอเบียม	ไ น โ อ เ บ ี ย ม
นักพรต	น ั ก พ ร ต
ถุงลมนิรภัย	ถ ุ ง ล ม น ิ ร ภ ั ย
ความตื้นเขิน	ค ว า ม ต ื ้ น เ ข ิ น
ไส้กรอก	ไ ส ้ ก ร อ ก
ดีปลี	ด ี ป ล ี
ชี้นำ	ช ี ้ น ำ
หงุดหงิด	ห ง ุ ด ห ง ิ ด
บัดนี้	บ ั ด น ี ้
อายุรแพทย์	อ า ย ุ ร แ พ ท ย ์
โครเอเชีย	โ ค ร เ อ เ ช ี ย
บำราบ	บ ำ ร า บ
พริกดอง	พ ร ิ ก ด อ ง
บีบคั้น	บ ี บ ค ั ้ น
เป่าปาก	เ ป ่ า ป า ก
เทพารักษ์	เ ท พ า ร ั ก ษ ์
การเสด็จ	ก า ร เ ส ด ็ จ
สแกนเดียม	ส แ ก น เ ด ี ย ม
หมูป่า	ห ม ู ป ่ า
พบ	พ บ
กลายพันธุ์	ก ล า ย พ ั น ธ ุ ์
ไฟเย็น	ไ ฟ เ ย ็ น
เหตุสุดวิสัย	เ ห ต ุ ส ุ ด ว ิ ส ั ย
หมายปล่อย	ห ม า ย ป ล ่ อ ย
ฃ	ฃ
กรมธรรม์	ก ร ม ธ ร ร ม ์
ขรึม	ข ร ึ ม
ไปเที่ยว	ไ ป เ ท ี ่ ย ว
พระราชบัญญัติ	พ ร ะ ร า ช บ ั ญ ญ ั ต ิ
เสือปลา	เ ส ื อ ป ล า
การหวั่นไหว	ก า ร ห ว ั ่ น ไ ห ว
ละอาย	ล ะ อ า ย
กับแกล้ม	ก ั บ แ ก ล ้ ม
ศูนย์กลางมวล	ศ ู น ย ์ ก ล า ง ม ว ล
แผลเก่า	แ ผ ล เ ก ่ า
โมเมนตัม	โ ม เ ม น ต ั ม
คลำ	ค ล ำ
ดูดฝุ่น	ด ู ด ฝ ุ ่ น
หน้าผา	ห น ้ า ผ า
ประดาน้ำ	ป ร ะ ด า น ้ ำ
ฤดูใบไม้ร่วง	ฤ ด ู ใ บ ไ ม ้ ร ่ ว ง
สี่สิบสี่	ส ี ่ ส ิ บ ส ี ่
ไย	ไ ย
แม่ไม้	แ ม ่ ไ ม ้
การสบถ	ก า ร ส บ ถ
สัด	ส ั ด
มีครรภ์	ม ี ค ร ร ภ ์
ตัวเร่ง	ต ั ว เ ร ่ ง
สเวตเตอร์	ส เ ว ต เ ต อ ร ์
กระดานโต้คลื่น	ก ร ะ ด า น โ ต ้ ค ล ื ่ น
สกอตแลนด์	ส ก อ ต แ ล น ด ์
สุรเดช	ส ุ ร เ ด ช
ไม้หมอน	ไ ม ้ ห ม อ น
ธรณีวิทยา	ธ ร ณ ี ว ิ ท ย า
แทรกเตอร์	แ ท ร ก เ ต อ ร ์
น้ำชา	น ้ ำ ช า
ไต่สวน	ไ ต ่ ส ว น
ฮะเก๋า	ฮ ะ เ ก ๋ า
โภคภัณฑ์	โ ภ ค ภ ั ณ ฑ ์
เผา	เ ผ า
กลฉ้อฉล	ก ล ฉ ้ อ ฉ ล
ตาชั่ง	ต า ช ั ่ ง
ลูกอม	ล ู ก อ ม
ทะเลทราย	ท ะ เ ล ท ร า ย
หมองู	ห ม อ ง ู
มุ่งร้าย	ม ุ ่ ง ร ้ า ย
ส่าง	ส ่ า ง
เพลงสวด	เ พ ล ง ส ว ด
ความครอบครอง	ค ว า ม ค ร อ บ ค ร อ ง
สายชู	ส า ย ช ู
ห้องนั่งเล่น	ห ้ อ ง น ั ่ ง เ ล ่ น
ความเว่อร์	ค ว า ม เ ว ่ อ ร ์
ภาคินี	ภ า ค ิ น ี
สมภารกินไก่วัด	ส ม ภ า ร ก ิ น ไ ก ่ ว ั ด
ผู้พิพากษา	ผ ู ้ พ ิ พ า ก ษ า
ค้ำประกัน	ค ้ ำ ป ร ะ ก ั น
ปาท่องโก๋	ป า ท ่ อ ง โ ก ๋
ปชช.	ป ช ช .
วาสนา	ว า ส น า
ล่อนจ้อน	ล ่ อ น จ ้ อ น
เลขคณิต	เ ล ข ค ณ ิ ต
สภานิติบัญญัติ	ส ภ า น ิ ต ิ บ ั ญ ญ ั ต ิ
โยคี	โ ย ค ี
วอดก้า	ว อ ด ก ้ า
มั่งคั่ง	ม ั ่ ง ค ั ่ ง
ญาติพี่น้อง	ญ า ต ิ พ ี ่ น ้ อ ง
จักรวรรดิโรมันอันศักดิ์สิทธิ์	จ ั ก ร ว ร ร ด ิ โ ร ม ั น อ ั น ศ ั ก ด ิ ์ ส ิ ท ธ ิ ์
ฝาง	ฝ า ง
พืชอวบน้ำ	พ ื ช อ ว บ น ้ ำ
อริยทรัพย์	อ ร ิ ย ท ร ั พ ย ์
บาศก์	บ า ศ ก ์
เห็นขี้ดีกว่าไส้	เ ห ็ น ข ี ้ ด ี ก ว ่ า ไ ส ้
เชิงกราน	เ ช ิ ง ก ร า น
เว่อร์	เ ว ่ อ ร ์
ไกล่เกลี่ย	ไ ก ล ่ เ ก ล ี ่ ย
การอาราธนา	ก า ร อ า ร า ธ น า
วิเศษณ์	ว ิ เ ศ ษ ณ ์
สารคดี	ส า ร ค ด ี
การรถไฟ	ก า ร ร ถ ไ ฟ
แอพริคอต	แ อ พ ร ิ ค อ ต
ปธน.	ป ธ น .
เพศสัมพันธ์	เ พ ศ ส ั ม พ ั น ธ ์
เอามะพร้าวห้าวไปขายสวน	เ อ า ม ะ พ ร ้ า ว ห ้ า ว ไ ป ข า ย ส ว น
สภาคณาจารย์	ส ภ า ค ณ า จ า ร ย ์
ตรอก	ต ร อ ก
การประหารชีวิต	ก า ร ป ร ะ ห า ร ช ี ว ิ ต
เนบิวลา	เ น บ ิ ว ล า
สองสาม	ส อ ง ส า ม
แทลเลียม	แ ท ล เ ล ี ย ม
รัฐสภา	ร ั ฐ ส ภ า
บอกหนังสือสังฆราช	บ อ ก ห น ั ง ส ื อ ส ั ง ฆ ร า ช
การรับของโจร	ก า ร ร ั บ ข อ ง โ จ ร
รติไฟ	ร ต ิ ไ ฟ
สาธารณรัฐแอฟริกากลาง	ส า ธ า ร ณ ร ั ฐ แ อ ฟ ร ิ ก า ก ล า ง
นิติศาสตร์	น ิ ต ิ ศ า ส ต ร ์
ตลอดไป	ต ล อ ด ไ ป
กีฏวิทยา	ก ี ฏ ว ิ ท ย า
เพศหญิง	เ พ ศ ห ญ ิ ง
มดยอบ	ม ด ย อ บ
ขับร้อง	ข ั บ ร ้ อ ง
โอนิงิริ	โ อ น ิ ง ิ ร ิ
ผูกพันธ์	ผ ู ก พ ั น ธ ์
เครื่องสำอาง	เ ค ร ื ่ อ ง ส ำ อ า ง
ทะเยอทะยาน	ท ะ เ ย อ ท ะ ย า น
คบชู้	ค บ ช ู ้
ขอยืม	ข อ ย ื ม
การส่อง	ก า ร ส ่ อ ง
แปรอักษร	แ ป ร อ ั ก ษ ร
บรรณาธิการ	บ ร ร ณ า ธ ิ ก า ร
การประมาณ	ก า ร ป ร ะ ม า ณ
กระรอกบิน	ก ร ะ ร อ ก บ ิ น
ใจเพชร	ใ จ เ พ ช ร
นกสองหัว	น ก ส อ ง ห ั ว
ตูบ	ต ู บ
แรด	แ ร ด
ย้อย	ย ้ อ ย
แพร์	แ พ ร ์
มีท้อง	ม ี ท ้ อ ง
ปอก	ป อ ก
การฆ่าช้างเอางา	ก า ร ฆ ่ า ช ้ า ง เ อ า ง า
พอร์ต-ออฟ-สเปน	พ อ ร ์ ต - อ อ ฟ - ส เ ป น
ฉลู	ฉ ล ู
แม่แบบ	แ ม ่ แ บ บ
ถามหา	ถ า ม ห า
เวจมรรค	เ ว จ ม ร ร ค
นักชีววิทยา	น ั ก ช ี ว ว ิ ท ย า
สตูล	ส ต ู ล
ซี่โครง	ซ ี ่ โ ค ร ง
ช่างหล่อ	ช ่ า ง ห ล ่ อ
ชาวสวน	ช า ว ส ว น
ภิกษุ	ภ ิ ก ษ ุ
ผงซักฟอก	ผ ง ซ ั ก ฟ อ ก
โจรห้าร้อย	โ จ ร ห ้ า ร ้ อ ย
น้ำมันปลา	น ้ ำ ม ั น ป ล า
เที่ยงคืน	เ ท ี ่ ย ง ค ื น
จำนวนตรรกยะ	จ ำ น ว น ต ร ร ก ย ะ
ระมาด	ร ะ ม า ด
วีดีทัศน์	ว ี ด ี ท ั ศ น ์
ทูน่า	ท ู น ่ า
รถลาก	ร ถ ล า ก
การสิ้นสุด	ก า ร ส ิ ้ น ส ุ ด
บัวแก้ว	บ ั ว แ ก ้ ว
ปลุกปั่น	ป ล ุ ก ป ั ่ น
ลงเอย	ล ง เ อ ย
กัวเตมาลา	ก ั ว เ ต ม า ล า
พลการ	พ ล ก า ร
ซัวเถา	ซ ั ว เ ถ า
แฟ็กซ์	แ ฟ ็ ก ซ ์
ฤชา	ฤ ช า
กุลบดี	ก ุ ล บ ด ี
คนแคระ	ค น แ ค ร ะ
ผู้ต้องสงสัย	ผ ู ้ ต ้ อ ง ส ง ส ั ย
ลัทธิทหาร	ล ั ท ธ ิ ท ห า ร
บาห์เรน	บ า ห ์ เ ร น
ความเกรงใจ	ค ว า ม เ ก ร ง ใ จ
เรื่องมาก	เ ร ื ่ อ ง ม า ก
ข้าวเกรียบ	ข ้ า ว เ ก ร ี ย บ
พะโล้	พ ะ โ ล ้
การยาตรา	ก า ร ย า ต ร า
ทวารหนัก	ท ว า ร ห น ั ก
ภาพเหมือน	ภ า พ เ ห ม ื อ น
งานฉลอง	ง า น ฉ ล อ ง
นิรนาม	น ิ ร น า ม
โคเปอร์นิเซียม	โ ค เ ป อ ร ์ น ิ เ ซ ี ย ม
ทุนการศึกษา	ท ุ น ก า ร ศ ึ ก ษ า
ชะรอย	ช ะ ร อ ย
ไอโฟน	ไ อ โ ฟ น
เฮอริเคน	เ ฮ อ ร ิ เ ค น
ผู้อพยพ	ผ ู ้ อ พ ย พ
ควีน	ค ว ี น
มอลตา	ม อ ล ต า
แปรงสีฟัน	แ ป ร ง ส ี ฟ ั น
ความขำ	ค ว า ม ข ำ
วงดนตรี	ว ง ด น ต ร ี
ล่วงล้ำ	ล ่ ว ง ล ้ ำ
หม้อแปลงไฟ	ห ม ้ อ แ ป ล ง ไ ฟ
การรีดไถ	ก า ร ร ี ด ไ ถ
ป่อง	ป ่ อ ง
โฮมสเตย์	โ ฮ ม ส เ ต ย ์
งุ้ม	ง ุ ้ ม
ที่เขี่ยบุหรี่	ท ี ่ เ ข ี ่ ย บ ุ ห ร ี ่
หลอมเหลว	ห ล อ ม เ ห ล ว
ระยะห่าง	ร ะ ย ะ ห ่ า ง
กองมรดก	ก อ ง ม ร ด ก
บุคคลภายนอก	บ ุ ค ค ล ภ า ย น อ ก
วารสารศาสตร์	ว า ร ส า ร ศ า ส ต ร ์
ควายเหล็ก	ค ว า ย เ ห ล ็ ก
อหิ	อ ห ิ
ใคร่ครวญ	ใ ค ร ่ ค ร ว ญ
ข้าวซอย	ข ้ า ว ซ อ ย
ยึกยัก	ย ึ ก ย ั ก
ไม้กวาด	ไ ม ้ ก ว า ด
กระต่ายป่า	ก ร ะ ต ่ า ย ป ่ า
หอดูดาว	ห อ ด ู ด า ว
ฟาน	ฟ า น
กระบองเพชร	ก ร ะ บ อ ง เ พ ช ร
บะช่อ	บ ะ ช ่ อ
เสียตัว	เ ส ี ย ต ั ว
สิงสาราสัตว์	ส ิ ง ส า ร า ส ั ต ว ์
นมระเหย	น ม ร ะ เ ห ย
จักษุ	จ ั ก ษ ุ
ผู้กระหายสงคราม	ผ ู ้ ก ร ะ ห า ย ส ง ค ร า ม
เหล็กกล้าไร้สนิม	เ ห ล ็ ก ก ล ้ า ไ ร ้ ส น ิ ม
เค้น	เ ค ้ น
จิ๊บจ๊อย	จ ิ ๊ บ จ ๊ อ ย
วยัคฆ์	ว ย ั ค ฆ ์
เชษฐะ	เ ช ษ ฐ ะ
หงอน	ห ง อ น
สเกต	ส เ ก ต
ทัศนียภาพ	ท ั ศ น ี ย ภ า พ
มานามา	ม า น า ม า
พวงกุญแจ	พ ว ง ก ุ ญ แ จ
ซิ่ว	ซ ิ ่ ว
สวนพฤกษศาสตร์	ส ว น พ ฤ ก ษ ศ า ส ต ร ์
พิราลัย	พ ิ ร า ล ั ย
ซ่อนชู้	ซ ่ อ น ช ู ้
พิธีสาร	พ ิ ธ ี ส า ร
รอบรู้	ร อ บ ร ู ้
สถาปนิก	ส ถ า ป น ิ ก
ดินน้ำมัน	ด ิ น น ้ ำ ม ั น
เต่าทอง	เ ต ่ า ท อ ง
อิเล็กทรอนิกส์	อ ิ เ ล ็ ก ท ร อ น ิ ก ส ์
สมบูรณาญาสิทธิราชย์	ส ม บ ู ร ณ า ญ า ส ิ ท ธ ิ ร า ช ย ์
คอลลาเจน	ค อ ล ล า เ จ น
นักปักษีวิทยา	น ั ก ป ั ก ษ ี ว ิ ท ย า
การคลาน	ก า ร ค ล า น
โอลิมปิก	โ อ ล ิ ม ป ิ ก
อินทผลัม	อ ิ น ท ผ ล ั ม
สามเณร	ส า ม เ ณ ร
เอ็มพีสาม	เ อ ็ ม พ ี ส า ม
รดับ	ร ด ั บ
กระทู้ถาม	ก ร ะ ท ู ้ ถ า ม
ตะพด	ต ะ พ ด
สมเหตุสมผล	ส ม เ ห ต ุ ส ม ผ ล
ติงต๊อง	ต ิ ง ต ๊ อ ง
กษัตรีย์	ก ษ ั ต ร ี ย ์
หอนาฬิกา	ห อ น า ฬ ิ ก า
กระหม่อม	ก ร ะ ห ม ่ อ ม
บาสเกตบอล	บ า ส เ ก ต บ อ ล
บาฮามาส	บ า ฮ า ม า ส
ดุ๊ก	ด ุ ๊ ก
ไพเราะ	ไ พ เ ร า ะ
ละหมาด	ล ะ ห ม า ด
กระตุกหนวดเสือ	ก ร ะ ต ุ ก ห น ว ด เ ส ื อ
มุด	ม ุ ด
รัฐบัญญัติ	ร ั ฐ บ ั ญ ญ ั ต ิ
แนะ	แ น ะ
การแจกแจงความน่าจะเป็น	ก า ร แ จ ก แ จ ง ค ว า ม น ่ า จ ะ เ ป ็ น
ความต่ำ	ค ว า ม ต ่ ำ
ตะกร้อ	ต ะ ก ร ้ อ
สลบ	ส ล บ
คั่ว	ค ั ่ ว
การบรรทม	ก า ร บ ร ร ท ม
มุมแหลม	ม ุ ม แ ห ล ม
สำริด	ส ำ ร ิ ด
ฟันแล้วทิ้ง	ฟ ั น แ ล ้ ว ท ิ ้ ง
เหี้ยม	เ ห ี ้ ย ม
หมี่กรอบ	ห ม ี ่ ก ร อ บ
บรมราชาธีราช	บ ร ม ร า ช า ธ ี ร า ช
เทเบิลเทนนิส	เ ท เ บ ิ ล เ ท น น ิ ส
ไพ่ตาย	ไ พ ่ ต า ย
หัวเข็มขัด	ห ั ว เ ข ็ ม ข ั ด
ก้านชูอับเรณู	ก ้ า น ช ู อ ั บ เ ร ณ ู
ตั๊กแตนตำข้าว	ต ั ๊ ก แ ต น ต ำ ข ้ า ว
ตัวเลือก	ต ั ว เ ล ื อ ก
สงครามโลก	ส ง ค ร า ม โ ล ก
กลอุบาย	ก ล อ ุ บ า ย
อีแอบ	อ ี แ อ บ
ปัญหาข้อเท็จจริง	ป ั ญ ห า ข ้ อ เ ท ็ จ จ ร ิ ง
สัตว์ป่า	ส ั ต ว ์ ป ่ า
ทักษิโณทก	ท ั ก ษ ิ โ ณ ท ก
การกรรโชก	ก า ร ก ร ร โ ช ก
ชื่อผู้ใช้	ช ื ่ อ ผ ู ้ ใ ช ้
ผ้าพันคอ	ผ ้ า พ ั น ค อ
สากลศักราช	ส า ก ล ศ ั ก ร า ช
เซลล์แสงอาทิตย์	เ ซ ล ล ์ แ ส ง อ า ท ิ ต ย ์
นายหน้า	น า ย ห น ้ า
เอกรรถประโยค	เ อ ก ร ร ถ ป ร ะ โ ย ค
ฅน	ฅ น
แกโซลีน	แ ก โ ซ ล ี น
จอม	จ อ ม
ละอองลอย	ล ะ อ อ ง ล อ ย
ขอยาด	ข อ ย า ด
อานุภาวะ	อ า น ุ ภ า ว ะ
นิยาม	น ิ ย า ม
เครย์ฟิช	เ ค ร ย ์ ฟ ิ ช
ไร้สาระ	ไ ร ้ ส า ร ะ
เบ้า	เ บ ้ า
ไวไฟ	ไ ว ไ ฟ
ปทุมุตร	ป ท ุ ม ุ ต ร
กบาล	ก บ า ล
สมชาย	ส ม ช า ย
รอยเท้า	ร อ ย เ ท ้ า
ไขว่	ไ ข ว ่
ขายหน้า	ข า ย ห น ้ า
ทัมบ์ไดรฟ์	ท ั ม บ ์ ไ ด ร ฟ ์
วู่วาม	ว ู ่ ว า ม
หัวดี	ห ั ว ด ี
ประมุข	ป ร ะ ม ุ ข
ดุษฎี	ด ุ ษ ฎ ี
พาชี	พ า ช ี
แฟนเพจ	แ ฟ น เ พ จ
ข้าวเหนียว	ข ้ า ว เ ห น ี ย ว
นทท.	น ท ท .
รู้จักมักคุ้น	ร ู ้ จ ั ก ม ั ก ค ุ ้ น
ความดันโลหิตสูง	ค ว า ม ด ั น โ ล ห ิ ต ส ู ง
เอาใจเขามาใส่ใจเรา	เ อ า ใ จ เ ข า ม า ใ ส ่ ใ จ เ ร า
เกชา	เ ก ช า
วิทยาการลำดับเวลา	ว ิ ท ย า ก า ร ล ำ ด ั บ เ ว ล า
โปแลนด์	โ ป แ ล น ด ์
แวน	แ ว น
พัศดี	พ ั ศ ด ี
หมู่เกาะ	ห ม ู ่ เ ก า ะ
ศารท	ศ า ร ท
ฑูต	ฑ ู ต
ทังสเตน	ท ั ง ส เ ต น
ชมพู	ช ม พ ู
บึงกาฬ	บ ึ ง ก า ฬ
มั่วสุม	ม ั ่ ว ส ุ ม
คริสต์ศักราช	ค ร ิ ส ต ์ ศ ั ก ร า ช
ความน่าเกลียด	ค ว า ม น ่ า เ ก ล ี ย ด
ซอสามสาย	ซ อ ส า ม ส า ย
ทานตะวัน	ท า น ต ะ ว ั น
สิ้นใจ	ส ิ ้ น ใ จ
คาเมเลี่ยน	ค า เ ม เ ล ี ่ ย น
ต่วน	ต ่ ว น
รัชทายาท	ร ั ช ท า ย า ท
ทอ	ท อ
ไซ้	ไ ซ ้
สมณมนตรี	ส ม ณ ม น ต ร ี
จิบ	จ ิ บ
กวยจั๊บ	ก ว ย จ ั ๊ บ
ใยแมงมุม	ใ ย แ ม ง ม ุ ม
ทรงสิบหน้า	ท ร ง ส ิ บ ห น ้ า
หริภุญชัย	ห ร ิ ภ ุ ญ ช ั ย
อันธพาล	อ ั น ธ พ า ล
มนุษย์หมาป่า	ม น ุ ษ ย ์ ห ม า ป ่ า
คำคม	ค ำ ค ม
อารมณ์เปลี่ยว	อ า ร ม ณ ์ เ ป ล ี ่ ย ว
มูลค่าความเสี่ยง	ม ู ล ค ่ า ค ว า ม เ ส ี ่ ย ง
เก็ง	เ ก ็ ง
แคดเมียม	แ ค ด เ ม ี ย ม
ย้อม	ย ้ อ ม
เถ้า	เ ถ ้ า
เสลด	เ ส ล ด
ปฏิสังขรณ์	ป ฏ ิ ส ั ง ข ร ณ ์
แมงลัก	แ ม ง ล ั ก
อภิบาล	อ ภ ิ บ า ล
เพ่ง	เ พ ่ ง
แมวน้ำ	แ ม ว น ้ ำ
ความบีบคั้น	ค ว า ม บ ี บ ค ั ้ น
โกย	โ ก ย
อพยพ	อ พ ย พ
พระพุทธเจ้าข้า	พ ร ะ พ ุ ท ธ เ จ ้ า ข ้ า
จักรวาล	จ ั ก ร ว า ล
หลุมฝังศพ	ห ล ุ ม ฝ ั ง ศ พ
อิมกังจัวยี่	อ ิ ม ก ั ง จ ั ว ย ี ่
ป่าดิบชื้น	ป ่ า ด ิ บ ช ื ้ น
ไทญ้อ	ไ ท ญ ้ อ
แทมพอน	แ ท ม พ อ น
หลงตัวเอง	ห ล ง ต ั ว เ อ ง
หน่วยจินตภาพ	ห น ่ ว ย จ ิ น ต ภ า พ
หน้าแหก	ห น ้ า แ ห ก
หัวเก่า	ห ั ว เ ก ่ า
สีหน้า	ส ี ห น ้ า
เบ้อเริ่ม	เ บ ้ อ เ ร ิ ่ ม
ลิ้นชัก	ล ิ ้ น ช ั ก
แปดสิบ	แ ป ด ส ิ บ
ลาเวนเดอร์	ล า เ ว น เ ด อ ร ์
วิฬา	ว ิ ฬ า
โคมเขียว	โ ค ม เ ข ี ย ว
บรรพชีวินวิทยา	บ ร ร พ ช ี ว ิ น ว ิ ท ย า
ตีปลาหน้าไซ	ต ี ป ล า ห น ้ า ไ ซ
ผีดูดเลือด	ผ ี ด ู ด เ ล ื อ ด
มะละกอ	ม ะ ล ะ ก อ
เอดินบะระ	เ อ ด ิ น บ ะ ร ะ
ปัญหาโลกแตก	ป ั ญ ห า โ ล ก แ ต ก
เพียร	เ พ ี ย ร
บักกุ๊ดเต๋	บ ั ก ก ุ ๊ ด เ ต ๋
น้ำอำพัน	น ้ ำ อ ำ พ ั น
มโนกรรม	ม โ น ก ร ร ม
คนเดือนตุลา	ค น เ ด ื อ น ต ุ ล า
ขพุง	ข พ ุ ง
โตนด	โ ต น ด
หีบเพลง	ห ี บ เ พ ล ง
การหุง	ก า ร ห ุ ง
ทั้ง	ท ั ้ ง
ที่สิบสอง	ท ี ่ ส ิ บ ส อ ง
ปั่นป่วน	ป ั ่ น ป ่ ว น
เมี่ยงคำ	เ ม ี ่ ย ง ค ำ
พเยีย	พ เ ย ี ย
น่านับถือ	น ่ า น ั บ ถ ื อ
ถลก	ถ ล ก
ภุมรี	ภ ุ ม ร ี
ตู้เสื้อผ้า	ต ู ้ เ ส ื ้ อ ผ ้ า
กระปี๋	ก ร ะ ป ี ๋
ไฟฉาย	ไ ฟ ฉ า ย
ประชด	ป ร ะ ช ด
หนังสือการ์ตูนญี่ปุ่น	ห น ั ง ส ื อ ก า ร ์ ต ู น ญ ี ่ ป ุ ่ น
ฟักข้าว	ฟ ั ก ข ้ า ว
กระดาษแก้ว	ก ร ะ ด า ษ แ ก ้ ว
ห้องน้ำ	ห ้ อ ง น ้ ำ
เซลฟี	เ ซ ล ฟ ี
ร่มเย็น	ร ่ ม เ ย ็ น
ฟ้าเหลือง	ฟ ้ า เ ห ล ื อ ง
ฮัลโล	ฮ ั ล โ ล
เต้าเจี้ยว	เ ต ้ า เ จ ี ้ ย ว
ผู้ว่าการ	ผ ู ้ ว ่ า ก า ร
แถบดาวเคราะห์น้อย	แ ถ บ ด า ว เ ค ร า ะ ห ์ น ้ อ ย
เถอะ	เ ถ อ ะ
สาบาน	ส า บ า น
พืชใบเลี้ยงเดี่ยว	พ ื ช ใ บ เ ล ี ้ ย ง เ ด ี ่ ย ว
การคว่ำบาตร	ก า ร ค ว ่ ำ บ า ต ร
บิกแบง	บ ิ ก แ บ ง
มั่ว	ม ั ่ ว
น้ำปลา	น ้ ำ ป ล า
รุกราน	ร ุ ก ร า น
สแกนดิเนเวีย	ส แ ก น ด ิ เ น เ ว ี ย
เทพธิดา	เ ท พ ธ ิ ด า
บรมราชา	บ ร ม ร า ช า
ตะบอง	ต ะ บ อ ง
เอาจริง	เ อ า จ ร ิ ง
ขลุ่ยหลิบ	ข ล ุ ่ ย ห ล ิ บ
หน้ากากอนามัย	ห น ้ า ก า ก อ น า ม ั ย
การตะโกน	ก า ร ต ะ โ ก น
สิบเหลี่ยม	ส ิ บ เ ห ล ี ่ ย ม
โยเกิร์ต	โ ย เ ก ิ ร ์ ต
ผู้หญิงหากิน	ผ ู ้ ห ญ ิ ง ห า ก ิ น
ผาก	ผ า ก
ศัพท์บัญญัติ	ศ ั พ ท ์ บ ั ญ ญ ั ต ิ
ฉ่ำ	ฉ ่ ำ
หัวไส้	ห ั ว ไ ส ้
ช่องอก	ช ่ อ ง อ ก
สารถี	ส า ร ถ ี
ลอกคราบ	ล อ ก ค ร า บ
แนว	แ น ว
แอนตาร์กติกา	แ อ น ต า ร ์ ก ต ิ ก า
น้ำเน่า	น ้ ำ เ น ่ า
ลอบสังหาร	ล อ บ ส ั ง ห า ร
กรดไขมัน	ก ร ด ไ ข ม ั น
ไฮ้	ไ ฮ ้
จับหวัด	จ ั บ ห ว ั ด
เครื่องสาย	เ ค ร ื ่ อ ง ส า ย
เล่นสวาท	เ ล ่ น ส ว า ท
ซ่องโสเภณี	ซ ่ อ ง โ ส เ ภ ณ ี
อไญยนิยม	อ ไ ญ ย น ิ ย ม
ไข้กระต่าย	ไ ข ้ ก ร ะ ต ่ า ย
หมึกกล้วย	ห ม ึ ก ก ล ้ ว ย
น้ำจิ้ม	น ้ ำ จ ิ ้ ม
กรุงเฮก	ก ร ุ ง เ ฮ ก
บั่ว	บ ั ่ ว
กันสาด	ก ั น ส า ด
จัดแจง	จ ั ด แ จ ง
ผู้ค้าขาย	ผ ู ้ ค ้ า ข า ย
หน่วยไต	ห น ่ ว ย ไ ต
มาตุฆาต	ม า ต ุ ฆ า ต
บัลแกเรีย	บ ั ล แ ก เ ร ี ย
เสียงลือเสียงเล่าอ้าง	เ ส ี ย ง ล ื อ เ ส ี ย ง เ ล ่ า อ ้ า ง
การเวก	ก า ร เ ว ก
ไทเบิ้ง	ไ ท เ บ ิ ้ ง
เทศน์แหล่	เ ท ศ น ์ แ ห ล ่
หมูหริ่ง	ห ม ู ห ร ิ ่ ง
ตัวนำ	ต ั ว น ำ
เสนา	เ ส น า
พนักงานขาย	พ น ั ก ง า น ข า ย
จ๊าก	จ ๊ า ก
มิ่ง	ม ิ ่ ง
ไหวหวั่น	ไ ห ว ห ว ั ่ น
เปราะ	เ ป ร า ะ
น้ำตา	น ้ ำ ต า
ทรัสต์	ท ร ั ส ต ์
แม่มด	แ ม ่ ม ด
ซาละเปา	ซ า ล ะ เ ป า
น้ำปูนใส	น ้ ำ ป ู น ใ ส
ทุพพลภาพ	ท ุ พ พ ล ภ า พ
วีดิโอ	ว ี ด ิ โ อ
รังมด	ร ั ง ม ด
ไอศครีม	ไ อ ศ ค ร ี ม
ผู้เห็นเหตุการณ์	ผ ู ้ เ ห ็ น เ ห ต ุ ก า ร ณ ์
สี่สิบสาม	ส ี ่ ส ิ บ ส า ม
พืดหินปะการัง	พ ื ด ห ิ น ป ะ ก า ร ั ง
นักรบ	น ั ก ร บ
ต่อมลูกหมาก	ต ่ อ ม ล ู ก ห ม า ก
บทกวี	บ ท ก ว ี
น้ำยาล้างจาน	น ้ ำ ย า ล ้ า ง จ า น
ศาลยุติธรรมระหว่างประเทศ	ศ า ล ย ุ ต ิ ธ ร ร ม ร ะ ห ว ่ า ง ป ร ะ เ ท ศ
ปิตร	ป ิ ต ร
ชาขาว	ช า ข า ว
วันที่	ว ั น ท ี ่
พูนสวัสดิ์	พ ู น ส ว ั ส ด ิ ์
ละเมอ	ล ะ เ ม อ
หัดเยอรมัน	ห ั ด เ ย อ ร ม ั น
การบังคม	ก า ร บ ั ง ค ม
กรณีพิพาท	ก ร ณ ี พ ิ พ า ท
๕	๕
โฮลเมียม	โ ฮ ล เ ม ี ย ม
น้ำมันหอมระเหย	น ้ ำ ม ั น ห อ ม ร ะ เ ห ย
ดีบุก	ด ี บ ุ ก
การฉ้อโกง	ก า ร ฉ ้ อ โ ก ง
ค้ำ	ค ้ ำ
เหม่อ	เ ห ม ่ อ
กระพัน	ก ร ะ พ ั น
การแกล้ง	ก า ร แ ก ล ้ ง
เอดส์	เ อ ด ส ์
แปด	แ ป ด
เฟสบุ๊ค	เ ฟ ส บ ุ ๊ ค
ความเร็วหลุดพ้น	ค ว า ม เ ร ็ ว ห ล ุ ด พ ้ น
ตุ๊กแก	ต ุ ๊ ก แ ก
มรณบัตร	ม ร ณ บ ั ต ร
กะเหรี่ยง	ก ะ เ ห ร ี ่ ย ง
ที่ทำการไปรษณีย์	ท ี ่ ท ำ ก า ร ไ ป ร ษ ณ ี ย ์
อุปโภค	อ ุ ป โ ภ ค
อ้อน	อ ้ อ น
กระโถน	ก ร ะ โ ถ น
เทิน	เ ท ิ น
หนุมานถวายแหวน	ห น ุ ม า น ถ ว า ย แ ห ว น
ทูเลียม	ท ู เ ล ี ย ม
มาราธอน	ม า ร า ธ อ น
ระบบประสาท	ร ะ บ บ ป ร ะ ส า ท
บัลเลต์	บ ั ล เ ล ต ์
พรรคการเมือง	พ ร ร ค ก า ร เ ม ื อ ง
ความวิปลาส	ค ว า ม ว ิ ป ล า ส
ภัตตาหาร	ภ ั ต ต า ห า ร
กองทัพบก	ก อ ง ท ั พ บ ก
น่านน้ำ	น ่ า น น ้ ำ
อั่งเปา	อ ั ่ ง เ ป า
นักวิทยาการระบาด	น ั ก ว ิ ท ย า ก า ร ร ะ บ า ด
อ่อย	อ ่ อ ย
มหิตลาธิเบศร	ม ห ิ ต ล า ธ ิ เ บ ศ ร
แผด	แ ผ ด
เขย่า	เ ข ย ่ า
บ/ช	บ / ช
หวาย	ห ว า ย
เด็กหญิง	เ ด ็ ก ห ญ ิ ง
เลบานอน	เ ล บ า น อ น
ทำศพ	ท ำ ศ พ
แหะ	แ ห ะ
มองโกเลีย	ม อ ง โ ก เ ล ี ย
สัปเหร่อ	ส ั ป เ ห ร ่ อ
กระอัก	ก ร ะ อ ั ก
โครงข่ายประสาท	โ ค ร ง ข ่ า ย ป ร ะ ส า ท
คนไข้	ค น ไ ข ้
เตาผิง	เ ต า ผ ิ ง
ฟุ้ง	ฟ ุ ้ ง
ยีสต์	ย ี ส ต ์
ชุดนอน	ช ุ ด น อ น
วารสาร	ว า ร ส า ร
ภูมิปัญญา	ภ ู ม ิ ป ั ญ ญ า
ที่นอนหมอนมุ้ง	ท ี ่ น อ น ห ม อ น ม ุ ้ ง
ไฮเพอร์โบลา	ไ ฮ เ พ อ ร ์ โ บ ล า
พระองค์เจ้า	พ ร ะ อ ง ค ์ เ จ ้ า
๑๒	๑ ๒
รัฐประหาร	ร ั ฐ ป ร ะ ห า ร
พลาซ่า	พ ล า ซ ่ า
สิ้นดี	ส ิ ้ น ด ี
ตะแกรง	ต ะ แ ก ร ง
ปัตตานี	ป ั ต ต า น ี
มีผลบังคับใช้	ม ี ผ ล บ ั ง ค ั บ ใ ช ้
เบี้ยว	เ บ ี ้ ย ว
ปราศรัย	ป ร า ศ ร ั ย
กลมกล่อม	ก ล ม ก ล ่ อ ม
ยูทูบ	ย ู ท ู บ
วายวาง	ว า ย ว า ง
นครหลวง	น ค ร ห ล ว ง
ภาษาโปรแกรม	ภ า ษ า โ ป ร แ ก ร ม
ฟาง	ฟ า ง
โลมา	โ ล ม า
ดับเบิลยู	ด ั บ เ บ ิ ล ย ู
พิมพ์เขียว	พ ิ ม พ ์ เ ข ี ย ว
น้ำกาม	น ้ ำ ก า ม
ความฉิบหาย	ค ว า ม ฉ ิ บ ห า ย
การพิพาท	ก า ร พ ิ พ า ท
บีตรูต	บ ี ต ร ู ต
สเต๊ก	ส เ ต ๊ ก
ปากหอยปากปู	ป า ก ห อ ย ป า ก ป ู
เอสโตเนีย	เ อ ส โ ต เ น ี ย
การดูหมิ่นซึ่งหน้า	ก า ร ด ู ห ม ิ ่ น ซ ึ ่ ง ห น ้ า
บัณฑิตย์	บ ั ณ ฑ ิ ต ย ์
น่ากิน	น ่ า ก ิ น
ถ่านไม้	ถ ่ า น ไ ม ้
เครื่องกรอง	เ ค ร ื ่ อ ง ก ร อ ง
สถานแสดงพันธุ์สัตว์น้ำ	ส ถ า น แ ส ด ง พ ั น ธ ุ ์ ส ั ต ว ์ น ้ ำ
แอ้ม	แ อ ้ ม
ชื่อเสีย	ช ื ่ อ เ ส ี ย
ขั้นตอนวิธี	ข ั ้ น ต อ น ว ิ ธ ี
เส้นทแยงมุม	เ ส ้ น ท แ ย ง ม ุ ม
เศร้าโศก	เ ศ ร ้ า โ ศ ก
เพดานปาก	เ พ ด า น ป า ก
วิสูตร	ว ิ ส ู ต ร
ปุบปับ	ป ุ บ ป ั บ
โรหิณี	โ ร ห ิ ณ ี
เบือน	เ บ ื อ น
เฉา	เ ฉ า
กัญชา	ก ั ญ ช า
อัลดิบาแรน	อ ั ล ด ิ บ า แ ร น
ไข่คน	ไ ข ่ ค น
เดนมาร์ก	เ ด น ม า ร ์ ก
พิธีกรรม	พ ิ ธ ี ก ร ร ม
สัมประสิทธิ์	ส ั ม ป ร ะ ส ิ ท ธ ิ ์
การแตกหน่อ	ก า ร แ ต ก ห น ่ อ
บุษบา	บ ุ ษ บ า
ปังตอ	ป ั ง ต อ
ฝักบัว	ฝ ั ก บ ั ว
หนังสืออ้างอิง	ห น ั ง ส ื อ อ ้ า ง อ ิ ง
ขลุ่ยอู้	ข ล ุ ่ ย อ ู ้
เพิกเฉย	เ พ ิ ก เ ฉ ย
อิกลู	อ ิ ก ล ู
โอมาฮา	โ อ ม า ฮ า
พริ้ว	พ ร ิ ้ ว
อดเปรี้ยวไว้กินหวาน	อ ด เ ป ร ี ้ ย ว ไ ว ้ ก ิ น ห ว า น
น้ำเลี้ยง	น ้ ำ เ ล ี ้ ย ง
ขลิบ	ข ล ิ บ
ความต่าง	ค ว า ม ต ่ า ง
นายทวาร	น า ย ท ว า ร
สักขีพยาน	ส ั ก ข ี พ ย า น
กม	ก ม
รีโมตคอนโทรล	ร ี โ ม ต ค อ น โ ท ร ล
ความควบคุม	ค ว า ม ค ว บ ค ุ ม
กากบาท	ก า ก บ า ท
ปราชญ์	ป ร า ช ญ ์
สวมเขา	ส ว ม เ ข า
แฅ่ง	แ ฅ ่ ง
การเข้าเมือง	ก า ร เ ข ้ า เ ม ื อ ง
ไกว	ไ ก ว
คีบ	ค ี บ
ฉลามวาฬ	ฉ ล า ม ว า ฬ
หน้าเน่า	ห น ้ า เ น ่ า
ลับแล	ล ั บ แ ล
ผ้าอ้อม	ผ ้ า อ ้ อ ม
จับมือ	จ ั บ ม ื อ
กระบอกเสียง	ก ร ะ บ อ ก เ ส ี ย ง
การเล่นแร่แปรธาตุ	ก า ร เ ล ่ น แ ร ่ แ ป ร ธ า ต ุ
บ้าหมู	บ ้ า ห ม ู
ประจิม	ป ร ะ จ ิ ม
เรดาร์	เ ร ด า ร ์
ห้องปิดตาย	ห ้ อ ง ป ิ ด ต า ย
ล่ำซำ	ล ่ ำ ซ ำ
การแจกแจง	ก า ร แ จ ก แ จ ง
เหน็บแนม	เ ห น ็ บ แ น ม
หมู่เกาะมาร์แชลล์	ห ม ู ่ เ ก า ะ ม า ร ์ แ ช ล ล ์
ทูลกระหม่อม	ท ู ล ก ร ะ ห ม ่ อ ม
บาร์เลย์	บ า ร ์ เ ล ย ์
ตื่นขึ้น	ต ื ่ น ข ึ ้ น
แคเมอรูน	แ ค เ ม อ ร ู น
หมายจำคุก	ห ม า ย จ ำ ค ุ ก
นักกิน	น ั ก ก ิ น
เหรา	เ ห ร า
สัณฑ์	ส ั ณ ฑ ์
หีบ	ห ี บ
การล่าแม่มด	ก า ร ล ่ า แ ม ่ ม ด
การปล้นทรัพย์	ก า ร ป ล ้ น ท ร ั พ ย ์
คีตกวี	ค ี ต ก ว ี
อุดมคติ	อ ุ ด ม ค ต ิ
เข๋า	เ ข ๋ า
นักขี่ม้าแข่ง	น ั ก ข ี ่ ม ้ า แ ข ่ ง
เพศกลาง	เ พ ศ ก ล า ง
ตาบอดสี	ต า บ อ ด ส ี
ภาคยานุวัติสาร	ภ า ค ย า น ุ ว ั ต ิ ส า ร
เล้า	เ ล ้ า
เจริญพร	เ จ ร ิ ญ พ ร
ก็อป	ก ็ อ ป
ความเบื่อ	ค ว า ม เ บ ื ่ อ
มหาเถร	ม ห า เ ถ ร
แก็ง	แ ก ็ ง
บรรลัย	บ ร ร ล ั ย
มุมไบ	ม ุ ม ไ บ
ตายตัว	ต า ย ต ั ว
มหาดเล็ก	ม ห า ด เ ล ็ ก
อภิเษก	อ ภ ิ เ ษ ก
ง้าง	ง ้ า ง
น้ำประปา	น ้ ำ ป ร ะ ป า
ลูกเธอ	ล ู ก เ ธ อ
หินทรายแป้ง	ห ิ น ท ร า ย แ ป ้ ง
บิสกิต	บ ิ ส ก ิ ต
วิลาด	ว ิ ล า ด
ภาษาต่างประเทศ	ภ า ษ า ต ่ า ง ป ร ะ เ ท ศ
ว่างงาน	ว ่ า ง ง า น
สันตะสำนัก	ส ั น ต ะ ส ำ น ั ก
ข้ามน้ำข้ามทะเล	ข ้ า ม น ้ ำ ข ้ า ม ท ะ เ ล
สาธารณรัฐจีน	ส า ธ า ร ณ ร ั ฐ จ ี น
พะเยา	พ ะ เ ย า
จรรยา	จ ร ร ย า
ถีบหัวส่ง	ถ ี บ ห ั ว ส ่ ง
เกล็ดหิมะ	เ ก ล ็ ด ห ิ ม ะ
หนังหุ้มปลาย	ห น ั ง ห ุ ้ ม ป ล า ย
ลูกอ๊อด	ล ู ก อ ๊ อ ด
ข้าวเปลือก	ข ้ า ว เ ป ล ื อ ก
เพนกวิน	เ พ น ก ว ิ น
กุมารี	ก ุ ม า ร ี
มฤค	ม ฤ ค
ไม้บาง	ไ ม ้ บ า ง
เยื้องย่าง	เ ย ื ้ อ ง ย ่ า ง
สหัสวรรษ	ส ห ั ส ว ร ร ษ
ท่องจำ	ท ่ อ ง จ ำ
เฟ้น	เ ฟ ้ น
เรดอน	เ ร ด อ น
ลำลอง	ล ำ ล อ ง
หมื่นนคร	ห ม ื ่ น น ค ร
สวิตเซอร์แลนด์	ส ว ิ ต เ ซ อ ร ์ แ ล น ด ์
อนธการ	อ น ธ ก า ร
ถวายพระพร	ถ ว า ย พ ร ะ พ ร
ประโคม	ป ร ะ โ ค ม
ไทเป	ไ ท เ ป
บริบูรณ์	บ ร ิ บ ู ร ณ ์
เหินห่าง	เ ห ิ น ห ่ า ง
เห็ดรา	เ ห ็ ด ร า
ส่งไม้ต่อ	ส ่ ง ไ ม ้ ต ่ อ
นารายน์	น า ร า ย น ์
สวนสนุก	ส ว น ส น ุ ก
น้ำยาลบคำผิด	น ้ ำ ย า ล บ ค ำ ผ ิ ด
เพื่อนกิน	เ พ ื ่ อ น ก ิ น
ตกทอด	ต ก ท อ ด
การคัดเลือกโดยธรรมชาติ	ก า ร ค ั ด เ ล ื อ ก โ ด ย ธ ร ร ม ช า ต ิ
ไต่	ไ ต ่
หมาจิ้งจอกทอง	ห ม า จ ิ ้ ง จ อ ก ท อ ง
การบริจาค	ก า ร บ ร ิ จ า ค
สามัญสำนึก	ส า ม ั ญ ส ำ น ึ ก
ปรัศนี	ป ร ั ศ น ี
ลอตเตอรี่	ล อ ต เ ต อ ร ี ่
ร้าวราน	ร ้ า ว ร า น
ดินหางยาว	ด ิ น ห า ง ย า ว
ข้าวคลุกกะปิ	ข ้ า ว ค ล ุ ก ก ะ ป ิ
ผู้ทำหม้อ	ผ ู ้ ท ำ ห ม ้ อ
กะทันหัน	ก ะ ท ั น ห ั น
กบ	ก บ
ชาห์	ช า ห ์
หม่อม	ห ม ่ อ ม
ดยุก	ด ย ุ ก
ข่มเหง	ข ่ ม เ ห ง
ลูกเล่น	ล ู ก เ ล ่ น
โสร่ง	โ ส ร ่ ง
วาล์ว	ว า ล ์ ว
ร่อง	ร ่ อ ง
ปาฏิหาริย์	ป า ฏ ิ ห า ร ิ ย ์
เสื้อแจ็กเก็ต	เ ส ื ้ อ แ จ ็ ก เ ก ็ ต
โฮจิมินห์	โ ฮ จ ิ ม ิ น ห ์
ดาวแคระน้ำตาล	ด า ว แ ค ร ะ น ้ ำ ต า ล
พฤษภ	พ ฤ ษ ภ
แก้วตา	แ ก ้ ว ต า
ลูกแก้ว	ล ู ก แ ก ้ ว
คู่หู	ค ู ่ ห ู
ข้าวฟ่าง	ข ้ า ว ฟ ่ า ง
ขุนทอง	ข ุ น ท อ ง
ตะฃอ	ต ะ ฃ อ
ธารายนต์	ธ า ร า ย น ต ์
พะแนง	พ ะ แ น ง
พะยะค่ะ	พ ะ ย ะ ค ่ ะ
คฤหัสถ์	ค ฤ ห ั ส ถ ์
หญัว	ห ญ ั ว
การวายชนม์	ก า ร ว า ย ช น ม ์
ปากน้ำ	ป า ก น ้ ำ
ปั้ม	ป ั ้ ม
หอสมุด	ห อ ส ม ุ ด
อภิธรรม	อ ภ ิ ธ ร ร ม
ภาพยนตร์การ์ตูน	ภ า พ ย น ต ร ์ ก า ร ์ ต ู น
หัวร้อน	ห ั ว ร ้ อ น
แซว	แ ซ ว
ยาแก้ปวด	ย า แ ก ้ ป ว ด
รังแค	ร ั ง แ ค
กางเกงขาสั้น	ก า ง เ ก ง ข า ส ั ้ น
ผู้สอบบัญชี	ผ ู ้ ส อ บ บ ั ญ ช ี
หยิบมือ	ห ย ิ บ ม ื อ
วรรณกรรม	ว ร ร ณ ก ร ร ม
แม่อยู่หัว	แ ม ่ อ ย ู ่ ห ั ว
แปะก๊วย	แ ป ะ ก ๊ ว ย
อักษรต่ำ	อ ั ก ษ ร ต ่ ำ
สังคัง	ส ั ง ค ั ง
สิบเก้า	ส ิ บ เ ก ้ า
ลมแรง	ล ม แ ร ง
โพดำ	โ พ ด ำ
ฟ้าทะลายโจร	ฟ ้ า ท ะ ล า ย โ จ ร
เพียงออ	เ พ ี ย ง อ อ
กลบบัตรสุมเพลิง	ก ล บ บ ั ต ร ส ุ ม เ พ ล ิ ง
ข้าวโพดอ่อน	ข ้ า ว โ พ ด อ ่ อ น
คู่สมรส	ค ู ่ ส ม ร ส
เยิน	เ ย ิ น
ศักดิ์ศรี	ศ ั ก ด ิ ์ ศ ร ี
วิเสท	ว ิ เ ส ท
ศาสนาฮินดู	ศ า ส น า ฮ ิ น ด ู
ฟัด	ฟ ั ด
ม่าย	ม ่ า ย
นายิกา	น า ย ิ ก า
ลุล่วง	ล ุ ล ่ ว ง
ประวัติย่อ	ป ร ะ ว ั ต ิ ย ่ อ
ปลอกนิ้ว	ป ล อ ก น ิ ้ ว
ทำท่า	ท ำ ท ่ า
หน้าปัด	ห น ้ า ป ั ด
อาชกาบัต	อ า ช ก า บ ั ต
ลิเก	ล ิ เ ก
ตุ่มรับรส	ต ุ ่ ม ร ั บ ร ส
ลิทัวเนีย	ล ิ ท ั ว เ น ี ย
กฎจราจร	ก ฎ จ ร า จ ร
โรแมนติก	โ ร แ ม น ต ิ ก
ตูนิเซีย	ต ู น ิ เ ซ ี ย
เกร็ง	เ ก ร ็ ง
หมดหวัง	ห ม ด ห ว ั ง
ตลาดนัด	ต ล า ด น ั ด
บีเทลจุส	บ ี เ ท ล จ ุ ส
อนุญาติ	อ น ุ ญ า ต ิ
โภชนะ	โ ภ ช น ะ
ยิปซี	ย ิ ป ซ ี
ที่สี่	ท ี ่ ส ี ่
วิวรณ์	ว ิ ว ร ณ ์
คงทน	ค ง ท น
หอยเชลล์	ห อ ย เ ช ล ล ์
อาบแดด	อ า บ แ ด ด
ฉุน	ฉ ุ น
คำตอบ	ค ำ ต อ บ
กูด	ก ู ด
หวย	ห ว ย
ความหยิ่ง	ค ว า ม ห ย ิ ่ ง
ค้ามนุษย์	ค ้ า ม น ุ ษ ย ์
ยูทูป	ย ู ท ู ป
อัคนี	อ ั ค น ี
การฝึกหัด	ก า ร ฝ ึ ก ห ั ด
อัลกอริทึม	อ ั ล ก อ ร ิ ท ึ ม
รักเพศเดียวกัน	ร ั ก เ พ ศ เ ด ี ย ว ก ั น
จอมพล	จ อ ม พ ล
มังสวิรัติ	ม ั ง ส ว ิ ร ั ต ิ
ถังขยะ	ถ ั ง ข ย ะ
พลากร	พ ล า ก ร
อ่างอาบน้ำ	อ ่ า ง อ า บ น ้ ำ
สวิส	ส ว ิ ส
เป่ายิ้งฉุบ	เ ป ่ า ย ิ ้ ง ฉ ุ บ
เกลือเป็นหนอน	เ ก ล ื อ เ ป ็ น ห น อ น
การปรึกษา	ก า ร ป ร ึ ก ษ า
สนญ.	ส น ญ .
ตำแย	ต ำ แ ย
ซุบซิบ	ซ ุ บ ซ ิ บ
โทสะ	โ ท ส ะ
ลิสง	ล ิ ส ง
วาฬเพชฌฆาต	ว า ฬ เ พ ช ฌ ฆ า ต
ความหนืด	ค ว า ม ห น ื ด
ช่างทอง	ช ่ า ง ท อ ง
อัศจรรย์	อ ั ศ จ ร ร ย ์
ปาทังกา	ป า ท ั ง ก า
รับน้อง	ร ั บ น ้ อ ง
ตาว	ต า ว
แม่เบี้ย	แ ม ่ เ บ ี ้ ย
ปึก	ป ึ ก
เหล็กใน	เ ห ล ็ ก ใ น
ความกล้า	ค ว า ม ก ล ้ า
โหราธิบดี	โ ห ร า ธ ิ บ ด ี
กวางมูส	ก ว า ง ม ู ส
การอภิปราย	ก า ร อ ภ ิ ป ร า ย
สีเทียน	ส ี เ ท ี ย น
น้ำมนต์	น ้ ำ ม น ต ์
เหลียว	เ ห ล ี ย ว
ราชสีห์	ร า ช ส ี ห ์
บำเหน็จ	บ ำ เ ห น ็ จ
แหนบ	แ ห น บ
เห็นใจ	เ ห ็ น ใ จ
กาญจนาภิเษก	ก า ญ จ น า ภ ิ เ ษ ก
สะกิด	ส ะ ก ิ ด
การบงการ	ก า ร บ ง ก า ร
นอร์ทมาซิโดเนีย	น อ ร ์ ท ม า ซ ิ โ ด เ น ี ย
นักขัตฤกษ์	น ั ก ข ั ต ฤ ก ษ ์
ซ้ำซาก	ซ ้ ำ ซ า ก
หลุดมือ	ห ล ุ ด ม ื อ
น้ำแข็งแห้ง	น ้ ำ แ ข ็ ง แ ห ้ ง
ชาติพันธุ์	ช า ต ิ พ ั น ธ ุ ์
สวามี	ส ว า ม ี
ตรึง	ต ร ึ ง
ไข้หวัด	ไ ข ้ ห ว ั ด
เพชรตัดเพชร	เ พ ช ร ต ั ด เ พ ช ร
บูด	บ ู ด
กรีฑา	ก ร ี ฑ า
หับเผย	ห ั บ เ ผ ย
สวัสดี	ส ว ั ส ด ี
วีดิทัศน์	ว ี ด ิ ท ั ศ น ์
อุบัติเหตุ	อ ุ บ ั ต ิ เ ห ต ุ
ธูปฤๅษี	ธ ู ป ฤ ๅ ษ ี
เกริก	เ ก ร ิ ก
สยิว	ส ย ิ ว
นายแบบ	น า ย แ บ บ
การกักกัน	ก า ร ก ั ก ก ั น
ไซแนปส์	ไ ซ แ น ป ส ์
สุดขีด	ส ุ ด ข ี ด
สวนหลังบ้าน	ส ว น ห ล ั ง บ ้ า น
มหาลัย	ม ห า ล ั ย
การสาบาน	ก า ร ส า บ า น
ไฟไหม้	ไ ฟ ไ ห ม ้
เพื่อนตาย	เ พ ื ่ อ น ต า ย
บทละคร	บ ท ล ะ ค ร
ขนมเปี๊ยะ	ข น ม เ ป ี ๊ ย ะ
ม.ศ.	ม . ศ .
เหลืองปรีดิยาธร	เ ห ล ื อ ง ป ร ี ด ิ ย า ธ ร
อุตุนิยม	อ ุ ต ุ น ิ ย ม
ลูกปัด	ล ู ก ป ั ด
ปริมาตร	ป ร ิ ม า ต ร
ละครน้ำเน่า	ล ะ ค ร น ้ ำ เ น ่ า
เสือหมอบแมวเซา	เ ส ื อ ห ม อ บ แ ม ว เ ซ า
อารทรา	อ า ร ท ร า
คืนวัน	ค ื น ว ั น
กาละเทศะ	ก า ล ะ เ ท ศ ะ
แอลเบเนีย	แ อ ล เ บ เ น ี ย
เชษฐา	เ ช ษ ฐ า
กินไข่แดง	ก ิ น ไ ข ่ แ ด ง
ฆ้อง	ฆ ้ อ ง
คลาดเคลื่อน	ค ล า ด เ ค ล ื ่ อ น
อุดหนุน	อ ุ ด ห น ุ น
รักแร้	ร ั ก แ ร ้
วัยเด็ก	ว ั ย เ ด ็ ก
แคล	แ ค ล
รำชั่วโทษพาทย์	ร ำ ช ั ่ ว โ ท ษ พ า ท ย ์
โรงหญิงโสเภณี	โ ร ง ห ญ ิ ง โ ส เ ภ ณ ี
ความละอาย	ค ว า ม ล ะ อ า ย
อัฐ	อ ั ฐ
ต่างเพศ	ต ่ า ง เ พ ศ
เสนาบดี	เ ส น า บ ด ี
เล็กพริกขี้หนู	เ ล ็ ก พ ร ิ ก ข ี ้ ห น ู
การข่มขืน	ก า ร ข ่ ม ข ื น
สไลด์หนอน	ส ไ ล ด ์ ห น อ น
แก้ผ้า	แ ก ้ ผ ้ า
โฉนด	โ ฉ น ด
เสน่ง	เ ส น ่ ง
ตารางวา	ต า ร า ง ว า
เงาะโรงเรียน	เ ง า ะ โ ร ง เ ร ี ย น
อ้วก	อ ้ ว ก
รถเข็นเด็ก	ร ถ เ ข ็ น เ ด ็ ก
โพรมีเทียม	โ พ ร ม ี เ ท ี ย ม
ไม้เท้า	ไ ม ้ เ ท ้ า
ยี่สิบห้า	ย ี ่ ส ิ บ ห ้ า
พล	พ ล
เพจ	เ พ จ
ไมกา	ไ ม ก า
นามบัตร	น า ม บ ั ต ร
โหนก	โ ห น ก
มังคุด	ม ั ง ค ุ ด
พิธีการ	พ ิ ธ ี ก า ร
ปลาร้า	ป ล า ร ้ า
ผักโขม	ผ ั ก โ ข ม
อังการา	อ ั ง ก า ร า
ขานขันหมาก	ข า น ข ั น ห ม า ก
ปะการัง	ป ะ ก า ร ั ง
ข้าวมันไก่	ข ้ า ว ม ั น ไ ก ่
แซนด์วิช	แ ซ น ด ์ ว ิ ช
ชีตาห์	ช ี ต า ห ์
หุบ	ห ุ บ
ยาสีฟัน	ย า ส ี ฟ ั น
แกรด	แ ก ร ด
บะหมี่กึ่งสำเร็จรูป	บ ะ ห ม ี ่ ก ึ ่ ง ส ำ เ ร ็ จ ร ู ป
ลูกความ	ล ู ก ค ว า ม
ความสยิว	ค ว า ม ส ย ิ ว
พาสุกรี	พ า ส ุ ก ร ี
แต๊ะอั๋ง	แ ต ๊ ะ อ ั ๋ ง
หัวเรือ	ห ั ว เ ร ื อ
น้ำเสียง	น ้ ำ เ ส ี ย ง
รบาญ	ร บ า ญ
โชย	โ ช ย
ชัยภูมิ	ช ั ย ภ ู ม ิ
แมนจูเรีย	แ ม น จ ู เ ร ี ย
อารูบา	อ า ร ู บ า
ข่วน	ข ่ ว น
นิ้วนาง	น ิ ้ ว น า ง
การอม	ก า ร อ ม
ตะพาบ	ต ะ พ า บ
ปุย	ป ุ ย
สมาชิกรัฐสภา	ส ม า ช ิ ก ร ั ฐ ส ภ า
เย็นชา	เ ย ็ น ช า
จุมพต	จ ุ ม พ ต
ทำสมาธิ	ท ำ ส ม า ธ ิ
ความสูง	ค ว า ม ส ู ง
ระแวง	ร ะ แ ว ง
การบ่อน	ก า ร บ ่ อ น
บังเหียน	บ ั ง เ ห ี ย น
กรดไขมันไม่อิ่มตัว	ก ร ด ไ ข ม ั น ไ ม ่ อ ิ ่ ม ต ั ว
มึน	ม ึ น
หับ	ห ั บ
สามเหลี่ยม	ส า ม เ ห ล ี ่ ย ม
กฎบัตร	ก ฎ บ ั ต ร
หุ่นไล่กา	ห ุ ่ น ไ ล ่ ก า
ปิดตาย	ป ิ ด ต า ย
เลื่อนลอย	เ ล ื ่ อ น ล อ ย
ประธานาธิบดี	ป ร ะ ธ า น า ธ ิ บ ด ี
แว่นกันแดด	แ ว ่ น ก ั น แ ด ด
นครลำปาง	น ค ร ล ำ ป า ง
การค้ามนุษย์	ก า ร ค ้ า ม น ุ ษ ย ์
จุฬา	จ ุ ฬ า
ฟาสซิสต์	ฟ า ส ซ ิ ส ต ์
ปักเป้า	ป ั ก เ ป ้ า
การทอดพระเนตร	ก า ร ท อ ด พ ร ะ เ น ต ร
เป็นตัวของตัวเอง	เ ป ็ น ต ั ว ข อ ง ต ั ว เ อ ง
พุทธรูป	พ ุ ท ธ ร ู ป
แอนติบอดี	แ อ น ต ิ บ อ ด ี
แฅน	แ ฅ น
กระเป๋าสตางค์	ก ร ะ เ ป ๋ า ส ต า ง ค ์
ยาสูบ	ย า ส ู บ
ที่สิบเอ็ด	ท ี ่ ส ิ บ เ อ ็ ด
ฮึด	ฮ ึ ด
เสดจ์	เ ส ด จ ์
ดิงโก	ด ิ ง โ ก
ดาร์มสตัดเทียม	ด า ร ์ ม ส ต ั ด เ ท ี ย ม
อุรคะ	อ ุ ร ค ะ
ดุสิต	ด ุ ส ิ ต
ทหารเรือ	ท ห า ร เ ร ื อ
การจองกฐิน	ก า ร จ อ ง ก ฐ ิ น
เคานต์	เ ค า น ต ์
ปั่ว	ป ั ่ ว
เศรษฐยาธิปไตย	เ ศ ร ษ ฐ ย า ธ ิ ป ไ ต ย
ตอนกิ่ง	ต อ น ก ิ ่ ง
ทารุณ	ท า ร ุ ณ
น้ำดี	น ้ ำ ด ี
อาเพศ	อ า เ พ ศ
โซดาไฟ	โ ซ ด า ไ ฟ
ตฤๅ	ต ฤ ๅ
ฯพณฯ	ฯ พ ณ ฯ
ปลอบใจ	ป ล อ บ ใ จ
ป๊อปคอร์น	ป ๊ อ ป ค อ ร ์ น
ยุทธภพ	ย ุ ท ธ ภ พ
กล้องสนาม	ก ล ้ อ ง ส น า ม
วีซีดี	ว ี ซ ี ด ี
อิเล็กตรอน	อ ิ เ ล ็ ก ต ร อ น
อวัยวะสืบพันธุ์	อ ว ั ย ว ะ ส ื บ พ ั น ธ ุ ์
การปราชัย	ก า ร ป ร า ช ั ย
นิ่ว	น ิ ่ ว
ระนอง	ร ะ น อ ง
การออกเสียง	ก า ร อ อ ก เ ส ี ย ง
หย่า	ห ย ่ า
อิรัก	อ ิ ร ั ก
เสื้อแดง	เ ส ื ้ อ แ ด ง
ป่าคอนกรีต	ป ่ า ค อ น ก ร ี ต
โหราศาสตร์	โ ห ร า ศ า ส ต ร ์
ทันตแพทย์	ท ั น ต แ พ ท ย ์
นางนวล	น า ง น ว ล
นัตถุ์	น ั ต ถ ุ ์
คำติชม	ค ำ ต ิ ช ม
ที่โน้น	ท ี ่ โ น ้ น
เข็มฉีดยา	เ ข ็ ม ฉ ี ด ย า
การบังคับใช้	ก า ร บ ั ง ค ั บ ใ ช ้
เจ้าชาย	เ จ ้ า ช า ย
ฉาง	ฉ า ง
หัวไว	ห ั ว ไ ว
ซูเปอร์มาร์เก็ต	ซ ู เ ป อ ร ์ ม า ร ์ เ ก ็ ต
บังคม	บ ั ง ค ม
กาหลง	ก า ห ล ง
ต.ต.	ต . ต .
การตัดมิให้รับมรดก	ก า ร ต ั ด ม ิ ใ ห ้ ร ั บ ม ร ด ก
หน่อย	ห น ่ อ ย
โคคาอีน	โ ค ค า อ ี น
กราม	ก ร า ม
ไนล่อน	ไ น ล ่ อ น
สอดรู้	ส อ ด ร ู ้
กิช	ก ิ ช
โชยุ	โ ช ย ุ
อนาจาร	อ น า จ า ร
ถาง	ถ า ง
มลพิษ	ม ล พ ิ ษ
เรื่องสั้น	เ ร ื ่ อ ง ส ั ้ น
ท้องเสีย	ท ้ อ ง เ ส ี ย
โรคภัยไข้เจ็บ	โ ร ค ภ ั ย ไ ข ้ เ จ ็ บ
เสิก	เ ส ิ ก
เวลส์	เ ว ล ส ์
ดินสอกด	ด ิ น ส อ ก ด
วาซาบิ	ว า ซ า บ ิ
บัวผุด	บ ั ว ผ ุ ด
อาหารเย็น	อ า ห า ร เ ย ็ น
ขยี้	ข ย ี ้
สระแก้ว	ส ร ะ แ ก ้ ว
สันดาร	ส ั น ด า ร
ตระกร้อ	ต ร ะ ก ร ้ อ
จิรายุ	จ ิ ร า ย ุ
มหาสมุทร	ม ห า ส ม ุ ท ร
คาดหมาย	ค า ด ห ม า ย
ซีริลลิก	ซ ี ร ิ ล ล ิ ก
โรงนา	โ ร ง น า
อวัยวะเพศชาย	อ ว ั ย ว ะ เ พ ศ ช า ย
มิเตอร์	ม ิ เ ต อ ร ์
กระดาษเงินกระดาษทอง	ก ร ะ ด า ษ เ ง ิ น ก ร ะ ด า ษ ท อ ง
ระเบิดมือ	ร ะ เ บ ิ ด ม ื อ
ฤดูใบไม้ผลิ	ฤ ด ู ใ บ ไ ม ้ ผ ล ิ
อเวจี	อ เ ว จ ี
สะบาโต	ส ะ บ า โ ต
วายปราณ	ว า ย ป ร า ณ
กุนศก	ก ุ น ศ ก
กระเทย	ก ร ะ เ ท ย
กลับบ้านเก่า	ก ล ั บ บ ้ า น เ ก ่ า
ดินสอ	ด ิ น ส อ
แตะต้อง	แ ต ะ ต ้ อ ง
กิโลไบต์	ก ิ โ ล ไ บ ต ์
นักเลง	น ั ก เ ล ง
กล้าหาญ	ก ล ้ า ห า ญ
เผด็จการ	เ ผ ด ็ จ ก า ร
เขาโดด	เ ข า โ ด ด
ตั๊กแตน	ต ั ๊ ก แ ต น
อาสนวิหาร	อ า ส น ว ิ ห า ร
ก๊ก	ก ๊ ก
กลัวดอกพิกุลจะร่วง	ก ล ั ว ด อ ก พ ิ ก ุ ล จ ะ ร ่ ว ง
ฮุบ	ฮ ุ บ
กระดานชนวน	ก ร ะ ด า น ช น ว น
อุปัชฌายะ	อ ุ ป ั ช ฌ า ย ะ
โยน	โ ย น
ฉ้อ	ฉ ้ อ
ฤษี	ฤ ษ ี
หมอผี	ห ม อ ผ ี
หน้าเนื้อใจเสือ	ห น ้ า เ น ื ้ อ ใ จ เ ส ื อ
ศุภชัย	ศ ุ ภ ช ั ย
การควาน	ก า ร ค ว า น
ฤดูหนาว	ฤ ด ู ห น า ว
ยุทธจักร	ย ุ ท ธ จ ั ก ร
เส้นแบ่งเขตวันสากล	เ ส ้ น แ บ ่ ง เ ข ต ว ั น ส า ก ล
ตราชู	ต ร า ช ู
กรรมวาจก	ก ร ร ม ว า จ ก
ความอัศจรรย์	ค ว า ม อ ั ศ จ ร ร ย ์
กกุสันธ	ก ก ุ ส ั น ธ
สลิปเปอร์	ส ล ิ ป เ ป อ ร ์
เคลิ้ม	เ ค ล ิ ้ ม
วาฬสีน้ำเงิน	ว า ฬ ส ี น ้ ำ เ ง ิ น
ไม่เบา	ไ ม ่ เ บ า
ปริ้น	ป ร ิ ้ น
เห็นชอบ	เ ห ็ น ช อ บ
กุย	ก ุ ย
วอก	ว อ ก
แปลอักษร	แ ป ล อ ั ก ษ ร
ความขัน	ค ว า ม ข ั น
๕๕๕	๕ ๕ ๕
หมายจับ	ห ม า ย จ ั บ
กู้ภัย	ก ู ้ ภ ั ย
นักการเงิน	น ั ก ก า ร เ ง ิ น
โยคะ	โ ย ค ะ
น้ำมันแร่	น ้ ำ ม ั น แ ร ่
การคน	ก า ร ค น
เลื่อม	เ ล ื ่ อ ม
ผุด	ผ ุ ด
แคม	แ ค ม
หลิ่ว	ห ล ิ ่ ว
บั่น	บ ั ่ น
ประชามติ	ป ร ะ ช า ม ต ิ
สามเหลี่ยมด้านเท่า	ส า ม เ ห ล ี ่ ย ม ด ้ า น เ ท ่ า
ศตภิษัช	ศ ต ภ ิ ษ ั ช
ความแค้น	ค ว า ม แ ค ้ น
ลูกซัด	ล ู ก ซ ั ด
ฑังสะ	ฑ ั ง ส ะ
หมากฝรั่ง	ห ม า ก ฝ ร ั ่ ง
ผู้ฝึก	ผ ู ้ ฝ ึ ก
เบ้อเริ่มเทิ่ม	เ บ ้ อ เ ร ิ ่ ม เ ท ิ ่ ม
สอนหนังสือสังฆราช	ส อ น ห น ั ง ส ื อ ส ั ง ฆ ร า ช
ความกระหาย	ค ว า ม ก ร ะ ห า ย
แบบฝึกหัด	แ บ บ ฝ ึ ก ห ั ด
การระเบิด	ก า ร ร ะ เ บ ิ ด
แรงบิด	แ ร ง บ ิ ด
การแสดง	ก า ร แ ส ด ง
แกล้ง	แ ก ล ้ ง
เซาท์แคโรไลนา	เ ซ า ท ์ แ ค โ ร ไ ล น า
ปากว่าตาขยิบ	ป า ก ว ่ า ต า ข ย ิ บ
กิ๊ก	ก ิ ๊ ก
ข้าวเที่ยง	ข ้ า ว เ ท ี ่ ย ง
ปิตุฆาต	ป ิ ต ุ ฆ า ต
ฉนวน	ฉ น ว น
ตังถั่งเช่า	ต ั ง ถ ั ่ ง เ ช ่ า
เป๊ปซี่	เ ป ๊ ป ซ ี ่
ฉีดยา	ฉ ี ด ย า
ปากคำ	ป า ก ค ำ
ทางเดินอาหาร	ท า ง เ ด ิ น อ า ห า ร
แมนโดลิน	แ ม น โ ด ล ิ น
กวม	ก ว ม
ที่เปิดกระป๋อง	ท ี ่ เ ป ิ ด ก ร ะ ป ๋ อ ง
แสตมป์	แ ส ต ม ป ์
หูกระต่าย	ห ู ก ร ะ ต ่ า ย
พลเอก	พ ล เ อ ก
ไม่ควรจะกราบบังคมทูลพระกรุณา	ไ ม ่ ค ว ร จ ะ ก ร า บ บ ั ง ค ม ท ู ล พ ร ะ ก ร ุ ณ า
อับดุลเลาะ	อ ั บ ด ุ ล เ ล า ะ
ตุลาการภิวัฒน์	ต ุ ล า ก า ร ภ ิ ว ั ฒ น ์
ลักลอบ	ล ั ก ล อ บ
จารึก	จ า ร ึ ก
ฟาดแข้ง	ฟ า ด แ ข ้ ง
นิสิต	น ิ ส ิ ต
ประดุจ	ป ร ะ ด ุ จ
แดดเดียว	แ ด ด เ ด ี ย ว
อนึ่ง	อ น ึ ่ ง
ผู้เสียหาย	ผ ู ้ เ ส ี ย ห า ย
อุโมงค์	อ ุ โ ม ง ค ์
ถูกส่วน	ถ ู ก ส ่ ว น
เส้นใย	เ ส ้ น ใ ย
เอียง	เ อ ี ย ง
การท้าทาย	ก า ร ท ้ า ท า ย
เนยเทียม	เ น ย เ ท ี ย ม
เอทีเอ็ม	เ อ ท ี เ อ ็ ม
อัยการสูงสุด	อ ั ย ก า ร ส ู ง ส ุ ด
เสาวรส	เ ส า ว ร ส
กรรเชียง	ก ร ร เ ช ี ย ง
นอนคุยกับรากมะม่วง	น อ น ค ุ ย ก ั บ ร า ก ม ะ ม ่ ว ง
ถึงแก่ความตาย	ถ ึ ง แ ก ่ ค ว า ม ต า ย
อับเฉา	อ ั บ เ ฉ า
หวั่นไหว	ห ว ั ่ น ไ ห ว
ผ่องใส	ผ ่ อ ง ใ ส
ความเป็นส่วนตัว	ค ว า ม เ ป ็ น ส ่ ว น ต ั ว
กุญแจซอล	ก ุ ญ แ จ ซ อ ล
วิกิพจนานุกรม	ว ิ ก ิ พ จ น า น ุ ก ร ม
เอเชียตะวันออกเฉียงใต้	เ อ เ ช ี ย ต ะ ว ั น อ อ ก เ ฉ ี ย ง ใ ต ้
การว่างงาน	ก า ร ว ่ า ง ง า น
คันธะ	ค ั น ธ ะ
มะโรง	ม ะ โ ร ง
การแข็งตัวขององคชาต	ก า ร แ ข ็ ง ต ั ว ข อ ง อ ง ค ช า ต
สุขา	ส ุ ข า
มีอันเป็นไป	ม ี อ ั น เ ป ็ น ไ ป
ดูก่อน	ด ู ก ่ อ น
ยาแรง	ย า แ ร ง
เทคนีเชียม	เ ท ค น ี เ ช ี ย ม
บังกลาเทศ	บ ั ง ก ล า เ ท ศ
หน้าซื่อใจคด	ห น ้ า ซ ื ่ อ ใ จ ค ด
ดอนเมือง	ด อ น เ ม ื อ ง
ขัณฑสกร	ข ั ณ ฑ ส ก ร
กำพร้า	ก ำ พ ร ้ า
พยาบาท	พ ย า บ า ท
ทำมาหากิน	ท ำ ม า ห า ก ิ น
ดิกชันนารี	ด ิ ก ช ั น น า ร ี
เทียด	เ ท ี ย ด
ใบบุญ	ใ บ บ ุ ญ
หนังสติ๊ก	ห น ั ง ส ต ิ ๊ ก
โรคพิษสุราเรื้อรัง	โ ร ค พ ิ ษ ส ุ ร า เ ร ื ้ อ ร ั ง
แปะ	แ ป ะ
แข็งตัว	แ ข ็ ง ต ั ว
ฟ้องร้อง	ฟ ้ อ ง ร ้ อ ง
เบลีซ	เ บ ล ี ซ
นีโอดิเมียม	น ี โ อ ด ิ เ ม ี ย ม
ใบรับของ	ใ บ ร ั บ ข อ ง
กาสิโน	ก า ส ิ โ น
เฟ้อ	เ ฟ ้ อ
อมฤต	อ ม ฤ ต
อเมริกาใต้	อ เ ม ร ิ ก า ใ ต ้
รุ่ม	ร ุ ่ ม
วิลันดา	ว ิ ล ั น ด า
กินรี	ก ิ น ร ี
ความโลภ	ค ว า ม โ ล ภ
ยุ่งเหมือนยุงตีกัน	ย ุ ่ ง เ ห ม ื อ น ย ุ ง ต ี ก ั น
ผ้าเช็ดปาก	ผ ้ า เ ช ็ ด ป า ก
ใบสั่งยา	ใ บ ส ั ่ ง ย า
ปิโตรเลียม	ป ิ โ ต ร เ ล ี ย ม
ขัดขืน	ข ั ด ข ื น
อสัญกรรม	อ ส ั ญ ก ร ร ม
กฎหมายเอกชน	ก ฎ ห ม า ย เ อ ก ช น
แอนดรอยด์	แ อ น ด ร อ ย ด ์
ลายนิ้วมือ	ล า ย น ิ ้ ว ม ื อ
หลังบ้าน	ห ล ั ง บ ้ า น
สิ้นบุญ	ส ิ ้ น บ ุ ญ
บรมนาถบพิตร	บ ร ม น า ถ บ พ ิ ต ร
เจงกีสข่าน	เ จ ง ก ี ส ข ่ า น
เดียรัจฉาน	เ ด ี ย ร ั จ ฉ า น
พฤ.	พ ฤ .
เครื่องปั้นดินเผา	เ ค ร ื ่ อ ง ป ั ้ น ด ิ น เ ผ า
อารบิก	อ า ร บ ิ ก
เบลารุส	เ บ ล า ร ุ ส
เมรุมาศ	เ ม ร ุ ม า ศ
รถเครื่อง	ร ถ เ ค ร ื ่ อ ง
เมกอัป	เ ม ก อ ั ป
หุบเขา	ห ุ บ เ ข า
ม้าเร็ว	ม ้ า เ ร ็ ว
พริกน้ำปลา	พ ร ิ ก น ้ ำ ป ล า
อุลิด	อ ุ ล ิ ด
ศังข์	ศ ั ง ข ์
ฝ่ายหน้า	ฝ ่ า ย ห น ้ า
ราพณาสูร	ร า พ ณ า ส ู ร
ความพิบัติ	ค ว า ม พ ิ บ ั ต ิ
กริ่งเกรง	ก ร ิ ่ ง เ ก ร ง
โรมาเนีย	โ ร ม า เ น ี ย
อาตมาภาพ	อ า ต ม า ภ า พ
ซาอุดีอาระเบีย	ซ า อ ุ ด ี อ า ร ะ เ บ ี ย
อูฐ	อ ู ฐ
ด้าว	ด ้ า ว
แหวกว่าย	แ ห ว ก ว ่ า ย
เอเคอร์	เ อ เ ค อ ร ์
ผัดผ่อน	ผ ั ด ผ ่ อ น
สองจิตสองใจ	ส อ ง จ ิ ต ส อ ง ใ จ
นักการทูต	น ั ก ก า ร ท ู ต
เบ็ดเสร็จ	เ บ ็ ด เ ส ร ็ จ
เขามอ	เ ข า ม อ
แสะ	แ ส ะ
กงเวียน	ก ง เ ว ี ย น
เนแบรสกา	เ น แ บ ร ส ก า
องค์การนอกภาครัฐ	อ ง ค ์ ก า ร น อ ก ภ า ค ร ั ฐ
ตะวันอ้อมข้าว	ต ะ ว ั น อ ้ อ ม ข ้ า ว
หยั่งรู้	ห ย ั ่ ง ร ู ้
ไม้กอล์ฟ	ไ ม ้ ก อ ล ์ ฟ
หนึ่งออ	ห น ึ ่ ง อ อ
ไหล่ทวีป	ไ ห ล ่ ท ว ี ป
ละติน	ล ะ ต ิ น
ประชานิยม	ป ร ะ ช า น ิ ย ม
พลิ้ว	พ ล ิ ้ ว
สิบห้า	ส ิ บ ห ้ า
ห้วงน้ำ	ห ้ ว ง น ้ ำ
ไข่ดาว	ไ ข ่ ด า ว
ทวิตภพ	ท ว ิ ต ภ พ
ซ่อนกลิ่น	ซ ่ อ น ก ล ิ ่ น
ทุรยศ	ท ุ ร ย ศ
ฮาลาล	ฮ า ล า ล
เรินต์เกเนียม	เ ร ิ น ต ์ เ ก เ น ี ย ม
เรือนตะเกียง	เ ร ื อ น ต ะ เ ก ี ย ง
ผู้ก่อตั้ง	ผ ู ้ ก ่ อ ต ั ้ ง
ขวัญเอยขวัญมา	ข ว ั ญ เ อ ย ข ว ั ญ ม า
การล้มละลาย	ก า ร ล ้ ม ล ะ ล า ย
เบลฟาสต์	เ บ ล ฟ า ส ต ์
เหนียง	เ ห น ี ย ง
อูม	อ ู ม
นุ่งลมห่มฟ้า	น ุ ่ ง ล ม ห ่ ม ฟ ้ า
พิสตาชีโอ	พ ิ ส ต า ช ี โ อ
สึนามิ	ส ึ น า ม ิ
กุ้งร้อยขา	ก ุ ้ ง ร ้ อ ย ข า
โหดเหี้ยม	โ ห ด เ ห ี ้ ย ม
ลัทธิอาณานิคม	ล ั ท ธ ิ อ า ณ า น ิ ค ม
ขอบน้ำใจ	ข อ บ น ้ ำ ใ จ
ล้นพ้น	ล ้ น พ ้ น
คำสาบาน	ค ำ ส า บ า น
อาดัม	อ า ด ั ม
รักชาติ	ร ั ก ช า ต ิ
ดุษฎีบัณฑิต	ด ุ ษ ฎ ี บ ั ณ ฑ ิ ต
อินทร์	อ ิ น ท ร ์
มณโฑ	ม ณ โ ฑ
ตรงนั้น	ต ร ง น ั ้ น
ลังถึง	ล ั ง ถ ึ ง
การฮั้ว	ก า ร ฮ ั ้ ว
สังข์	ส ั ง ข ์
กกุท	ก ก ุ ท
ชำแรก	ช ำ แ ร ก
พาโนรามา	พ า โ น ร า ม า
ครัวซ็อง	ค ร ั ว ซ ็ อ ง
บุรพภัทรบท	บ ุ ร พ ภ ั ท ร บ ท
รถพยาบาล	ร ถ พ ย า บ า ล
เฟอร์รี	เ ฟ อ ร ์ ร ี
สัตวบาล	ส ั ต ว บ า ล
ลูกชิ้น	ล ู ก ช ิ ้ น
ซูรินาม	ซ ู ร ิ น า ม
นิวยอร์กซิตี	น ิ ว ย อ ร ์ ก ซ ิ ต ี
โขก	โ ข ก
โขง	โ ข ง
ก่อการร้าย	ก ่ อ ก า ร ร ้ า ย
เช็กโกสโลวะเกีย	เ ช ็ ก โ ก ส โ ล ว ะ เ ก ี ย
เหมียว	เ ห ม ี ย ว
ปล้ำ	ป ล ้ ำ
กู่ไม่กลับ	ก ู ่ ไ ม ่ ก ล ั บ
ชานชาลา	ช า น ช า ล า
ฮัดชิ่ว	ฮ ั ด ช ิ ่ ว
แตกหน่อ	แ ต ก ห น ่ อ
นารทะ	น า ร ท ะ
คูเรียม	ค ู เ ร ี ย ม
ฉิ่ง	ฉ ิ ่ ง
แล็กเกอร์	แ ล ็ ก เ ก อ ร ์
๑๘	๑ ๘
แม่ยาย	แ ม ่ ย า ย
มักง่าย	ม ั ก ง ่ า ย
บาดแผล	บ า ด แ ผ ล
วุฒิสภา	ว ุ ฒ ิ ส ภ า
หายใจออก	ห า ย ใ จ อ อ ก
สถูป	ส ถ ู ป
โมร็อกโก	โ ม ร ็ อ ก โ ก
กลุ่มดาว	ก ล ุ ่ ม ด า ว
มนุษยชาติ	ม น ุ ษ ย ช า ต ิ
พ่ายแพ้	พ ่ า ย แ พ ้
สมัครใจ	ส ม ั ค ร ใ จ
เม็ดเลือดขาว	เ ม ็ ด เ ล ื อ ด ข า ว
หน่วยอักขระ	ห น ่ ว ย อ ั ก ข ร ะ
หกล้ม	ห ก ล ้ ม
ความเฮง	ค ว า ม เ ฮ ง
เสรีภาพ	เ ส ร ี ภ า พ
มหาบัณฑิต	ม ห า บ ั ณ ฑ ิ ต
ความหมิ่นประมาท	ค ว า ม ห ม ิ ่ น ป ร ะ ม า ท
แบงก์กาโม่	แ บ ง ก ์ ก า โ ม ่
กังวล	ก ั ง ว ล
บุรพผลคุนี	บ ุ ร พ ผ ล ค ุ น ี
คู่ใจ	ค ู ่ ใ จ
ลาง	ล า ง
พีบิมบับ	พ ี บ ิ ม บ ั บ
การร้องไห้	ก า ร ร ้ อ ง ไ ห ้
ดูไบ	ด ู ไ บ
การผูกขาด	ก า ร ผ ู ก ข า ด
แมงกะพรุน	แ ม ง ก ะ พ ร ุ น
ไดรฟ์	ไ ด ร ฟ ์
ละมุน	ล ะ ม ุ น
คุกกี้เสี่ยงทาย	ค ุ ก ก ี ้ เ ส ี ่ ย ง ท า ย
มณฑป	ม ณ ฑ ป
ตถาคต	ต ถ า ค ต
พิสดาร	พ ิ ส ด า ร
เล่นแร่แปรธาตุ	เ ล ่ น แ ร ่ แ ป ร ธ า ต ุ
ลาวสูง	ล า ว ส ู ง
บิ่น	บ ิ ่ น
ส่งผู้ร้ายข้ามแดน	ส ่ ง ผ ู ้ ร ้ า ย ข ้ า ม แ ด น
พยานบุคคล	พ ย า น บ ุ ค ค ล
ธรรมะธรรมโม	ธ ร ร ม ะ ธ ร ร ม โ ม
ข้าง	ข ้ า ง
กระดูกโหนกแก้ม	ก ร ะ ด ู ก โ ห น ก แ ก ้ ม
ถนอม	ถ น อ ม
ศาสนิกชน	ศ า ส น ิ ก ช น
ลายมือ	ล า ย ม ื อ
ขี้ผึ้ง	ข ี ้ ผ ึ ้ ง
แซ็ว	แ ซ ็ ว
มือปืน	ม ื อ ป ื น
เถรตรง	เ ถ ร ต ร ง
ระบบหายใจ	ร ะ บ บ ห า ย ใ จ
คณิกา	ค ณ ิ ก า
เบญจศก	เ บ ญ จ ศ ก
ปืนครก	ป ื น ค ร ก
จอร์เจีย	จ อ ร ์ เ จ ี ย
หญิงรักร่วมเพศ	ห ญ ิ ง ร ั ก ร ่ ว ม เ พ ศ
เกาหลีเหนือ	เ ก า ห ล ี เ ห น ื อ
เฒ่า	เ ฒ ่ า
โทโส	โ ท โ ส
สร่าง	ส ร ่ า ง
ทางสามแพร่ง	ท า ง ส า ม แ พ ร ่ ง
เครื่องดนตรี	เ ค ร ื ่ อ ง ด น ต ร ี
คูเวตซิตี	ค ู เ ว ต ซ ิ ต ี
หม้อ	ห ม ้ อ
สุมิตรา	ส ุ ม ิ ต ร า
ยืนหยัด	ย ื น ห ย ั ด
เกวียน	เ ก ว ี ย น
ลายเซ็น	ล า ย เ ซ ็ น
อุจาด	อ ุ จ า ด
เข้าตา	เ ข ้ า ต า
ถ่วง	ถ ่ ว ง
กลาก	ก ล า ก
เน็ตไอดอล	เ น ็ ต ไ อ ด อ ล
กรรโชก	ก ร ร โ ช ก
ช่างตัดผม	ช ่ า ง ต ั ด ผ ม
คริสตสมภพ	ค ร ิ ส ต ส ม ภ พ
ตาปลา	ต า ป ล า
ปริญญาบัตร	ป ร ิ ญ ญ า บ ั ต ร
บัตรสนเท่ห์	บ ั ต ร ส น เ ท ่ ห ์
หอยเม่น	ห อ ย เ ม ่ น
นกแสก	น ก แ ส ก
กลั่นกรอง	ก ล ั ่ น ก ร อ ง
ฌาปนกิจ	ฌ า ป น ก ิ จ
ใต้ดิน	ใ ต ้ ด ิ น
หางเสือเลี้ยว	ห า ง เ ส ื อ เ ล ี ้ ย ว
จาเมกา	จ า เ ม ก า
โวยวาย	โ ว ย ว า ย
เรือบิน	เ ร ื อ บ ิ น
วงกต	ว ง ก ต
กองพล	ก อ ง พ ล
ถอน	ถ อ น
พิฆาต	พ ิ ฆ า ต
กระท้อน	ก ร ะ ท ้ อ น
ความประพฤติ	ค ว า ม ป ร ะ พ ฤ ต ิ
ปากกาเมจิก	ป า ก ก า เ ม จ ิ ก
อีเต้อ	อ ี เ ต ้ อ
สุกเอาเผากิน	ส ุ ก เ อ า เ ผ า ก ิ น
บัลลาด	บ ั ล ล า ด
มันส์	ม ั น ส ์
ทาร์เซียร์	ท า ร ์ เ ซ ี ย ร ์
รังสีแพทย์	ร ั ง ส ี แ พ ท ย ์
เรือนกระจก	เ ร ื อ น ก ร ะ จ ก
ปลั่ง	ป ล ั ่ ง
หยิบ	ห ย ิ บ
เฮี้ยน	เ ฮ ี ้ ย น
เกษตรกรรม	เ ก ษ ต ร ก ร ร ม
อะพอสทรอฟี	อ ะ พ อ ส ท ร อ ฟ ี
พ่วงพี	พ ่ ว ง พ ี
อาหารขยะ	อ า ห า ร ข ย ะ
เครื่องขุด	เ ค ร ื ่ อ ง ข ุ ด
ไชโย	ไ ช โ ย
อีสุกอีใส	อ ี ส ุ ก อ ี ใ ส
สุภาษิต	ส ุ ภ า ษ ิ ต
โกหร่าน	โ ก ห ร ่ า น
กำมะถันแดง	ก ำ ม ะ ถ ั น แ ด ง
แตร	แ ต ร
ลือชา	ล ื อ ช า
เจ้าพระยา	เ จ ้ า พ ร ะ ย า
ฟงดูว์	ฟ ง ด ู ว ์
ก้าวร้าว	ก ้ า ว ร ้ า ว
ข่มขืน	ข ่ ม ข ื น
สบตา	ส บ ต า
ฟยอร์ด	ฟ ย อ ร ์ ด
เครื่องกลึง	เ ค ร ื ่ อ ง ก ล ึ ง
โถส้วม	โ ถ ส ้ ว ม
เคียฟ	เ ค ี ย ฟ
ยาตรา	ย า ต ร า
ผ้าม่าน	ผ ้ า ม ่ า น
จำนวนอดิศัย	จ ำ น ว น อ ด ิ ศ ั ย
นกเป็ดผี	น ก เ ป ็ ด ผ ี
ไท้	ไ ท ้
คายกคณะ	ค า ย ก ค ณ ะ
อกไข่ดาว	อ ก ไ ข ่ ด า ว
เจ้าสาว	เ จ ้ า ส า ว
อนุชา	อ น ุ ช า
ถั่วเขียว	ถ ั ่ ว เ ข ี ย ว
มึนเชิน	ม ึ น เ ช ิ น
รากไม้	ร า ก ไ ม ้
หนึบ	ห น ึ บ
นักปฏิวัติ	น ั ก ป ฏ ิ ว ั ต ิ
เลขศาสตร์	เ ล ข ศ า ส ต ร ์
อันดอร์ราลาเวยา	อ ั น ด อ ร ์ ร า ล า เ ว ย า
มาซิโดเนีย	ม า ซ ิ โ ด เ น ี ย
สภาพบุคคล	ส ภ า พ บ ุ ค ค ล
บังควร	บ ั ง ค ว ร
มรกต	ม ร ก ต
โรงละคร	โ ร ง ล ะ ค ร
ภารย	ภ า ร ย
การชั่ง	ก า ร ช ั ่ ง
สิทธิบัตร	ส ิ ท ธ ิ บ ั ต ร
โรมโบราณ	โ ร ม โ บ ร า ณ
กว้างใหญ่	ก ว ้ า ง ใ ห ญ ่
เบญจกัลยาณี	เ บ ญ จ ก ั ล ย า ณ ี
ลายน้ำ	ล า ย น ้ ำ
ภูเขาน้ำแข็ง	ภ ู เ ข า น ้ ำ แ ข ็ ง
วยัสย์	ว ย ั ส ย ์
จำนวนเชิงพีชคณิต	จ ำ น ว น เ ช ิ ง พ ี ช ค ณ ิ ต
โรงตึ๊ง	โ ร ง ต ึ ๊ ง
ไนโรบี	ไ น โ ร บ ี
วณิพก	ว ณ ิ พ ก
กีวี	ก ี ว ี
ฟก	ฟ ก
ป่าโมก	ป ่ า โ ม ก
ท้าวพระยา	ท ้ า ว พ ร ะ ย า
แช่แข็ง	แ ช ่ แ ข ็ ง
กระปรี้กระเปร่า	ก ร ะ ป ร ี ้ ก ร ะ เ ป ร ่ า
ฐานข้อมูล	ฐ า น ข ้ อ ม ู ล
จักจี้	จ ั ก จ ี ้
ขัดข้อง	ข ั ด ข ้ อ ง
ด้าย	ด ้ า ย
แบ๊ว	แ บ ๊ ว
พระพุทธเจ้า	พ ร ะ พ ุ ท ธ เ จ ้ า
ไอดอล	ไ อ ด อ ล
การจบการศึกษา	ก า ร จ บ ก า ร ศ ึ ก ษ า
ไฟเขียว	ไ ฟ เ ข ี ย ว
ไม้พุ่ม	ไ ม ้ พ ุ ่ ม
ปืนฉีดน้ำ	ป ื น ฉ ี ด น ้ ำ
ทรพิษ	ท ร พ ิ ษ
สัมภาระ	ส ั ม ภ า ร ะ
เบนซิน	เ บ น ซ ิ น
พรำ	พ ร ำ
บัตรประจำตัว	บ ั ต ร ป ร ะ จ ำ ต ั ว
ไมตรี	ไ ม ต ร ี
ปฐมฤกษ์	ป ฐ ม ฤ ก ษ ์
เคาะ	เ ค า ะ
คำพังเพย	ค ำ พ ั ง เ พ ย
หมากล้อม	ห ม า ก ล ้ อ ม
๑๓	๑ ๓
สุริยคราส	ส ุ ร ิ ย ค ร า ส
หัวนม	ห ั ว น ม
สุดวิสัย	ส ุ ด ว ิ ส ั ย
สุรคต	ส ุ ร ค ต
พ้อ	พ ้ อ
โลหิตวิทยา	โ ล ห ิ ต ว ิ ท ย า
ผู้มีอำนาจ	ผ ู ้ ม ี อ ำ น า จ
บูร์กินาฟาโซ	บ ู ร ์ ก ิ น า ฟ า โ ซ
ไฟลนก้น	ไ ฟ ล น ก ้ น
จุดเยือกแข็ง	จ ุ ด เ ย ื อ ก แ ข ็ ง
การฆ่า	ก า ร ฆ ่ า
รหัสไปรษณีย์	ร ห ั ส ไ ป ร ษ ณ ี ย ์
วงวาร	ว ง ว า ร
ซีร็อกซ์	ซ ี ร ็ อ ก ซ ์
ยุยง	ย ุ ย ง
นรธา	น ร ธ า
ถั่วพู	ถ ั ่ ว พ ู
ประจุไฟฟ้า	ป ร ะ จ ุ ไ ฟ ฟ ้ า
ร้องเรียน	ร ้ อ ง เ ร ี ย น
ประกายไฟฟ้า	ป ร ะ ก า ย ไ ฟ ฟ ้ า
วอลรัส	ว อ ล ร ั ส
ภัยพิบัติ	ภ ั ย พ ิ บ ั ต ิ
อ่าวไทย	อ ่ า ว ไ ท ย
นิศาบดี	น ิ ศ า บ ด ี
การเซ็นเซอร์	ก า ร เ ซ ็ น เ ซ อ ร ์
รูหนอน	ร ู ห น อ น
ปฏัก	ป ฏ ั ก
เทวี	เ ท ว ี
มโนคติ	ม โ น ค ต ิ
คุรุ	ค ุ ร ุ
ยาบ้า	ย า บ ้ า
อมยิ้ม	อ ม ย ิ ้ ม
จุดยืน	จ ุ ด ย ื น
ย่อหน้า	ย ่ อ ห น ้ า
โลลิ	โ ล ล ิ
การให้การ	ก า ร ใ ห ้ ก า ร
ลูกจ้าง	ล ู ก จ ้ า ง
คุกเข่า	ค ุ ก เ ข ่ า
รำไทย	ร ำ ไ ท ย
โปง	โ ป ง
พงษาวดาร	พ ง ษ า ว ด า ร
ก๋วยเตี๋ยว	ก ๋ ว ย เ ต ี ๋ ย ว
ร้อนลน	ร ้ อ น ล น
จระเข้ฟาดหาง	จ ร ะ เ ข ้ ฟ า ด ห า ง
นายอำเภอ	น า ย อ ำ เ ภ อ
ข้าพเจ้า	ข ้ า พ เ จ ้ า
ສົນທະນາ	ສ ົ ນ ທ ະ ນ າ
ยูคาลิปตัส	ย ู ค า ล ิ ป ต ั ส
แสงบาดตา	แ ส ง บ า ด ต า
รถบ้าน	ร ถ บ ้ า น
สเปน	ส เ ป น
แพ็กเจ	แ พ ็ ก เ จ
คฑา	ค ฑ า
กุ้งหอยปูปลา	ก ุ ้ ง ห อ ย ป ู ป ล า
ถาก	ถ า ก
ลาวเบิ้ง	ล า ว เ บ ิ ้ ง
ทะเบียนสมรส	ท ะ เ บ ี ย น ส ม ร ส
ต.อ.น.	ต . อ . น .
วงเล็บ	ว ง เ ล ็ บ
กรรมสาร	ก ร ร ม ส า ร
ทองพันชั่ง	ท อ ง พ ั น ช ั ่ ง
พะย่ะค่ะ	พ ะ ย ่ ะ ค ่ ะ
เดนลอว์	เ ด น ล อ ว ์
หอน	ห อ น
พระตะบอง	พ ร ะ ต ะ บ อ ง
นิวเจอร์ซีย์	น ิ ว เ จ อ ร ์ ซ ี ย ์
คุณานุประโยค	ค ุ ณ า น ุ ป ร ะ โ ย ค
วาสุกี	ว า ส ุ ก ี
ความสมเหตุสมผล	ค ว า ม ส ม เ ห ต ุ ส ม ผ ล
น้ำพริกเผา	น ้ ำ พ ร ิ ก เ ผ า
ผีถ้วยแก้ว	ผ ี ถ ้ ว ย แ ก ้ ว
นาวา	น า ว า
ลิปสติก	ล ิ ป ส ต ิ ก
จิ้งจก	จ ิ ้ ง จ ก
บุพเพสันนิวาส	บ ุ พ เ พ ส ั น น ิ ว า ส
ปริ่ม	ป ร ิ ่ ม
คายตะขาบ	ค า ย ต ะ ข า บ
ศิคาล	ศ ิ ค า ล
ตะไคร้	ต ะ ไ ค ร ้
คี่	ค ี ่
ผณิน	ผ ณ ิ น
ตีหน้า	ต ี ห น ้ า
ดาบส	ด า บ ส
หย่อม	ห ย ่ อ ม
โทส	โ ท ส
อันว่า	อ ั น ว ่ า
เป้	เ ป ้
จักรวรรดิออตโตมัน	จ ั ก ร ว ร ร ด ิ อ อ ต โ ต ม ั น
สมมติฐาน	ส ม ม ต ิ ฐ า น
วิปครีม	ว ิ ป ค ร ี ม
หีบศพ	ห ี บ ศ พ
นวยนาด	น ว ย น า ด
บิชเคก	บ ิ ช เ ค ก
เหน็บหนาว	เ ห น ็ บ ห น า ว
ความเสียว	ค ว า ม เ ส ี ย ว
คว่ำบาตร	ค ว ่ ำ บ า ต ร
เปิดโปง	เ ป ิ ด โ ป ง
งานอดิเรก	ง า น อ ด ิ เ ร ก
ฟอนต์	ฟ อ น ต ์
กขค.	ก ข ค .
การสมรสตามกฎหมาย	ก า ร ส ม ร ส ต า ม ก ฎ ห ม า ย
ซักฟอก	ซ ั ก ฟ อ ก
แกรไฟต์	แ ก ร ไ ฟ ต ์
ฟือเรอร์	ฟ ื อ เ ร อ ร ์
ไส้เดือน	ไ ส ้ เ ด ื อ น
บังกะโล	บ ั ง ก ะ โ ล
จำนวนเต็ม	จ ำ น ว น เ ต ็ ม
กำนัล	ก ำ น ั ล
ออกตัว	อ อ ก ต ั ว
อหิวาตกโรค	อ ห ิ ว า ต ก โ ร ค
กระโทง	ก ร ะ โ ท ง
ความบริสุทธิ์	ค ว า ม บ ร ิ ส ุ ท ธ ิ ์
กลุ่มดาวหมีใหญ่	ก ล ุ ่ ม ด า ว ห ม ี ใ ห ญ ่
เหม็น	เ ห ม ็ น
ยาทาเล็บ	ย า ท า เ ล ็ บ
สัสดี	ส ั ส ด ี
หน้าร้อน	ห น ้ า ร ้ อ น
ของชำ	ข อ ง ช ำ
ไม้บรรทัด	ไ ม ้ บ ร ร ท ั ด
พักร้อน	พ ั ก ร ้ อ น
โฟลเอ็ม	โ ฟ ล เ อ ็ ม
ภาษาปะกิด	ภ า ษ า ป ะ ก ิ ด
ผิดใจ	ผ ิ ด ใ จ
ปฏิชีวนะ	ป ฏ ิ ช ี ว น ะ
ใบปลิว	ใ บ ป ล ิ ว
สังหารหมู่	ส ั ง ห า ร ห ม ู ่
สิบหก	ส ิ บ ห ก
รุ่งโรจน์	ร ุ ่ ง โ ร จ น ์
อุกกาบาต	อ ุ ก ก า บ า ต
ชิลี	ช ิ ล ี
สตรอเบอร์รี่	ส ต ร อ เ บ อ ร ์ ร ี ่
เป็นหูเป็นตา	เ ป ็ น ห ู เ ป ็ น ต า
ผัดซีอิ๊ว	ผ ั ด ซ ี อ ิ ๊ ว
มลัก	ม ล ั ก
กลีบดอกไม้	ก ล ี บ ด อ ก ไ ม ้
โขลง	โ ข ล ง
ไฮโดรเจน	ไ ฮ โ ด ร เ จ น
ความเอ็กซ์	ค ว า ม เ อ ็ ก ซ ์
เงือก	เ ง ื อ ก
จุดประสานประสาท	จ ุ ด ป ร ะ ส า น ป ร ะ ส า ท
ทิชชู	ท ิ ช ช ู
คำนิยาม	ค ำ น ิ ย า ม
หนังสือโต๊ะกาแฟ	ห น ั ง ส ื อ โ ต ๊ ะ ก า แ ฟ
ปรีชา	ป ร ี ช า
ฟลีโรเวียม	ฟ ล ี โ ร เ ว ี ย ม
วีระกรรม	ว ี ร ะ ก ร ร ม
ฝ่ายขวา	ฝ ่ า ย ข ว า
กระปุกหมู	ก ร ะ ป ุ ก ห ม ู
ความผูกพัน	ค ว า ม ผ ู ก พ ั น
เอกสารชั้นต้น	เ อ ก ส า ร ช ั ้ น ต ้ น
อาลักษณ์	อ า ล ั ก ษ ณ ์
เอกซ์	เ อ ก ซ ์
คล้องจอง	ค ล ้ อ ง จ อ ง
โข	โ ข
ตะโก้	ต ะ โ ก ้
กองกำลัง	ก อ ง ก ำ ล ั ง
การถอด	ก า ร ถ อ ด
ขงเบ้ง	ข ง เ บ ้ ง
ประจักษ์พยาน	ป ร ะ จ ั ก ษ ์ พ ย า น
ยวบ	ย ว บ
รูปด้าน	ร ู ป ด ้ า น
ฟิสิกส์	ฟ ิ ส ิ ก ส ์
ซักถาม	ซ ั ก ถ า ม
ปูม	ป ู ม
แบ่งแยก	แ บ ่ ง แ ย ก
คุณหญิง	ค ุ ณ ห ญ ิ ง
ท่อปัสสาวะ	ท ่ อ ป ั ส ส า ว ะ
กำไร	ก ำ ไ ร
ละเมิดอำนาจศาล	ล ะ เ ม ิ ด อ ำ น า จ ศ า ล
การกีดขวาง	ก า ร ก ี ด ข ว า ง
งาย	ง า ย
เพลงคร่ำครวญ	เ พ ล ง ค ร ่ ำ ค ร ว ญ
มายองเนส	ม า ย อ ง เ น ส
อาเทศ	อ า เ ท ศ
โด่ง	โ ด ่ ง
ช่องแคบอังกฤษ	ช ่ อ ง แ ค บ อ ั ง ก ฤ ษ
กากี่นั้ง	ก า ก ี ่ น ั ้ ง
น้ำแร่	น ้ ำ แ ร ่
เวรัมพวาต	เ ว ร ั ม พ ว า ต
สิ่งของ	ส ิ ่ ง ข อ ง
ประทีป	ป ร ะ ท ี ป
ระแทะ	ร ะ แ ท ะ
ครูใหญ่	ค ร ู ใ ห ญ ่
ไทยเดิ้ง	ไ ท ย เ ด ิ ้ ง
มั๊ย	ม ั ๊ ย
ก๊อก	ก ๊ อ ก
มหาสมุทรใต้	ม ห า ส ม ุ ท ร ใ ต ้
ตัวร้าย	ต ั ว ร ้ า ย
ความว่องไว	ค ว า ม ว ่ อ ง ไ ว
ขลาด	ข ล า ด
สำปะหลัง	ส ำ ป ะ ห ล ั ง
ศิลา	ศ ิ ล า
บอตสวานา	บ อ ต ส ว า น า
การแทรก	ก า ร แ ท ร ก
กะรุน	ก ะ ร ุ น
หัวใส	ห ั ว ใ ส
เจาะไข่แดง	เ จ า ะ ไ ข ่ แ ด ง
ตัวเอก	ต ั ว เ อ ก
หมูเห็ดเป็ดไก่	ห ม ู เ ห ็ ด เ ป ็ ด ไ ก ่
เต้านม	เ ต ้ า น ม
พันตรี	พ ั น ต ร ี
กระดูกทั่ง	ก ร ะ ด ู ก ท ั ่ ง
การแข็งตัว	ก า ร แ ข ็ ง ต ั ว
หน้าผีบอดี้เริ่ด	ห น ้ า ผ ี บ อ ด ี ้ เ ร ิ ่ ด
ฆาตกรรม	ฆ า ต ก ร ร ม
เรไร	เ ร ไ ร
คอห่าน	ค อ ห ่ า น
ที่ตัดเล็บ	ท ี ่ ต ั ด เ ล ็ บ
เพ้อฝัน	เ พ ้ อ ฝ ั น
แซ็กโซโฟน	แ ซ ็ ก โ ซ โ ฟ น
สถุน	ส ถ ุ น
มันเสา	ม ั น เ ส า
ละก์ซา	ล ะ ก ์ ซ า
เครื่องใน	เ ค ร ื ่ อ ง ใ น
เหรัญญิก	เ ห ร ั ญ ญ ิ ก
อุตรดิตถ์	อ ุ ต ร ด ิ ต ถ ์
แน่นหนา	แ น ่ น ห น า
แว้ง	แ ว ้ ง
ใจพระ	ใ จ พ ร ะ
เละเทะ	เ ล ะ เ ท ะ
สะกด	ส ะ ก ด
บล็อกเกอร์	บ ล ็ อ ก เ ก อ ร ์
การเคี่ยว	ก า ร เ ค ี ่ ย ว
ความลึกลับ	ค ว า ม ล ึ ก ล ั บ
สมัยพระเจ้าเหา	ส ม ั ย พ ร ะ เ จ ้ า เ ห า
อุดมการณ์	อ ุ ด ม ก า ร ณ ์
ไซเล็ม	ไ ซ เ ล ็ ม
ขยว	ข ย ว
แป๊ะ	แ ป ๊ ะ
เอาอกเอาใจ	เ อ า อ ก เ อ า ใ จ
ยัญ	ย ั ญ
โบตั๋น	โ บ ต ั ๋ น
นาโต้	น า โ ต ้
เกื้อกูล	เ ก ื ้ อ ก ู ล
บรรณารักษ์	บ ร ร ณ า ร ั ก ษ ์
ไคโยตี	ไ ค โ ย ต ี
ฆ่าล้างเผ่าพันธุ์	ฆ ่ า ล ้ า ง เ ผ ่ า พ ั น ธ ุ ์
เทศาภิบาล	เ ท ศ า ภ ิ บ า ล
โบสถ์	โ บ ส ถ ์
ประชาคม	ป ร ะ ช า ค ม
การอภิบาล	ก า ร อ ภ ิ บ า ล
ตะกวด	ต ะ ก ว ด
น่าเสียใจ	น ่ า เ ส ี ย ใ จ
ตักบาตร	ต ั ก บ า ต ร
ผลักภาระ	ผ ล ั ก ภ า ร ะ
กีด	ก ี ด
การบัญชี	ก า ร บ ั ญ ช ี
ชลธาร	ช ล ธ า ร
พิถีพิถัน	พ ิ ถ ี พ ิ ถ ั น
หัวเข่า	ห ั ว เ ข ่ า
หอย	ห อ ย
ออริกาโน	อ อ ร ิ ก า โ น
มะเร็งเต้านม	ม ะ เ ร ็ ง เ ต ้ า น ม
บิ๊ว	บ ิ ๊ ว
หน้าม้า	ห น ้ า ม ้ า
คีม	ค ี ม
กองพัน	ก อ ง พ ั น
สมัชชาใหญ่แห่งสหประชาชาติ	ส ม ั ช ช า ใ ห ญ ่ แ ห ่ ง ส ห ป ร ะ ช า ช า ต ิ
ปรัสเซีย	ป ร ั ส เ ซ ี ย
ท่องเที่ยว	ท ่ อ ง เ ท ี ่ ย ว
พ่อขุน	พ ่ อ ข ุ น
พังงา	พ ั ง ง า
นักว่ายน้ำ	น ั ก ว ่ า ย น ้ ำ
หินอัคนี	ห ิ น อ ั ค น ี
จรด	จ ร ด
ที่นอน	ท ี ่ น อ น
การรับประกัน	ก า ร ร ั บ ป ร ะ ก ั น
ฮาม	ฮ า ม
ผ่าเหล่า	ผ ่ า เ ห ล ่ า
ลิ้นไก่	ล ิ ้ น ไ ก ่
นักวิเคราะห์	น ั ก ว ิ เ ค ร า ะ ห ์
ชฎา	ช ฎ า
ฉันใด	ฉ ั น ใ ด
ฟันน้ำนม	ฟ ั น น ้ ำ น ม
ดาน	ด า น
ความต้านทานไฟฟ้า	ค ว า ม ต ้ า น ท า น ไ ฟ ฟ ้ า
ฤๅษีแปลงสาร	ฤ ๅ ษ ี แ ป ล ง ส า ร
แทน	แ ท น
กุญแจผี	ก ุ ญ แ จ ผ ี
หอมใหญ่	ห อ ม ใ ห ญ ่
โคร่ง	โ ค ร ่ ง
มังงะ	ม ั ง ง ะ
เครื่องยนต์จรวด	เ ค ร ื ่ อ ง ย น ต ์ จ ร ว ด
แลมบ์ดา	แ ล ม บ ์ ด า
ฉันรักคุณ	ฉ ั น ร ั ก ค ุ ณ
การดูหมิ่น	ก า ร ด ู ห ม ิ ่ น
วรรณคดี	ว ร ร ณ ค ด ี
จำปาดะ	จ ำ ป า ด ะ
โกร่ง	โ ก ร ่ ง
เปลวไฟ	เ ป ล ว ไ ฟ
อุทัย	อ ุ ท ั ย
โปรย	โ ป ร ย
หมีขอ	ห ม ี ข อ
แจกแจง	แ จ ก แ จ ง
เลี่ยม	เ ล ี ่ ย ม
จดจ่อ	จ ด จ ่ อ
ลูกกระเดือก	ล ู ก ก ร ะ เ ด ื อ ก
คร้าม	ค ร ้ า ม
นมถั่วเหลือง	น ม ถ ั ่ ว เ ห ล ื อ ง
มะระ	ม ะ ร ะ
ถ้อย	ถ ้ อ ย
อวบ	อ ว บ
มลทิน	ม ล ท ิ น
อีฉัน	อ ี ฉ ั น
ขุนนาง	ข ุ น น า ง
สายสะพาย	ส า ย ส ะ พ า ย
ส่วนของเส้นตรง	ส ่ ว น ข อ ง เ ส ้ น ต ร ง
ชีวนิเวศ	ช ี ว น ิ เ ว ศ
โศถะ	โ ศ ถ ะ
ทาก	ท า ก
ปิตาธิปไตย	ป ิ ต า ธ ิ ป ไ ต ย
เว้า	เ ว ้ า
ยาดม	ย า ด ม
ลัทธินายทุน	ล ั ท ธ ิ น า ย ท ุ น
วานซืน	ว า น ซ ื น
ค็อกเทล	ค ็ อ ก เ ท ล
เทอร์มอมิเตอร์	เ ท อ ร ์ ม อ ม ิ เ ต อ ร ์
ขจี	ข จ ี
เอเชียตะวันออก	เ อ เ ช ี ย ต ะ ว ั น อ อ ก
จ๊าด	จ ๊ า ด
สนามเด็กเล่น	ส น า ม เ ด ็ ก เ ล ่ น
สูงส่ง	ส ู ง ส ่ ง
ทรชน	ท ร ช น
ศีลธรรม	ศ ี ล ธ ร ร ม
นาอูรู	น า อ ู ร ู
ไตรลักษณ์	ไ ต ร ล ั ก ษ ณ ์
เรฟูจี	เ ร ฟ ู จ ี
โรคนอนไม่หลับ	โ ร ค น อ น ไ ม ่ ห ล ั บ
ทำการบ้าน	ท ำ ก า ร บ ้ า น
การพา	ก า ร พ า
สถานทูต	ส ถ า น ท ู ต
โอพอสซัม	โ อ พ อ ส ซ ั ม
เซ่น	เ ซ ่ น
เครื่องปรุง	เ ค ร ื ่ อ ง ป ร ุ ง
ประทุษวาจา	ป ร ะ ท ุ ษ ว า จ า
สิทธิมนุษยชน	ส ิ ท ธ ิ ม น ุ ษ ย ช น
ติเรือทั้งโกลน	ต ิ เ ร ื อ ท ั ้ ง โ ก ล น
ความเฉื่อย	ค ว า ม เ ฉ ื ่ อ ย
จ่าฝูง	จ ่ า ฝ ู ง
ปรานีฆาต	ป ร า น ี ฆ า ต
จตุจักร	จ ต ุ จ ั ก ร
เกลือแร่	เ ก ล ื อ แ ร ่
น้ำกระด้าง	น ้ ำ ก ร ะ ด ้ า ง
ยกกระบัตร	ย ก ก ร ะ บ ั ต ร
โอคลาโฮมา	โ อ ค ล า โ ฮ ม า
บาป	บ า ป
มลังเมลือง	ม ล ั ง เ ม ล ื อ ง
คูเมือง	ค ู เ ม ื อ ง
การยกเลิก	ก า ร ย ก เ ล ิ ก
กะทิ	ก ะ ท ิ
ออกโรง	อ อ ก โ ร ง
จิ๊กโก๋	จ ิ ๊ ก โ ก ๋
กลับตัว	ก ล ั บ ต ั ว
มาตุ	ม า ต ุ
บูรพา	บ ู ร พ า
จขกท	จ ข ก ท
คลื่นใส้	ค ล ื ่ น ใ ส ้
สังวาส	ส ั ง ว า ส
หนุ่มแน่น	ห น ุ ่ ม แ น ่ น
พวงมาลัย	พ ว ง ม า ล ั ย
พลศาสตร์ของไหล	พ ล ศ า ส ต ร ์ ข อ ง ไ ห ล
องค์ประชุม	อ ง ค ์ ป ร ะ ช ุ ม
ซาย	ซ า ย
ความเท่ห์	ค ว า ม เ ท ่ ห ์
เชอง	เ ช อ ง
ลิปดา	ล ิ ป ด า
บรรพบุรุษ	บ ร ร พ บ ุ ร ุ ษ
โคก	โ ค ก
กุนเชียง	ก ุ น เ ช ี ย ง
ทาบ	ท า บ
ก.ท.ม.	ก . ท . ม .
โควตา	โ ค ว ต า
เสื้อชุด	เ ส ื ้ อ ช ุ ด
กู้	ก ู ้
สัตว์ขาปล้อง	ส ั ต ว ์ ข า ป ล ้ อ ง
ข้อแม้	ข ้ อ แ ม ้
ชี้ต้าน	ช ี ้ ต ้ า น
ไม่เป็นไร	ไ ม ่ เ ป ็ น ไ ร
หนีเสือปะจระเข้	ห น ี เ ส ื อ ป ะ จ ร ะ เ ข ้
ขนมไหว้พระจันทร์	ข น ม ไ ห ว ้ พ ร ะ จ ั น ท ร ์
เครื่องหมายสงสัย	เ ค ร ื ่ อ ง ห ม า ย ส ง ส ั ย
งั่ว	ง ั ่ ว
ชิมแปนซี	ช ิ ม แ ป น ซ ี
ปิยทัสสี	ป ิ ย ท ั ส ส ี
มูลฐาน	ม ู ล ฐ า น
อาญาสิทธิ์	อ า ญ า ส ิ ท ธ ิ ์
ฉีกหน้า	ฉ ี ก ห น ้ า
ร่องรอย	ร ่ อ ง ร อ ย
ชั่วกัปชั่วกัลป์	ช ั ่ ว ก ั ป ช ั ่ ว ก ั ล ป ์
ความหูเบา	ค ว า ม ห ู เ บ า
เมียนมา	เ ม ี ย น ม า
จิตบำบัด	จ ิ ต บ ำ บ ั ด
นักกฎหมาย	น ั ก ก ฎ ห ม า ย
ไอติม	ไ อ ต ิ ม
ถวายบังคมลา	ถ ว า ย บ ั ง ค ม ล า
อ๋อง	อ ๋ อ ง
ดับขันธ์	ด ั บ ข ั น ธ ์
อาชญาสิทธิ์	อ า ช ญ า ส ิ ท ธ ิ ์
โทรศัพท์เคลื่อนที่	โ ท ร ศ ั พ ท ์ เ ค ล ื ่ อ น ท ี ่
สงเคราะห์	ส ง เ ค ร า ะ ห ์
โต้เถียง	โ ต ้ เ ถ ี ย ง
แมวป่า	แ ม ว ป ่ า
รัฐบรรณาการ	ร ั ฐ บ ร ร ณ า ก า ร
ไฟท้าย	ไ ฟ ท ้ า ย
ยาฆ่าหญ้า	ย า ฆ ่ า ห ญ ้ า
เล็น	เ ล ็ น
หวีด	ห ว ี ด
เปลญวน	เ ป ล ญ ว น
เปิ๊ดสะก๊าด	เ ป ิ ๊ ด ส ะ ก ๊ า ด
ปิดล้อม	ป ิ ด ล ้ อ ม
ไทยมุง	ไ ท ย ม ุ ง
เนวาดา	เ น ว า ด า
โพธิสัตว์	โ พ ธ ิ ส ั ต ว ์
กำเริบ	ก ำ เ ร ิ บ
รสนิยม	ร ส น ิ ย ม
เนื้อเยื่อบุผิว	เ น ื ้ อ เ ย ื ่ อ บ ุ ผ ิ ว
การดำเนินคดี	ก า ร ด ำ เ น ิ น ค ด ี
ที่สิบสาม	ท ี ่ ส ิ บ ส า ม
หลอดเลือดแดง	ห ล อ ด เ ล ื อ ด แ ด ง
น้ำมะพร้าว	น ้ ำ ม ะ พ ร ้ า ว
กระทะ	ก ร ะ ท ะ
บีบคอ	บ ี บ ค อ
รถเข็นล้อเดียว	ร ถ เ ข ็ น ล ้ อ เ ด ี ย ว
ณครรลำภาง	ณ ค ร ร ล ำ ภ า ง
วงเวียน	ว ง เ ว ี ย น
ถุงนอน	ถ ุ ง น อ น
ทรงพระประชวร	ท ร ง พ ร ะ ป ร ะ ช ว ร
รีวกีว	ร ี ว ก ี ว
ใบสั่ง	ใ บ ส ั ่ ง
ฟูมฟัก	ฟ ู ม ฟ ั ก
ซาแมเรียม	ซ า แ ม เ ร ี ย ม
รู้คุณ	ร ู ้ ค ุ ณ
หน่วยกิต	ห น ่ ว ย ก ิ ต
นมัสการ	น ม ั ส ก า ร
ชุบชีวิต	ช ุ บ ช ี ว ิ ต
หยุมหยิม	ห ย ุ ม ห ย ิ ม
อาเซอร์ไบจาน	อ า เ ซ อ ร ์ ไ บ จ า น
ตรึม	ต ร ึ ม
ประกาศิต	ป ร ะ ก า ศ ิ ต
ลิเทียม	ล ิ เ ท ี ย ม
ทิ้งระเบิด	ท ิ ้ ง ร ะ เ บ ิ ด
กลิ่นตัว	ก ล ิ ่ น ต ั ว
การละเมิด	ก า ร ล ะ เ ม ิ ด
ปลอบโยน	ป ล อ บ โ ย น
จักรวาฬ	จ ั ก ร ว า ฬ
ทิมพู	ท ิ ม พ ู
อ่วม	อ ่ ว ม
ฟุ้งซ่าน	ฟ ุ ้ ง ซ ่ า น
ตับอ่อน	ต ั บ อ ่ อ น
ค่าเสียหาย	ค ่ า เ ส ี ย ห า ย
ไข้เหลือง	ไ ข ้ เ ห ล ื อ ง
ประพันธสรรพนาม	ป ร ะ พ ั น ธ ส ร ร พ น า ม
คู่ผัวตัวเมีย	ค ู ่ ผ ั ว ต ั ว เ ม ี ย
จีน-ทิเบต	จ ี น - ท ิ เ บ ต
คาหนังคาเขา	ค า ห น ั ง ค า เ ข า
นักดาราศาสตร์	น ั ก ด า ร า ศ า ส ต ร ์
ตู้กับข้าว	ต ู ้ ก ั บ ข ้ า ว
ธนิษฐะ	ธ น ิ ษ ฐ ะ
การมองบน	ก า ร ม อ ง บ น
ลายเซ็นต์	ล า ย เ ซ ็ น ต ์
หินย้อย	ห ิ น ย ้ อ ย
แหวะ	แ ห ว ะ
รูม่านตา	ร ู ม ่ า น ต า
ฝึกหัด	ฝ ึ ก ห ั ด
ปรมินทร	ป ร ม ิ น ท ร
เทวะ	เ ท ว ะ
กรดไขมันอิ่มตัว	ก ร ด ไ ข ม ั น อ ิ ่ ม ต ั ว
ส้วม	ส ้ ว ม
ปฐมยาม	ป ฐ ม ย า ม
แฅว	แ ฅ ว
วิทยานิพนธ์	ว ิ ท ย า น ิ พ น ธ ์
วนศาสตร์	ว น ศ า ส ต ร ์
เซ็นต์	เ ซ ็ น ต ์
ปรมินทร์	ป ร ม ิ น ท ร ์
โฟลเดอร์	โ ฟ ล เ ด อ ร ์
แพละโลม	แ พ ล ะ โ ล ม
นิติกรรมอำพราง	น ิ ต ิ ก ร ร ม อ ำ พ ร า ง
องค์กรณ์	อ ง ค ์ ก ร ณ ์
สุภา	ส ุ ภ า
การดม	ก า ร ด ม
กันดาล	ก ั น ด า ล
อิสลามาบาด	อ ิ ส ล า ม า บ า ด
ก้าง	ก ้ า ง
คอมไพเลอร์	ค อ ม ไ พ เ ล อ ร ์
ปริยาย	ป ร ิ ย า ย
สาหัส	ส า ห ั ส
แน่	แ น ่
บัวโนสไอเรส	บ ั ว โ น ส ไ อ เ ร ส
ยีราฟ	ย ี ร า ฟ
ความโง่	ค ว า ม โ ง ่
อัลตร้าซาวด์	อ ั ล ต ร ้ า ซ า ว ด ์
ม้ามืด	ม ้ า ม ื ด
ค้นหา	ค ้ น ห า
อุตรผลคุนี	อ ุ ต ร ผ ล ค ุ น ี
ฝรั่งขี้นก	ฝ ร ั ่ ง ข ี ้ น ก
พารามีเซียม	พ า ร า ม ี เ ซ ี ย ม
คราด	ค ร า ด
การยุบ	ก า ร ย ุ บ
เด็กน้อย	เ ด ็ ก น ้ อ ย
บั้น	บ ั ้ น
การล้อม	ก า ร ล ้ อ ม
ปัณฑุกัมพล	ป ั ณ ฑ ุ ก ั ม พ ล
ความบริบูรณ์	ค ว า ม บ ร ิ บ ู ร ณ ์
อุรณะ	อ ุ ร ณ ะ
ฆ้อน	ฆ ้ อ น
กือราเซา	ก ื อ ร า เ ซ า
กระสา	ก ร ะ ส า
บรั่นดี	บ ร ั ่ น ด ี
ระนาด	ร ะ น า ด
แทง	แ ท ง
โคโลญ	โ ค โ ล ญ
ไข้เลือดออก	ไ ข ้ เ ล ื อ ด อ อ ก
ภาคตัดกรวย	ภ า ค ต ั ด ก ร ว ย
บารอมิเตอร์	บ า ร อ ม ิ เ ต อ ร ์
การแท้ง	ก า ร แ ท ้ ง
ความสุภาพ	ค ว า ม ส ุ ภ า พ
อักษรกลาง	อ ั ก ษ ร ก ล า ง
ขุดรากถอนโคน	ข ุ ด ร า ก ถ อ น โ ค น
อ่าวกินี	อ ่ า ว ก ิ น ี
เยซู	เ ย ซ ู
อรรฆ	อ ร ร ฆ
เยซูคริสต์	เ ย ซ ู ค ร ิ ส ต ์
มะขามป้อม	ม ะ ข า ม ป ้ อ ม
เด็กแนว	เ ด ็ ก แ น ว
ไข่เจียว	ไ ข ่ เ จ ี ย ว
ความเที่ยงธรรม	ค ว า ม เ ท ี ่ ย ง ธ ร ร ม
มลภาวะทางแสง	ม ล ภ า ว ะ ท า ง แ ส ง
น่ารำคาญ	น ่ า ร ำ ค า ญ
การเอาผิด	ก า ร เ อ า ผ ิ ด
ชอล์ก	ช อ ล ์ ก
เปิบ	เ ป ิ บ
รื่นรมย์	ร ื ่ น ร ม ย ์
อัมพฤกษ์	อ ั ม พ ฤ ก ษ ์
ชื่อเล่น	ช ื ่ อ เ ล ่ น
ทะเลสาบ	ท ะ เ ล ส า บ
นักสืบ	น ั ก ส ื บ
การทราบ	ก า ร ท ร า บ
พลเรือน	พ ล เ ร ื อ น
โจทก์	โ จ ท ก ์
อาคารจอดรถ	อ า ค า ร จ อ ด ร ถ
หลุดปาก	ห ล ุ ด ป า ก
นิการากัว	น ิ ก า ร า ก ั ว
อนุภาคมูลฐาน	อ น ุ ภ า ค ม ู ล ฐ า น
ไนจีเรีย	ไ น จ ี เ ร ี ย
โกฏิ	โ ก ฏ ิ
จบการศึกษา	จ บ ก า ร ศ ึ ก ษ า
จุลชีววิทยา	จ ุ ล ช ี ว ว ิ ท ย า
แอสไพริน	แ อ ส ไ พ ร ิ น
กุฏฐัง	ก ุ ฏ ฐ ั ง
ทนายแผ่นดิน	ท น า ย แ ผ ่ น ด ิ น
ไม้หนีบผ้า	ไ ม ้ ห น ี บ ผ ้ า
กระเชอ	ก ร ะ เ ช อ
ประจำเดือน	ป ร ะ จ ำ เ ด ื อ น
น้ำแล้ง	น ้ ำ แ ล ้ ง
สังเวย	ส ั ง เ ว ย
น้ำไหลไฟดับ	น ้ ำ ไ ห ล ไ ฟ ด ั บ
อักขระ	อ ั ก ข ร ะ
การอาเจียน	ก า ร อ า เ จ ี ย น
กระเซ็น	ก ร ะ เ ซ ็ น
มะเดื่อ	ม ะ เ ด ื ่ อ
คูถ	ค ู ถ
ตะแมะแคระ	ต ะ แ ม ะ แ ค ร ะ
เมาส์	เ ม า ส ์
จารชน	จ า ร ช น
เผ่าพันธุ์	เ ผ ่ า พ ั น ธ ุ ์
เบญจเพส	เ บ ญ จ เ พ ส
ค่าไถ่	ค ่ า ไ ถ ่
การประชวร	ก า ร ป ร ะ ช ว ร
ศุลกากร	ศ ุ ล ก า ก ร
อาลัย	อ า ล ั ย
เฟอร์	เ ฟ อ ร ์
บอสเนียและเฮอร์เซโกวีนา	บ อ ส เ น ี ย แ ล ะ เ ฮ อ ร ์ เ ซ โ ก ว ี น า
แช่ง	แ ช ่ ง
หลิว	ห ล ิ ว
การฉลอง	ก า ร ฉ ล อ ง
ให้โดยเสน่หา	ใ ห ้ โ ด ย เ ส น ่ ห า
เปียโน	เ ป ี ย โ น
ญาติดี	ญ า ต ิ ด ี
ศาลปกครอง	ศ า ล ป ก ค ร อ ง
ตู้ปลา	ต ู ้ ป ล า
ฟ้าผ่า	ฟ ้ า ผ ่ า
กระสวยอวกาศ	ก ร ะ ส ว ย อ ว ก า ศ
ต้นสายปลายเหตุ	ต ้ น ส า ย ป ล า ย เ ห ต ุ
โก๋	โ ก ๋
ข่าวสาร	ข ่ า ว ส า ร
เสียอาการ	เ ส ี ย อ า ก า ร
แกว	แ ก ว
เก๊กซิม	เ ก ๊ ก ซ ิ ม
หนังกำพร้า	ห น ั ง ก ำ พ ร ้ า
เจิม	เ จ ิ ม
มีดโกน	ม ี ด โ ก น
กระดูกค้อน	ก ร ะ ด ู ก ค ้ อ น
ตื้น	ต ื ้ น
อวัยวะเพศ	อ ว ั ย ว ะ เ พ ศ
โกงกาง	โ ก ง ก า ง
หลอดอาหาร	ห ล อ ด อ า ห า ร
นาราย	น า ร า ย
หรือยัง	ห ร ื อ ย ั ง
สัตว์ไม่มีกระดูกสันหลัง	ส ั ต ว ์ ไ ม ่ ม ี ก ร ะ ด ู ก ส ั น ห ล ั ง
โลกาภิวัฒน์	โ ล ก า ภ ิ ว ั ฒ น ์
ขี้เหร่	ข ี ้ เ ห ร ่
กฤดีกา	ก ฤ ด ี ก า
เห็นอกเห็นใจ	เ ห ็ น อ ก เ ห ็ น ใ จ
ก็ได้	ก ็ ไ ด ้
ป่าดงพงไพร	ป ่ า ด ง พ ง ไ พ ร
เงินทอน	เ ง ิ น ท อ น
บัยส์	บ ั ย ส ์
นักการตลาด	น ั ก ก า ร ต ล า ด
การกัด	ก า ร ก ั ด
เลือดกำเดา	เ ล ื อ ด ก ำ เ ด า
โท่รห	โ ท ่ ร ห
ส่วนสูง	ส ่ ว น ส ู ง
เวเนซุเอลา	เ ว เ น ซ ุ เ อ ล า
ช้อนโต๊ะ	ช ้ อ น โ ต ๊ ะ
มรณภาพ	ม ร ณ ภ า พ
หัวเทียน	ห ั ว เ ท ี ย น
รูทีเนียม	ร ู ท ี เ น ี ย ม
ยกบัตร	ย ก บ ั ต ร
ฝาด	ฝ า ด
สารานุกรม	ส า ร า น ุ ก ร ม
อวตาร	อ ว ต า ร
ชั่วร้าย	ช ั ่ ว ร ้ า ย
สบู่เหลว	ส บ ู ่ เ ห ล ว
วันทยาวุธ	ว ั น ท ย า ว ุ ธ
กุมภ์	ก ุ ม ภ ์
ประดิษฐาน	ป ร ะ ด ิ ษ ฐ า น
การเพิ่ม	ก า ร เ พ ิ ่ ม
ปริศนา	ป ร ิ ศ น า
ทับซ้อน	ท ั บ ซ ้ อ น
ไทใหญ่	ไ ท ใ ห ญ ่
ตีปีก	ต ี ป ี ก
คนทำความสะอาด	ค น ท ำ ค ว า ม ส ะ อ า ด
เพี้ยน	เ พ ี ้ ย น
ประณต	ป ร ะ ณ ต
เพกาซัส	เ พ ก า ซ ั ส
ห้องสมุด	ห ้ อ ง ส ม ุ ด
เดาะ	เ ด า ะ
สกรู	ส ก ร ู
สงครามจิตวิทยา	ส ง ค ร า ม จ ิ ต ว ิ ท ย า
ตะลึง	ต ะ ล ึ ง
ราชาธิปไตยภายใต้รัฐธรรมนูญ	ร า ช า ธ ิ ป ไ ต ย ภ า ย ใ ต ้ ร ั ฐ ธ ร ร ม น ู ญ
วันวาเลนไทน์	ว ั น ว า เ ล น ไ ท น ์
หนูผี	ห น ู ผ ี
ต่อรอง	ต ่ อ ร อ ง
โอโจ้	โ อ โ จ ้
เปลือกหอย	เ ป ล ื อ ก ห อ ย
พะยูง	พ ะ ย ู ง
ระบบรวบอำนาจเบ็ดเสร็จ	ร ะ บ บ ร ว บ อ ำ น า จ เ บ ็ ด เ ส ร ็ จ
ฮาร์ตฟอร์ด	ฮ า ร ์ ต ฟ อ ร ์ ด
ปฏิสัมพันธ์	ป ฏ ิ ส ั ม พ ั น ธ ์
พระราชกำหนด	พ ร ะ ร า ช ก ำ ห น ด
รถไฟเหาะตีลังกา	ร ถ ไ ฟ เ ห า ะ ต ี ล ั ง ก า
ขนตา	ข น ต า
ชิเมจิ	ช ิ เ ม จ ิ
นอกใจ	น อ ก ใ จ
ความเสียดสี	ค ว า ม เ ส ี ย ด ส ี
หาง	ห า ง
แรสเบอร์รี	แ ร ส เ บ อ ร ์ ร ี
ความน่ารัก	ค ว า ม น ่ า ร ั ก
กระดิก	ก ร ะ ด ิ ก
รถบดถนน	ร ถ บ ด ถ น น
มีดพับ	ม ี ด พ ั บ
โคไพร	โ ค ไ พ ร
ผลักดัน	ผ ล ั ก ด ั น
ลูกน้อง	ล ู ก น ้ อ ง
ไก่ได้พลอย	ไ ก ่ ไ ด ้ พ ล อ ย
กระจก	ก ร ะ จ ก
ก้นหอย	ก ้ น ห อ ย
พลูโต	พ ล ู โ ต
แกงได	แ ก ง ไ ด
การแก้ไขเพิ่มเติม	ก า ร แ ก ้ ไ ข เ พ ิ ่ ม เ ต ิ ม
ขี้หมูขี้หมา	ข ี ้ ห ม ู ข ี ้ ห ม า
ฟั่น	ฟ ั ่ น
จำนวนเฉพาะ	จ ำ น ว น เ ฉ พ า ะ
ข้างหลัง	ข ้ า ง ห ล ั ง
เล่นสกปรก	เ ล ่ น ส ก ป ร ก
ตารางเวลา	ต า ร า ง เ ว ล า
ค้างคาว	ค ้ า ง ค า ว
ต้นหอม	ต ้ น ห อ ม
จิตขุนทด	จ ิ ต ข ุ น ท ด
เก๊ก	เ ก ๊ ก
ไทดำ	ไ ท ด ำ
ความป่วย	ค ว า ม ป ่ ว ย
จังไร	จ ั ง ไ ร
ปากหวาน	ป า ก ห ว า น
ตัก	ต ั ก
การผลัก	ก า ร ผ ล ั ก
ฝึกปรือ	ฝ ึ ก ป ร ื อ
ต่อมใต้สมอง	ต ่ อ ม ใ ต ้ ส ม อ ง
ไลแล็ค	ไ ล แ ล ็ ค
แทสเมเนียนเดวิล	แ ท ส เ ม เ น ี ย น เ ด ว ิ ล
ตำลึง	ต ำ ล ึ ง
ที่หก	ท ี ่ ห ก
น้ำมันดิน	น ้ ำ ม ั น ด ิ น
วันวิสาขบูชา	ว ั น ว ิ ส า ข บ ู ช า
หิ้ว	ห ิ ้ ว
ดีกรี	ด ี ก ร ี
สแลง	ส แ ล ง
มุขมนตรี	ม ุ ข ม น ต ร ี
โรงทหาร	โ ร ง ท ห า ร
อะลาดิน	อ ะ ล า ด ิ น
การเกรง	ก า ร เ ก ร ง
จันทบุรี	จ ั น ท บ ุ ร ี
ดูออก	ด ู อ อ ก
หว้า	ห ว ้ า
หัวเรื่อง	ห ั ว เ ร ื ่ อ ง
ปีติ	ป ี ต ิ
นางฟ้า	น า ง ฟ ้ า
ปลดกลางอากาศ	ป ล ด ก ล า ง อ า ก า ศ
ผ้าห่ม	ผ ้ า ห ่ ม
พ่อครัว	พ ่ อ ค ร ั ว
ท้องฟ้าจำลอง	ท ้ อ ง ฟ ้ า จ ำ ล อ ง
ไอน้ำ	ไ อ น ้ ำ
แปรปรวน	แ ป ร ป ร ว น
สถล	ส ถ ล
การเลือกตั้งทั่วไป	ก า ร เ ล ื อ ก ต ั ้ ง ท ั ่ ว ไ ป
วุ้นแปลภาษา	ว ุ ้ น แ ป ล ภ า ษ า
แม่บท	แ ม ่ บ ท
แพรว	แ พ ร ว
แบนโจ	แ บ น โ จ
การมั่วสุม	ก า ร ม ั ่ ว ส ุ ม
ไฟป่า	ไ ฟ ป ่ า
น่าสงสัย	น ่ า ส ง ส ั ย
ความสามัคคี	ค ว า ม ส า ม ั ค ค ี
มะหะหมัด	ม ะ ห ะ ห ม ั ด
แมกนีเซียม	แ ม ก น ี เ ซ ี ย ม
รำบาญ	ร ำ บ า ญ
วิกรม	ว ิ ก ร ม
นัมเบอร์	น ั ม เ บ อ ร ์
สันนิบาต	ส ั น น ิ บ า ต
กฤติกา	ก ฤ ต ิ ก า
นมนาง	น ม น า ง
เหร่	เ ห ร ่
ครึ้ม	ค ร ึ ้ ม
รูเบิล	ร ู เ บ ิ ล
พลับพลึง	พ ล ั บ พ ล ึ ง
ความเคารพ	ค ว า ม เ ค า ร พ
ตะหลิว	ต ะ ห ล ิ ว
ชนม์	ช น ม ์
ดูหมิ่น	ด ู ห ม ิ ่ น
ของฝาก	ข อ ง ฝ า ก
ภูมิคุ้มกันหมู่	ภ ู ม ิ ค ุ ้ ม ก ั น ห ม ู ่
กุ้งมังกร	ก ุ ้ ง ม ั ง ก ร
ง่าม	ง ่ า ม
คุณชื่ออะไรคะ	ค ุ ณ ช ื ่ อ อ ะ ไ ร ค ะ
องค์การระหว่างประเทศ	อ ง ค ์ ก า ร ร ะ ห ว ่ า ง ป ร ะ เ ท ศ
แรงดันไฟฟ้า	แ ร ง ด ั น ไ ฟ ฟ ้ า
ดินสอสี	ด ิ น ส อ ส ี
นานาจิตตัง	น า น า จ ิ ต ต ั ง
ถถถ	ถ ถ ถ
โม้	โ ม ้
มัสยา	ม ั ส ย า
บุพการี	บ ุ พ ก า ร ี
เกรียงไกร	เ ก ร ี ย ง ไ ก ร
ทำนูล	ท ำ น ู ล
ดาวเรือง	ด า ว เ ร ื อ ง
ทรงรี	ท ร ง ร ี
อินโดนีเซีย	อ ิ น โ ด น ี เ ซ ี ย
ความขม	ค ว า ม ข ม
แผ่นดินไหวตาม	แ ผ ่ น ด ิ น ไ ห ว ต า ม
ดัตช์	ด ั ต ช ์
บาทหลวง	บ า ท ห ล ว ง
ประชาพิจารณ์	ป ร ะ ช า พ ิ จ า ร ณ ์
กิเลน	ก ิ เ ล น
กระดุม	ก ร ะ ด ุ ม
เด็กอ่อน	เ ด ็ ก อ ่ อ น
การระบาด	ก า ร ร ะ บ า ด
แฟนไซต์	แ ฟ น ไ ซ ต ์
ไกปืน	ไ ก ป ื น
กระบุง	ก ร ะ บ ุ ง
กระษัตริย์	ก ร ะ ษ ั ต ร ิ ย ์
แนวหน้า	แ น ว ห น ้ า
ห่าม	ห ่ า ม
ค่าสินไหมทดแทน	ค ่ า ส ิ น ไ ห ม ท ด แ ท น
การอับปาง	ก า ร อ ั บ ป า ง
วัว	ว ั ว
ไฮเตอร์	ไ ฮ เ ต อ ร ์
พาด	พ า ด
เงย	เ ง ย
เชน	เ ช น
ดุริยางค์	ด ุ ร ิ ย า ง ค ์
ครั้น	ค ร ั ้ น
ผ้านุ่ง	ผ ้ า น ุ ่ ง
เรือเหาะ	เ ร ื อ เ ห า ะ
หนังสือเดินทาง	ห น ั ง ส ื อ เ ด ิ น ท า ง
กลับเนื้อกลับตัว	ก ล ั บ เ น ื ้ อ ก ล ั บ ต ั ว
มณีปุระ	ม ณ ี ป ุ ร ะ
โมฆบุรุษ	โ ม ฆ บ ุ ร ุ ษ
ชบา	ช บ า
มะกอก	ม ะ ก อ ก
กำนัน	ก ำ น ั น
เห็นแก่ตัว	เ ห ็ น แ ก ่ ต ั ว
แฟ้ม	แ ฟ ้ ม
ตุ่ม	ต ุ ่ ม
พุทธศักราช	พ ุ ท ธ ศ ั ก ร า ช
ทะเลแดง	ท ะ เ ล แ ด ง
นัยนา	น ั ย น า
อารยธรรม	อ า ร ย ธ ร ร ม
เรียก	เ ร ี ย ก
หน้าใบไม้ผลิ	ห น ้ า ใ บ ไ ม ้ ผ ล ิ
อัณฑะ	อ ั ณ ฑ ะ
ตลาดหุ้น	ต ล า ด ห ุ ้ น
กำเดา	ก ำ เ ด า
ม้าม	ม ้ า ม
ความโชคดี	ค ว า ม โ ช ค ด ี
กระสุน	ก ร ะ ส ุ น
กินนร	ก ิ น น ร
คาง	ค า ง
ผ้านวม	ผ ้ า น ว ม
ชานอ้อย	ช า น อ ้ อ ย
ลิเธียม	ล ิ เ ธ ี ย ม
แก้ไขเพิ่มเติม	แ ก ้ ไ ข เ พ ิ ่ ม เ ต ิ ม
อุ้ง	อ ุ ้ ง
นักสเก็ต	น ั ก ส เ ก ็ ต
ฮัลโหล	ฮ ั ล โ ห ล
เฉือน	เ ฉ ื อ น
คำเตือน	ค ำ เ ต ื อ น
อาคเนย์	อ า ค เ น ย ์
เจ้าประเทศราช	เ จ ้ า ป ร ะ เ ท ศ ร า ช
หมายบังคับคดี	ห ม า ย บ ั ง ค ั บ ค ด ี
ควันหลง	ค ว ั น ห ล ง
ตุ๊กตาเสียกบาล	ต ุ ๊ ก ต า เ ส ี ย ก บ า ล
เสื้อกล้าม	เ ส ื ้ อ ก ล ้ า ม
ฆ่าช้างเอางา	ฆ ่ า ช ้ า ง เ อ า ง า
ศัลยแพทย์	ศ ั ล ย แ พ ท ย ์
หงอก	ห ง อ ก
พังพาน	พ ั ง พ า น
พหุภพ	พ ห ุ ภ พ
ผมปลอม	ผ ม ป ล อ ม
ชาดก	ช า ด ก
อักษรสูง	อ ั ก ษ ร ส ู ง
ความหลากหลายทางชีวภาพ	ค ว า ม ห ล า ก ห ล า ย ท า ง ช ี ว ภ า พ
ขลับ	ข ล ั บ
เบาใจ	เ บ า ใ จ
ใยแก้วนำแสง	ใ ย แ ก ้ ว น ำ แ ส ง
ม่องเท่ง	ม ่ อ ง เ ท ่ ง
ญาดา	ญ า ด า
การคลอด	ก า ร ค ล อ ด
การสืบพันธุ์	ก า ร ส ื บ พ ั น ธ ุ ์
คดีหมายเลขดำ	ค ด ี ห ม า ย เ ล ข ด ำ
ความเหี้ยมโหด	ค ว า ม เ ห ี ้ ย ม โ ห ด
อะตอม	อ ะ ต อ ม
อนาธิปไตย	อ น า ธ ิ ป ไ ต ย
อกภูเขาไฟ	อ ก ภ ู เ ข า ไ ฟ
พินัย	พ ิ น ั ย
โอบามา	โ อ บ า ม า
สมองไหล	ส ม อ ง ไ ห ล
ลูกกรุง	ล ู ก ก ร ุ ง
ยางมะตูม	ย า ง ม ะ ต ู ม
เม้าส์	เ ม ้ า ส ์
บาลี	บ า ล ี
สารละลาย	ส า ร ล ะ ล า ย
ขี่ช้างจับตั๊กแตน	ข ี ่ ช ้ า ง จ ั บ ต ั ๊ ก แ ต น
สิบสองปันนา	ส ิ บ ส อ ง ป ั น น า
ง้าว	ง ้ า ว
การผ่าเหล่า	ก า ร ผ ่ า เ ห ล ่ า
สตรีนิยม	ส ต ร ี น ิ ย ม
การผงก	ก า ร ผ ง ก
การละเมิดอำนาจศาล	ก า ร ล ะ เ ม ิ ด อ ำ น า จ ศ า ล
คันเหยียบ	ค ั น เ ห ย ี ย บ
มนตร์	ม น ต ร ์
ความใกล้เคียง	ค ว า ม ใ ก ล ้ เ ค ี ย ง
สามเหลี่ยมมุมแหลม	ส า ม เ ห ล ี ่ ย ม ม ุ ม แ ห ล ม
การแอ๊บแบ๊ว	ก า ร แ อ ๊ บ แ บ ๊ ว
การทักทาย	ก า ร ท ั ก ท า ย
กันตรึม	ก ั น ต ร ึ ม
เชื่อง	เ ช ื ่ อ ง
ทะลุทะลวง	ท ะ ล ุ ท ะ ล ว ง
นักแม่นปืน	น ั ก แ ม ่ น ป ื น
โหรา	โ ห ร า
ฝีเท้า	ฝ ี เ ท ้ า
ตั๋วทนาย	ต ั ๋ ว ท น า ย
สารก่อไข้	ส า ร ก ่ อ ไ ข ้
เคล้า	เ ค ล ้ า
ความศรัทธา	ค ว า ม ศ ร ั ท ธ า
รอบคอบ	ร อ บ ค อ บ
อัตราร้อยละ	อ ั ต ร า ร ้ อ ย ล ะ
ลูกผสม	ล ู ก ผ ส ม
โธวนะ	โ ธ ว น ะ
ความดัง	ค ว า ม ด ั ง
ฝอย	ฝ อ ย
เขียง	เ ข ี ย ง
จ่าหน้า	จ ่ า ห น ้ า
บาดทะยัก	บ า ด ท ะ ย ั ก
โอปอล	โ อ ป อ ล
จี๊ด	จ ี ๊ ด
นักรัฐศาสตร์	น ั ก ร ั ฐ ศ า ส ต ร ์
ลิเบีย	ล ิ เ บ ี ย
เครื่องแบบ	เ ค ร ื ่ อ ง แ บ บ
วิงเวียน	ว ิ ง เ ว ี ย น
ซายองเต้	ซ า ย อ ง เ ต ้
ต้มยำ	ต ้ ม ย ำ
ดำรัส	ด ำ ร ั ส
คลุมเครือ	ค ล ุ ม เ ค ร ื อ
การโกหก	ก า ร โ ก ห ก
บุญหนักศักดิ์ใหญ่	บ ุ ญ ห น ั ก ศ ั ก ด ิ ์ ใ ห ญ ่
นางไม้	น า ง ไ ม ้
เจอร์เมเนียม	เ จ อ ร ์ เ ม เ น ี ย ม
ฮัดชิ้ว	ฮ ั ด ช ิ ้ ว
รูหนู	ร ู ห น ู
หว่าน	ห ว ่ า น
เวทนา	เ ว ท น า
หลอน	ห ล อ น
ไม้เซลฟี	ไ ม ้ เ ซ ล ฟ ี
ยุ้ง	ย ุ ้ ง
หลาม	ห ล า ม
ดำรง	ด ำ ร ง
เอื้อง	เ อ ื ้ อ ง
ตาลปัตร	ต า ล ป ั ต ร
สูด	ส ู ด
นิ้วหัวแม่มือ	น ิ ้ ว ห ั ว แ ม ่ ม ื อ
ผู้กำกับภาพยนตร์	ผ ู ้ ก ำ ก ั บ ภ า พ ย น ต ร ์
เพิก	เ พ ิ ก
หน้ามืด	ห น ้ า ม ื ด
พิกุล	พ ิ ก ุ ล
ลวงตา	ล ว ง ต า
ประเสริฐ	ป ร ะ เ ส ร ิ ฐ
จอมปลวก	จ อ ม ป ล ว ก
รหัส	ร ห ั ส
แปดเหลี่ยม	แ ป ด เ ห ล ี ่ ย ม
โมรา	โ ม ร า
หนอนบ่อนไส้	ห น อ น บ ่ อ น ไ ส ้
ใจแคบ	ใ จ แ ค บ
ดาวแคระขาว	ด า ว แ ค ร ะ ข า ว
แทนซาเนีย	แ ท น ซ า เ น ี ย
ออกนั่งพิจารณา	อ อ ก น ั ่ ง พ ิ จ า ร ณ า
เช้ง	เ ช ้ ง
ปลิง	ป ล ิ ง
กรรไกร	ก ร ร ไ ก ร
สยอง	ส ย อ ง
น่าฮัก	น ่ า ฮ ั ก
ลายสือ	ล า ย ส ื อ
ไม้จิ้มฟัน	ไ ม ้ จ ิ ้ ม ฟ ั น
การรู้	ก า ร ร ู ้
สรง	ส ร ง
ตะไคร่น้ำ	ต ะ ไ ค ร ่ น ้ ำ
เนียง	เ น ี ย ง
แพทยศาสตร์	แ พ ท ย ศ า ส ต ร ์
ปาปัวนิวกินี	ป า ป ั ว น ิ ว ก ิ น ี
มาดราซาห์	ม า ด ร า ซ า ห ์
ยึดครอง	ย ึ ด ค ร อ ง
ตัวอ่อน	ต ั ว อ ่ อ น
พระทัย	พ ร ะ ท ั ย
ฝอยทอง	ฝ อ ย ท อ ง
ทาจิกิสถาน	ท า จ ิ ก ิ ส ถ า น
คู่กรณี	ค ู ่ ก ร ณ ี
โวลต์	โ ว ล ต ์
ล็อกดาวน์	ล ็ อ ก ด า ว น ์
หอระฆัง	ห อ ร ะ ฆ ั ง
อากาศยานต่อสู้ไร้คนขับ	อ า ก า ศ ย า น ต ่ อ ส ู ้ ไ ร ้ ค น ข ั บ
น้ำผลไม้	น ้ ำ ผ ล ไ ม ้
โรมะจิ	โ ร ม ะ จ ิ
ประณาม	ป ร ะ ณ า ม
อุทาหรณ์	อ ุ ท า ห ร ณ ์
ตุ๊กตาแม่ลูกดก	ต ุ ๊ ก ต า แ ม ่ ล ู ก ด ก
พนมเปญ	พ น ม เ ป ญ
ดิ้น	ด ิ ้ น
ภูมิทัศน์	ภ ู ม ิ ท ั ศ น ์
เบริลเลียม	เ บ ร ิ ล เ ล ี ย ม
ก้านสมอง	ก ้ า น ส ม อ ง
ความเศร้า	ค ว า ม เ ศ ร ้ า
ปากดี	ป า ก ด ี
คอสตาริกา	ค อ ส ต า ร ิ ก า
มเหสี	ม เ ห ส ี
จางหาย	จ า ง ห า ย
ยศถาบรรดาศักดิ์	ย ศ ถ า บ ร ร ด า ศ ั ก ด ิ ์
ประจุ	ป ร ะ จ ุ
โซฟา	โ ซ ฟ า
สังค์	ส ั ง ค ์
รีบร้อน	ร ี บ ร ้ อ น
แสงวาบรังสีแกมมา	แ ส ง ว า บ ร ั ง ส ี แ ก ม ม า
สัตวแพทย์	ส ั ต ว แ พ ท ย ์
แพลทินัม	แ พ ล ท ิ น ั ม
เนื้อแดง	เ น ื ้ อ แ ด ง
ภาพยนตร์สารคดี	ภ า พ ย น ต ร ์ ส า ร ค ด ี
พงศาวดาร	พ ง ศ า ว ด า ร
เสื้อกันฝน	เ ส ื ้ อ ก ั น ฝ น
เมือก	เ ม ื อ ก
ละครทีวี	ล ะ ค ร ท ี ว ี
ไหมขัดฟัน	ไ ห ม ข ั ด ฟ ั น
การอยู่	ก า ร อ ย ู ่
อักขรวิธี	อ ั ก ข ร ว ิ ธ ี
กุลี	ก ุ ล ี
ดอลล่าร์	ด อ ล ล ่ า ร ์
การชุมนุม	ก า ร ช ุ ม น ุ ม
๑๕	๑ ๕
วัณโรค	ว ั ณ โ ร ค
พยัญชนะ	พ ย ั ญ ช น ะ
โว	โ ว
ดวงอาทิตย์เที่ยงคืน	ด ว ง อ า ท ิ ต ย ์ เ ท ี ่ ย ง ค ื น
สถานีอวกาศ	ส ถ า น ี อ ว ก า ศ
สี่เหลี่ยมรูปว่าว	ส ี ่ เ ห ล ี ่ ย ม ร ู ป ว ่ า ว
วินาศกรรม	ว ิ น า ศ ก ร ร ม
ขวาน	ข ว า น
ขอร้อง	ข อ ร ้ อ ง
ขุ่นเคือง	ข ุ ่ น เ ค ื อ ง
ฝ่าฟัน	ฝ ่ า ฟ ั น
วันยังค่ำ	ว ั น ย ั ง ค ่ ำ
ตรัส	ต ร ั ส
เสียม	เ ส ี ย ม
โก-ลก	โ ก - ล ก
เป่ย์จิง	เ ป ่ ย ์ จ ิ ง
ผู้บัญญัติกฎหมาย	ผ ู ้ บ ั ญ ญ ั ต ิ ก ฎ ห ม า ย
ทางน้ำล้น	ท า ง น ้ ำ ล ้ น
นราธิวาส	น ร า ธ ิ ว า ส
ความซวย	ค ว า ม ซ ว ย
พี่สาว	พ ี ่ ส า ว
เกรวี	เ ก ร ว ี
ผัด	ผ ั ด
ขว้าง	ข ว ้ า ง
พนักงานต้อนรับ	พ น ั ก ง า น ต ้ อ น ร ั บ
ไฮดรา	ไ ฮ ด ร า
แสร้งว่า	แ ส ร ้ ง ว ่ า
ทำนองเสียง	ท ำ น อ ง เ ส ี ย ง
แคนเบอร์รา	แ ค น เ บ อ ร ์ ร า
การคอย	ก า ร ค อ ย
สายด่วน	ส า ย ด ่ ว น
มหากาพย์	ม ห า ก า พ ย ์
โฑครี	โ ฑ ค ร ี
เครื่องทุ่นแรง	เ ค ร ื ่ อ ง ท ุ ่ น แ ร ง
หาเสียง	ห า เ ส ี ย ง
กรรไกรเล็ก	ก ร ร ไ ก ร เ ล ็ ก
คำพ้องรูป	ค ำ พ ้ อ ง ร ู ป
เนยขาว	เ น ย ข า ว
แยบยล	แ ย บ ย ล
ติดอ่าง	ต ิ ด อ ่ า ง
ทุนนิยม	ท ุ น น ิ ย ม
ยะลา	ย ะ ล า
เอื้อเฟื้อ	เ อ ื ้ อ เ ฟ ื ้ อ
พื้นดิน	พ ื ้ น ด ิ น
มันฝรั่ง	ม ั น ฝ ร ั ่ ง
บ้าบิ่น	บ ้ า บ ิ ่ น
เอื่อย	เ อ ื ่ อ ย
สะอึก	ส ะ อ ึ ก
เจ้าสำนัก	เ จ ้ า ส ำ น ั ก
บ้านช่องห้องหอ	บ ้ า น ช ่ อ ง ห ้ อ ง ห อ
ความเพ้อเจ้อ	ค ว า ม เ พ ้ อ เ จ ้ อ
ทวีป	ท ว ี ป
ประโยคความซ้อน	ป ร ะ โ ย ค ค ว า ม ซ ้ อ น
ห่าง	ห ่ า ง
ปิ๊ง	ป ิ ๊ ง
กิเลส	ก ิ เ ล ส
แบเรียม	แ บ เ ร ี ย ม
อบเชย	อ บ เ ช ย
นิวเดลี	น ิ ว เ ด ล ี
ฉลูศก	ฉ ล ู ศ ก
มะแม	ม ะ แ ม
ควาญ	ค ว า ญ
กลเม็ด	ก ล เ ม ็ ด
สก็อต	ส ก ็ อ ต
ภาษาต่างดาว	ภ า ษ า ต ่ า ง ด า ว
สะท้าน	ส ะ ท ้ า น
อัปปาง	อ ั ป ป า ง
สัทอักษร	ส ั ท อ ั ก ษ ร
รากฝอย	ร า ก ฝ อ ย
จำนง	จ ำ น ง
มนุษย์ขนมปังขิง	ม น ุ ษ ย ์ ข น ม ป ั ง ข ิ ง
จุดสุดยอดทางเพศ	จ ุ ด ส ุ ด ย อ ด ท า ง เ พ ศ
รปภ.	ร ป ภ .
นัดยิ้ม	น ั ด ย ิ ้ ม
ธารน้ำแข็ง	ธ า ร น ้ ำ แ ข ็ ง
เชยชม	เ ช ย ช ม
เนติบัณฑิต	เ น ต ิ บ ั ณ ฑ ิ ต
พื้นเมือง	พ ื ้ น เ ม ื อ ง
หางเครื่อง	ห า ง เ ค ร ื ่ อ ง
สารก่อภูมิต้านทาน	ส า ร ก ่ อ ภ ู ม ิ ต ้ า น ท า น
น่านฟ้า	น ่ า น ฟ ้ า
ยิมนาสติก	ย ิ ม น า ส ต ิ ก
สก็อตแลนด์	ส ก ็ อ ต แ ล น ด ์
ดับบลิว	ด ั บ บ ล ิ ว
วางวาย	ว า ง ว า ย
แท่นบูชา	แ ท ่ น บ ู ช า
ไอยรา	ไ อ ย ร า
เครื่องเสวย	เ ค ร ื ่ อ ง เ ส ว ย
แตงโม	แ ต ง โ ม
โละ	โ ล ะ
คริสตจักร	ค ร ิ ส ต จ ั ก ร
ลำไส้เล็ก	ล ำ ไ ส ้ เ ล ็ ก
ร้านสุรา	ร ้ า น ส ุ ร า
อริยบุคคล	อ ร ิ ย บ ุ ค ค ล
เก็บดอกไม้	เ ก ็ บ ด อ ก ไ ม ้
การขุด	ก า ร ข ุ ด
คีตะ	ค ี ต ะ
ธรณีประตู	ธ ร ณ ี ป ร ะ ต ู
ทวารวดี	ท ว า ร ว ด ี
เบี้ยประกัน	เ บ ี ้ ย ป ร ะ ก ั น
บาหลี	บ า ห ล ี
รถเมล์	ร ถ เ ม ล ์
ก้อย	ก ้ อ ย
สัตว์มีกระเป๋าหน้าท้อง	ส ั ต ว ์ ม ี ก ร ะ เ ป ๋ า ห น ้ า ท ้ อ ง
ไก่ป่า	ไ ก ่ ป ่ า
ความล้า	ค ว า ม ล ้ า
พีพี	พ ี พ ี
สิ่งปฏิกูล	ส ิ ่ ง ป ฏ ิ ก ู ล
การสาวไส้	ก า ร ส า ว ไ ส ้
หลังไมค์	ห ล ั ง ไ ม ค ์
น้ำเกลือ	น ้ ำ เ ก ล ื อ
รีกา	ร ี ก า
พริกหยวก	พ ร ิ ก ห ย ว ก
ประนาม	ป ร ะ น า ม
มาลาวี	ม า ล า ว ี
หน้าเป็น	ห น ้ า เ ป ็ น
สิบแปดมงกุฏ	ส ิ บ แ ป ด ม ง ก ุ ฏ
โป๊ยเซียน	โ ป ๊ ย เ ซ ี ย น
กระพือ	ก ร ะ พ ื อ
พี่ชาย	พ ี ่ ช า ย
นักกระโดดน้ำ	น ั ก ก ร ะ โ ด ด น ้ ำ
ปลายาว	ป ล า ย า ว
สุขภัณฑ์	ส ุ ข ภ ั ณ ฑ ์
การไต่สวน	ก า ร ไ ต ่ ส ว น
เด็กผู้ชาย	เ ด ็ ก ผ ู ้ ช า ย
นักแปล	น ั ก แ ป ล
เกรตบริเตน	เ ก ร ต บ ร ิ เ ต น
ให้อภัย	ใ ห ้ อ ภ ั ย
ตั้งใจ	ต ั ้ ง ใ จ
การจำลอง	ก า ร จ ำ ล อ ง
ฮิปโปโปเตมัส	ฮ ิ ป โ ป โ ป เ ต ม ั ส
ความตาย	ค ว า ม ต า ย
ปัจฉิม	ป ั จ ฉ ิ ม
กวีนิพนธ์	ก ว ี น ิ พ น ธ ์
ไอออน	ไ อ อ อ น
อุรังอุตัง	อ ุ ร ั ง อ ุ ต ั ง
สะบัด	ส ะ บ ั ด
ไทลื้อ	ไ ท ล ื ้ อ
ตะเข็บ	ต ะ เ ข ็ บ
สงครามกลางเมือง	ส ง ค ร า ม ก ล า ง เ ม ื อ ง
ฆรณี	ฆ ร ณ ี
คำราม	ค ำ ร า ม
โหดร้าย	โ ห ด ร ้ า ย
ด้าม	ด ้ า ม
เดดซี	เ ด ด ซ ี
ผู้พิมพ์	ผ ู ้ พ ิ ม พ ์
ลอยนวล	ล อ ย น ว ล
การอ้วก	ก า ร อ ้ ว ก
ซามัว	ซ า ม ั ว
รังเกียจ	ร ั ง เ ก ี ย จ
ปั๊มน้ำมัน	ป ั ๊ ม น ้ ำ ม ั น
สายลับ	ส า ย ล ั บ
โรมาจิ	โ ร ม า จ ิ
ซักอบรีด	ซ ั ก อ บ ร ี ด
แจ๋ว	แ จ ๋ ว
นักเคลื่อนไหว	น ั ก เ ค ล ื ่ อ น ไ ห ว
ปือ	ป ื อ
ลิดรอน	ล ิ ด ร อ น
สรทะ	ส ร ท ะ
ติดสัด	ต ิ ด ส ั ด
ช่างเทคนิค	ช ่ า ง เ ท ค น ิ ค
อาณาเขต	อ า ณ า เ ข ต
มวยโบราณ	ม ว ย โ บ ร า ณ
ผู้เยาว์	ผ ู ้ เ ย า ว ์
แขวนบนเส้นด้าย	แ ข ว น บ น เ ส ้ น ด ้ า ย
แคชเมียร์	แ ค ช เ ม ี ย ร ์
ชะเนียง	ช ะ เ น ี ย ง
ใส่ความ	ใ ส ่ ค ว า ม
จัดไป	จ ั ด ไ ป
นาสิก	น า ส ิ ก
ทาฐิกะ	ท า ฐ ิ ก ะ
แพลงก์ตอน	แ พ ล ง ก ์ ต อ น
ซินแส	ซ ิ น แ ส
ลิลลี่	ล ิ ล ล ี ่
ผลัด	ผ ล ั ด
ภาพพจน์	ภ า พ พ จ น ์
เพศรวม	เ พ ศ ร ว ม
แวมไพร์	แ ว ม ไ พ ร ์
โครยอ	โ ค ร ย อ
ตุนาหงัน	ต ุ น า ห ง ั น
ตองกา	ต อ ง ก า
ธากา	ธ า ก า
แปลน	แ ป ล น
สันติวิธี	ส ั น ต ิ ว ิ ธ ี
ละทิ้ง	ล ะ ท ิ ้ ง
การชง	ก า ร ช ง
รูปปั้น	ร ู ป ป ั ้ น
เหนี่ยว	เ ห น ี ่ ย ว
ปลิว	ป ล ิ ว
เมียร์แคต	เ ม ี ย ร ์ แ ค ต
ลอว์เรนเซียม	ล อ ว ์ เ ร น เ ซ ี ย ม
กล้วย	ก ล ้ ว ย
การค้าประเวณี	ก า ร ค ้ า ป ร ะ เ ว ณ ี
ปล่อง	ป ล ่ อ ง
อะแลสกา	อ ะ แ ล ส ก า
ยูนิคอร์น	ย ู น ิ ค อ ร ์ น
การรับรอง	ก า ร ร ั บ ร อ ง
คีเฟอร์	ค ี เ ฟ อ ร ์
ในหลวง	ใ น ห ล ว ง
อิวเมี่ยน	อ ิ ว เ ม ี ่ ย น
ลึงค์	ล ึ ง ค ์
จีนแส	จ ี น แ ส
แจกัน	แ จ ก ั น
ใช้บังคับ	ใ ช ้ บ ั ง ค ั บ
คำแปล	ค ำ แ ป ล
หน้าผีบอดี้เน่า	ห น ้ า ผ ี บ อ ด ี ้ เ น ่ า
ตื๊อ	ต ื ๊ อ
กัดกร่อน	ก ั ด ก ร ่ อ น
กระป๋อง	ก ร ะ ป ๋ อ ง
เส้นทางสายไหม	เ ส ้ น ท า ง ส า ย ไ ห ม
ผีเสื้อกลางคืน	ผ ี เ ส ื ้ อ ก ล า ง ค ื น
แคะ	แ ค ะ
เตาไฟ	เ ต า ไ ฟ
ควาน	ค ว า น
อัสสัม	อ ั ส ส ั ม
เครื่องสูบ	เ ค ร ื ่ อ ง ส ู บ
การประหาร	ก า ร ป ร ะ ห า ร
สูจิ	ส ู จ ิ
เทศน์	เ ท ศ น ์
สวนสนาม	ส ว น ส น า ม
ฤๅสาย	ฤ ๅ ส า ย
อุบาย	อ ุ บ า ย
เบสบอล	เ บ ส บ อ ล
มูตร	ม ู ต ร
วงโคจร	ว ง โ ค จ ร
โน	โ น
สวด	ส ว ด
อับปาง	อ ั บ ป า ง
กรงเล็บ	ก ร ง เ ล ็ บ
เหา	เ ห า
ฟิวส์	ฟ ิ ว ส ์
พัทลุง	พ ั ท ล ุ ง
ประเชิญ	ป ร ะ เ ช ิ ญ
พรหมจารี	พ ร ห ม จ า ร ี
การเรียนรู้เชิงลึก	ก า ร เ ร ี ย น ร ู ้ เ ช ิ ง ล ึ ก
วาต	ว า ต
แพะ	แ พ ะ
ออร์แกน	อ อ ร ์ แ ก น
ไส	ไ ส
สมุทรปราการ	ส ม ุ ท ร ป ร า ก า ร
ความกด	ค ว า ม ก ด
จินตภาพ	จ ิ น ต ภ า พ
ทะลาย	ท ะ ล า ย
ฟูนะฟูตี	ฟ ู น ะ ฟ ู ต ี
โมดูล	โ ม ด ู ล
ไพร่ฟ้า	ไ พ ร ่ ฟ ้ า
แป้น	แ ป ้ น
กักขัง	ก ั ก ข ั ง
เล่ห์	เ ล ่ ห ์
นันทนาการ	น ั น ท น า ก า ร
ฉวัดเฉวียน	ฉ ว ั ด เ ฉ ว ี ย น
โควิท	โ ค ว ิ ท
แอปเปิล	แ อ ป เ ป ิ ล
คลอก	ค ล อ ก
กิจการของอัครทูต	ก ิ จ ก า ร ข อ ง อ ั ค ร ท ู ต
การเบิกความ	ก า ร เ บ ิ ก ค ว า ม
กบฏ	ก บ ฏ
คริสตศักราช	ค ร ิ ส ต ศ ั ก ร า ช
อนุญาโตตุลาการ	อ น ุ ญ า โ ต ต ุ ล า ก า ร
หม้อไฟ	ห ม ้ อ ไ ฟ
หย่านม	ห ย ่ า น ม
ดุ้น	ด ุ ้ น
อาร์คันซอ	อ า ร ์ ค ั น ซ อ
หวังดี	ห ว ั ง ด ี
จิ้งเหลน	จ ิ ้ ง เ ห ล น
รถถัง	ร ถ ถ ั ง
มั่งมี	ม ั ่ ง ม ี
ใชย	ใ ช ย
กำปั่น	ก ำ ป ั ่ น
เฉาก๊วย	เ ฉ า ก ๊ ว ย
การก่อการร้าย	ก า ร ก ่ อ ก า ร ร ้ า ย
แครอท	แ ค ร อ ท
หมอนข้าง	ห ม อ น ข ้ า ง
สาธารณรัฐประชาธิปไตยคองโก	ส า ธ า ร ณ ร ั ฐ ป ร ะ ช า ธ ิ ป ไ ต ย ค อ ง โ ก
โคลัมโบ	โ ค ล ั ม โ บ
บัวหิมะ	บ ั ว ห ิ ม ะ
สาป	ส า ป
แหล่งจ่ายไฟ	แ ห ล ่ ง จ ่ า ย ไ ฟ
บรรดาศักดิ์	บ ร ร ด า ศ ั ก ด ิ ์
คิมหันต์	ค ิ ม ห ั น ต ์
ผู้ก่อการร้าย	ผ ู ้ ก ่ อ ก า ร ร ้ า ย
ลูกเสือลูกตะเข้	ล ู ก เ ส ื อ ล ู ก ต ะ เ ข ้
สถานภาพ	ส ถ า น ภ า พ
ทนายความ	ท น า ย ค ว า ม
แผ่นดินไหว	แ ผ ่ น ด ิ น ไ ห ว
สุธี	ส ุ ธ ี
ท่าเทียบเรือ	ท ่ า เ ท ี ย บ เ ร ื อ
นักกระโดดร่ม	น ั ก ก ร ะ โ ด ด ร ่ ม
เหวี่ยง	เ ห ว ี ่ ย ง
เสวก	เ ส ว ก
สุสาน	ส ุ ส า น
คริสต์ศาสนิกชน	ค ร ิ ส ต ์ ศ า ส น ิ ก ช น
วัตถุไวไฟ	ว ั ต ถ ุ ไ ว ไ ฟ
การนิมิต	ก า ร น ิ ม ิ ต
ราชาคณะ	ร า ช า ค ณ ะ
เวี่ย	เ ว ี ่ ย
อ่างทอง	อ ่ า ง ท อ ง
อั่ว	อ ั ่ ว
การเฉลย	ก า ร เ ฉ ล ย
เส้นแวง	เ ส ้ น แ ว ง
ช็อคโกแลต	ช ็ อ ค โ ก แ ล ต
เชียร์ลีดเดอร์	เ ช ี ย ร ์ ล ี ด เ ด อ ร ์
ไอร์แลนด์เหนือ	ไ อ ร ์ แ ล น ด ์ เ ห น ื อ
โอฐ	โ อ ฐ
เอ็กซ์เรย์	เ อ ็ ก ซ ์ เ ร ย ์
ยุ่งเหยิง	ย ุ ่ ง เ ห ย ิ ง
พลับพลา	พ ล ั บ พ ล า
เจ้าหญิง	เ จ ้ า ห ญ ิ ง
ข้าศึก	ข ้ า ศ ึ ก
ตะวันตกเฉียงใต้	ต ะ ว ั น ต ก เ ฉ ี ย ง ใ ต ้
เรือด	เ ร ื อ ด
น่านเจ้า	น ่ า น เ จ ้ า
ซิงก์	ซ ิ ง ก ์
ความตกลง	ค ว า ม ต ก ล ง
ขี้คร้าน	ข ี ้ ค ร ้ า น
แรเงา	แ ร เ ง า
เปรอะ	เ ป ร อ ะ
สติกเกอร์	ส ต ิ ก เ ก อ ร ์
กลุ่มดาวหมีเล็ก	ก ล ุ ่ ม ด า ว ห ม ี เ ล ็ ก
ชาตรูป	ช า ต ร ู ป
อรุณี	อ ร ุ ณ ี
กระดานลื่น	ก ร ะ ด า น ล ื ่ น
สุเหร่า	ส ุ เ ห ร ่ า
เจือจาง	เ จ ื อ จ า ง
หอยแครง	ห อ ย แ ค ร ง
พระเจ้าช่วยกล้วยทอด	พ ร ะ เ จ ้ า ช ่ ว ย ก ล ้ ว ย ท อ ด
ผู้เหยียดผิว	ผ ู ้ เ ห ย ี ย ด ผ ิ ว
เทพี	เ ท พ ี
ความแห้ง	ค ว า ม แ ห ้ ง
สดุดี	ส ด ุ ด ี
ออร์ทอดอกซ์	อ อ ร ์ ท อ ด อ ก ซ ์
มริยาท	ม ร ิ ย า ท
มอดไม้	ม อ ด ไ ม ้
ปล่องไฟ	ป ล ่ อ ง ไ ฟ
มัจจุราช	ม ั จ จ ุ ร า ช
จรจัด	จ ร จ ั ด
ล้มละลาย	ล ้ ม ล ะ ล า ย
ผักสลัด	ผ ั ก ส ล ั ด
หินตะกอน	ห ิ น ต ะ ก อ น
เพื่อนร่วมงาน	เ พ ื ่ อ น ร ่ ว ม ง า น
นักจิตวิทยา	น ั ก จ ิ ต ว ิ ท ย า
กระพัง	ก ร ะ พ ั ง
พันธนาคาร	พ ั น ธ น า ค า ร
ซาโมวาร์	ซ า โ ม ว า ร ์
ผู้วินิจฉัย	ผ ู ้ ว ิ น ิ จ ฉ ั ย
แม่สาย	แ ม ่ ส า ย
อ้างว้าง	อ ้ า ง ว ้ า ง
กระจับ	ก ร ะ จ ั บ
นวนิยาย	น ว น ิ ย า ย
ความทุจริต	ค ว า ม ท ุ จ ร ิ ต
ยิปซัม	ย ิ ป ซ ั ม
กระด้ง	ก ร ะ ด ้ ง
คันเบ็ด	ค ั น เ บ ็ ด
เกล็ด	เ ก ล ็ ด
เฟสบุ๊ก	เ ฟ ส บ ุ ๊ ก
อ๊วก	อ ๊ ว ก
สมาส	ส ม า ส
กัลบก	ก ั ล บ ก
พนักงานอัยการ	พ น ั ก ง า น อ ั ย ก า ร
ดอมินีกา	ด อ ม ิ น ี ก า
แพทย์ผดุงครรภ์	แ พ ท ย ์ ผ ด ุ ง ค ร ร ภ ์
สารระเหย	ส า ร ร ะ เ ห ย
ศาสตราจารย์	ศ า ส ต ร า จ า ร ย ์
น้ำประสานทอง	น ้ ำ ป ร ะ ส า น ท อ ง
คอนซีลเลอร์	ค อ น ซ ี ล เ ล อ ร ์
นอร์ทแคโรไลนา	น อ ร ์ ท แ ค โ ร ไ ล น า
ลูกเลี้ยง	ล ู ก เ ล ี ้ ย ง
เรวดี	เ ร ว ด ี
ปริซึม	ป ร ิ ซ ึ ม
เนยโกโก้	เ น ย โ ก โ ก ้
ไป่	ไ ป ่
แบกแดด	แ บ ก แ ด ด
ไถง	ไ ถ ง
บิดเบือน	บ ิ ด เ บ ื อ น
บัณฑิตย	บ ั ณ ฑ ิ ต ย
ล่าแม่มด	ล ่ า แ ม ่ ม ด
เม็ดเลือดแดง	เ ม ็ ด เ ล ื อ ด แ ด ง
เบอร์ลิน	เ บ อ ร ์ ล ิ น
โลงศพ	โ ล ง ศ พ
จุมพิต	จ ุ ม พ ิ ต
ท้าวพญา	ท ้ า ว พ ญ า
ปรับตัว	ป ร ั บ ต ั ว
ลักทรัพย์	ล ั ก ท ร ั พ ย ์
วอร์ซอ	ว อ ร ์ ซ อ
เฮกตาร์	เ ฮ ก ต า ร ์
ชื่นใจ	ช ื ่ น ใ จ
ทรงกระบอก	ท ร ง ก ร ะ บ อ ก
พิบัติภัย	พ ิ บ ั ต ิ ภ ั ย
ป่าชายเลน	ป ่ า ช า ย เ ล น
ลูกเขยตายแม่ยายทำศพ	ล ู ก เ ข ย ต า ย แ ม ่ ย า ย ท ำ ศ พ
ท่านผู้หญิง	ท ่ า น ผ ู ้ ห ญ ิ ง
ผีเสื้อ	ผ ี เ ส ื ้ อ
พื้น	พ ื ้ น
เบี้ยปรับ	เ บ ี ้ ย ป ร ั บ
แผน	แ ผ น
เซียน	เ ซ ี ย น
ผู้ไท	ผ ู ้ ไ ท
ซูโม่	ซ ู โ ม ่
ผาสุข	ผ า ส ุ ข
ครั่ง	ค ร ั ่ ง
กะตือรือร้น	ก ะ ต ื อ ร ื อ ร ้ น
ข้อเสื่อม	ข ้ อ เ ส ื ่ อ ม
การแถ	ก า ร แ ถ
น้ำมันมะกอก	น ้ ำ ม ั น ม ะ ก อ ก
หมีขาว	ห ม ี ข า ว
น้ำกัดเท้า	น ้ ำ ก ั ด เ ท ้ า
อัลมอนด์	อ ั ล ม อ น ด ์
ปรกติ	ป ร ก ต ิ
ควิเบก	ค ว ิ เ บ ก
ลัตเวีย	ล ั ต เ ว ี ย
โขมด	โ ข ม ด
อสูร	อ ส ู ร
อัลกุรอาน	อ ั ล ก ุ ร อ า น
ปืนลม	ป ื น ล ม
นครนายก	น ค ร น า ย ก
ถอนหงอก	ถ อ น ห ง อ ก
วิสา	ว ิ ส า
มล่อน	ม ล ่ อ น
กบเลือกนาย	ก บ เ ล ื อ ก น า ย
อภิชน	อ ภ ิ ช น
ละครสัตว์	ล ะ ค ร ส ั ต ว ์
เศรษฐินี	เ ศ ร ษ ฐ ิ น ี
กิโยตีน	ก ิ โ ย ต ี น
โจ้	โ จ ้
กฎหมายเหตุ	ก ฎ ห ม า ย เ ห ต ุ
กงกาง	ก ง ก า ง
วิมล	ว ิ ม ล
แม่กอง	แ ม ่ ก อ ง
เว็บเพจ	เ ว ็ บ เ พ จ
ล้วงคองูเห่า	ล ้ ว ง ค อ ง ู เ ห ่ า
ปริตยาค	ป ร ิ ต ย า ค
พิซซ่า	พ ิ ซ ซ ่ า
พลังงานจลน์	พ ล ั ง ง า น จ ล น ์
คาราเมล	ค า ร า เ ม ล
ตาลิปัตร	ต า ล ิ ป ั ต ร
ความกตัญญูกตเวที	ค ว า ม ก ต ั ญ ญ ู ก ต เ ว ท ี
หมากฮอส	ห ม า ก ฮ อ ส
ทางเท้า	ท า ง เ ท ้ า
มนุษย์อวกาศ	ม น ุ ษ ย ์ อ ว ก า ศ
เทลลูเรียม	เ ท ล ล ู เ ร ี ย ม
ขบถ	ข บ ถ
ท้าว	ท ้ า ว
นกเขาชวา	น ก เ ข า ช ว า
หมาหรึ่ง	ห ม า ห ร ึ ่ ง
เบาะแส	เ บ า ะ แ ส
สุกร	ส ุ ก ร
รัฐประศาสน์	ร ั ฐ ป ร ะ ศ า ส น ์
เสื้อแสง	เ ส ื ้ อ แ ส ง
นิรมิต	น ิ ร ม ิ ต
ยูโด	ย ู โ ด
เชลโล	เ ช ล โ ล
ถุงมือ	ถ ุ ง ม ื อ
โรคา	โ ร ค า
ชด	ช ด
ปลอก	ป ล อ ก
กบเหลาดินสอ	ก บ เ ห ล า ด ิ น ส อ
ผู้รักชาติ	ผ ู ้ ร ั ก ช า ต ิ
กิ้งกือ	ก ิ ้ ง ก ื อ
อุปัชฌาย	อ ุ ป ั ช ฌ า ย
เลือดเนื้อ	เ ล ื อ ด เ น ื ้ อ
ปอดบวม	ป อ ด บ ว ม
ประติบัติ	ป ร ะ ต ิ บ ั ต ิ
ความเข้มข้น	ค ว า ม เ ข ้ ม ข ้ น
อุปนิสัย	อ ุ ป น ิ ส ั ย
หนังสือเสียง	ห น ั ง ส ื อ เ ส ี ย ง
เซาท์ซูดาน	เ ซ า ท ์ ซ ู ด า น
เอกภาพ	เ อ ก ภ า พ
การฟอกเงิน	ก า ร ฟ อ ก เ ง ิ น
แชมเปญ	แ ช ม เ ป ญ
ศาลากลาง	ศ า ล า ก ล า ง
พีชคณิต	พ ี ช ค ณ ิ ต
ความคลาด	ค ว า ม ค ล า ด
ริบบิ้น	ร ิ บ บ ิ ้ น
เจ้านาย	เ จ ้ า น า ย
นักสกี	น ั ก ส ก ี
กฤษฎีกา	ก ฤ ษ ฎ ี ก า
หูหนวก	ห ู ห น ว ก
ไนโตรเจน	ไ น โ ต ร เ จ น
ซันเด	ซ ั น เ ด
แม่ม่าย	แ ม ่ ม ่ า ย
การสร้างสรรค์	ก า ร ส ร ้ า ง ส ร ร ค ์
การลงขัน	ก า ร ล ง ข ั น
อาเจียน	อ า เ จ ี ย น
พื้นที่ผิว	พ ื ้ น ท ี ่ ผ ิ ว
หมิ่น	ห ม ิ ่ น
ชัลลุกา	ช ั ล ล ุ ก า
สถาปนา	ส ถ า ป น า
ฝักบัวล้างก้น	ฝ ั ก บ ั ว ล ้ า ง ก ้ น
หมาใน	ห ม า ใ น
พืชดอก	พ ื ช ด อ ก
เฟื่อง	เ ฟ ื ่ อ ง
ป้ายโฆษณา	ป ้ า ย โ ฆ ษ ณ า
ทองเหลือง	ท อ ง เ ห ล ื อ ง
ทแกล้วทหาญ	ท แ ก ล ้ ว ท ห า ญ
หินดินดาน	ห ิ น ด ิ น ด า น
ซาฮารา	ซ า ฮ า ร า
ราชบัณฑิต	ร า ช บ ั ณ ฑ ิ ต
แคระ	แ ค ร ะ
ทิชากร	ท ิ ช า ก ร
ลาวลุ่ม	ล า ว ล ุ ่ ม
อู้	อ ู ้
รูปหล่อ	ร ู ป ห ล ่ อ
เหงือก	เ ห ง ื อ ก
ระเบิดปรมาณู	ร ะ เ บ ิ ด ป ร ม า ณ ู
กาบูเวร์ดี	ก า บ ู เ ว ร ์ ด ี
ทีปังกร	ท ี ป ั ง ก ร
ผักชีโรยหน้า	ผ ั ก ช ี โ ร ย ห น ้ า
หลาว	ห ล า ว
การเช่า	ก า ร เ ช ่ า
ราชญี	ร า ช ญ ี
เหตุแห่งสงคราม	เ ห ต ุ แ ห ่ ง ส ง ค ร า ม
นักแต่งเพลง	น ั ก แ ต ่ ง เ พ ล ง
ฮอลลีวูด	ฮ อ ล ล ี ว ู ด
สาง	ส า ง
ราตรีสวัสดิ์	ร า ต ร ี ส ว ั ส ด ิ ์
ผู้ประสบภัย	ผ ู ้ ป ร ะ ส บ ภ ั ย
ฟูก	ฟ ู ก
อนุสัญญา	อ น ุ ส ั ญ ญ า
โมนาโก	โ ม น า โ ก
บายศรี	บ า ย ศ ร ี
โกรต๋น	โ ก ร ต ๋ น
ร่างกุ้ง	ร ่ า ง ก ุ ้ ง
อิฐ	อ ิ ฐ
อนาถา	อ น า ถ า
หนาแน่น	ห น า แ น ่ น
กระยาง	ก ร ะ ย า ง
ความเกรียน	ค ว า ม เ ก ร ี ย น
พัฟฟิน	พ ั ฟ ฟ ิ น
ไส้ติ่ง	ไ ส ้ ต ิ ่ ง
ฃอง	ฃ อ ง
ส่อง	ส ่ อ ง
ไข่ต้ม	ไ ข ่ ต ้ ม
ตัดหางปล่อยวัด	ต ั ด ห า ง ป ล ่ อ ย ว ั ด
โอโม่	โ อ โ ม ่
สามเหลี่ยมหน้าจั่ว	ส า ม เ ห ล ี ่ ย ม ห น ้ า จ ั ่ ว
หักโหม	ห ั ก โ ห ม
อสุรกาย	อ ส ุ ร ก า ย
กฎเกณฑ์	ก ฎ เ ก ณ ฑ ์
บรรณาการ	บ ร ร ณ า ก า ร
ความแอ๊บแบ๊ว	ค ว า ม แ อ ๊ บ แ บ ๊ ว
ไจ	ไ จ
อินเดียม	อ ิ น เ ด ี ย ม
เรือไฟ	เ ร ื อ ไ ฟ
เบญจมาศ	เ บ ญ จ ม า ศ
เริม	เ ร ิ ม
วิฬาร์	ว ิ ฬ า ร ์
กุ้งยิง	ก ุ ้ ง ย ิ ง
เฌอ	เ ฌ อ
เขน	เ ข น
จนท.	จ น ท .
มหาเศรษฐี	ม ห า เ ศ ร ษ ฐ ี
เรื่อย	เ ร ื ่ อ ย
ไม้ขีดไฟ	ไ ม ้ ข ี ด ไ ฟ
ภาษาแม่	ภ า ษ า แ ม ่
ความล่มจม	ค ว า ม ล ่ ม จ ม
การลงแขก	ก า ร ล ง แ ข ก
อุปมานิทัศน์	อ ุ ป ม า น ิ ท ั ศ น ์
สุมน	ส ุ ม น
ไททาเนียม	ไ ท ท า เ น ี ย ม
ขมิ้น	ข ม ิ ้ น
บาทา	บ า ท า
แง้ม	แ ง ้ ม
ภูต	ภ ู ต
ความบ้านนอก	ค ว า ม บ ้ า น น อ ก
ใบหู	ใ บ ห ู
หลักแหลม	ห ล ั ก แ ห ล ม
พรมแดน	พ ร ม แ ด น
ลิขิต	ล ิ ข ิ ต
จะเข้	จ ะ เ ข ้
จักรวรรดิไบแซนไทน์	จ ั ก ร ว ร ร ด ิ ไ บ แ ซ น ไ ท น ์
นิกาย	น ิ ก า ย
อาร์เจนตินา	อ า ร ์ เ จ น ต ิ น า
เครื่องหมายตกใจ	เ ค ร ื ่ อ ง ห ม า ย ต ก ใ จ
เนิ่น	เ น ิ ่ น
วนอุทยาน	ว น อ ุ ท ย า น
น้องชาย	น ้ อ ง ช า ย
ล้างสมอง	ล ้ า ง ส ม อ ง
นพศก	น พ ศ ก
พวง	พ ว ง
หินแลง	ห ิ น แ ล ง
แพทย์หญิง	แ พ ท ย ์ ห ญ ิ ง
ม้ง	ม ้ ง
นักล่า	น ั ก ล ่ า
ไข่ดาวน้ำ	ไ ข ่ ด า ว น ้ ำ
ขืน	ข ื น
คัดลอก	ค ั ด ล อ ก
ปรากฤต	ป ร า ก ฤ ต
น้ำมันหอย	น ้ ำ ม ั น ห อ ย
ดูหมิ่นซึ่งหน้า	ด ู ห ม ิ ่ น ซ ึ ่ ง ห น ้ า
อนิจจัง	อ น ิ จ จ ั ง
ฒากา	ฒ า ก า
เดินเล่น	เ ด ิ น เ ล ่ น
ฉุกเฉิน	ฉ ุ ก เ ฉ ิ น
กลับหลังหัน	ก ล ั บ ห ล ั ง ห ั น
ถ่านหิน	ถ ่ า น ห ิ น
ซินเดอเรลล่า	ซ ิ น เ ด อ เ ร ล ล ่ า
อ้น	อ ้ น
ไฉน	ไ ฉ น
ตลับ	ต ล ั บ
ปล่อยของ	ป ล ่ อ ย ข อ ง
ดินเผา	ด ิ น เ ผ า
หงสบาท	ห ง ส บ า ท
กระจกเงา	ก ร ะ จ ก เ ง า
ลูกบาศก์	ล ู ก บ า ศ ก ์
ปากกาลูกลื่น	ป า ก ก า ล ู ก ล ื ่ น
พุทธเซเล็บ	พ ุ ท ธ เ ซ เ ล ็ บ
น้ำจัณฑ์	น ้ ำ จ ั ณ ฑ ์
หลอดไฟไอปรอท	ห ล อ ด ไ ฟ ไ อ ป ร อ ท
อานุภาพ	อ า น ุ ภ า พ
โค๊ก	โ ค ๊ ก
การเต้นรำ	ก า ร เ ต ้ น ร ำ
เทศนา	เ ท ศ น า
ไม้นวดแป้ง	ไ ม ้ น ว ด แ ป ้ ง
เดลตา	เ ด ล ต า
การสีซอให้ควายฟัง	ก า ร ส ี ซ อ ใ ห ้ ค ว า ย ฟ ั ง
เงิบ	เ ง ิ บ
แองกวิลลา	แ อ ง ก ว ิ ล ล า
เป็นรอง	เ ป ็ น ร อ ง
เลียบ	เ ล ี ย บ
เกริ่น	เ ก ร ิ ่ น
ตอแหลแลนด์	ต อ แ ห ล แ ล น ด ์
คืนดี	ค ื น ด ี
หลอดเลือดฝอย	ห ล อ ด เ ล ื อ ด ฝ อ ย
ฟืม	ฟ ื ม
สูท	ส ู ท
ผู้บรรยาย	ผ ู ้ บ ร ร ย า ย
โป๊ยกั้ก	โ ป ๊ ย ก ั ้ ก
ทองไม่รู้ร้อน	ท อ ง ไ ม ่ ร ู ้ ร ้ อ น
นารท	น า ร ท
เรื่องใหญ่	เ ร ื ่ อ ง ใ ห ญ ่
เนคไท	เ น ค ไ ท
การควบแน่น	ก า ร ค ว บ แ น ่ น
ปฏิญาณ	ป ฏ ิ ญ า ณ
หัวใจหยุดเต้น	ห ั ว ใ จ ห ย ุ ด เ ต ้ น
อรุโณทัย	อ ร ุ โ ณ ท ั ย
กาแล็กซี	ก า แ ล ็ ก ซ ี
ระเบียบวินัย	ร ะ เ บ ี ย บ ว ิ น ั ย
ยักยอก	ย ั ก ย อ ก
การงัด	ก า ร ง ั ด
ซีซาร์	ซ ี ซ า ร ์
โครโมโซม	โ ค ร โ ม โ ซ ม
การดำเนินคดีแบบกลุ่ม	ก า ร ด ำ เ น ิ น ค ด ี แ บ บ ก ล ุ ่ ม
กระเพรา	ก ร ะ เ พ ร า
ฝ่ายซ้าย	ฝ ่ า ย ซ ้ า ย
มาตุภูมิ	ม า ต ุ ภ ู ม ิ
กรรมกร	ก ร ร ม ก ร
เผ็ด	เ ผ ็ ด
เครื่องดูดฝุ่น	เ ค ร ื ่ อ ง ด ู ด ฝ ุ ่ น
โน้น	โ น ้ น
ร้อนรน	ร ้ อ น ร น
มิว	ม ิ ว
ความลับ	ค ว า ม ล ั บ
ตะไบ	ต ะ ไ บ
ช้อนชา	ช ้ อ น ช า
ความอิจฉา	ค ว า ม อ ิ จ ฉ า
ไคล	ไ ค ล
เทคบอล	เ ท ค บ อ ล
คชสาร	ค ช ส า ร
อัตราเร็ว	อ ั ต ร า เ ร ็ ว
รอยโรค	ร อ ย โ ร ค
เปรอ	เ ป ร อ
กรีซโบราณ	ก ร ี ซ โ บ ร า ณ
ใบไม้ร่วง	ใ บ ไ ม ้ ร ่ ว ง
ฟาโรห์	ฟ า โ ร ห ์
กะหล่ำดาว	ก ะ ห ล ่ ำ ด า ว
การฮั้วประมูล	ก า ร ฮ ั ้ ว ป ร ะ ม ู ล
การต่อยอด	ก า ร ต ่ อ ย อ ด
ใส่ไข่	ใ ส ่ ไ ข ่
เด็กแว้น	เ ด ็ ก แ ว ้ น
กระเด็น	ก ร ะ เ ด ็ น
สุขาภิบาล	ส ุ ข า ภ ิ บ า ล
ปล้นทรัพย์	ป ล ้ น ท ร ั พ ย ์
ไม่เผาผี	ไ ม ่ เ ผ า ผ ี
บาดาล	บ า ด า ล
แม่ไก่	แ ม ่ ไ ก ่
ต่อมตง	ต ่ อ ม ต ง
เมลานีเซีย	เ ม ล า น ี เ ซ ี ย
สี่สิบแปด	ส ี ่ ส ิ บ แ ป ด
บิงซู	บ ิ ง ซ ู
สโลแกน	ส โ ล แ ก น
แฟรงก์เฟิร์ต	แ ฟ ร ง ก ์ เ ฟ ิ ร ์ ต
การเผชิญ	ก า ร เ ผ ช ิ ญ
เลือกปฏิบัติ	เ ล ื อ ก ป ฏ ิ บ ั ต ิ
แมส	แ ม ส
ฉับพลัน	ฉ ั บ พ ล ั น
สีมา	ส ี ม า
หมก	ห ม ก
ชม	ช ม
การแถลงการณ์	ก า ร แ ถ ล ง ก า ร ณ ์
ฃ๋า	ฃ ๋ า
คั่น	ค ั ่ น
ฤกษณะ	ฤ ก ษ ณ ะ
หมายเกาะ	ห ม า ย เ ก า ะ
ฟางเส้นสุดท้าย	ฟ า ง เ ส ้ น ส ุ ด ท ้ า ย
บำนาญ	บ ำ น า ญ
สักขี	ส ั ก ข ี
กลับตาลปัตร	ก ล ั บ ต า ล ป ั ต ร
กาแฟขี้ชะมด	ก า แ ฟ ข ี ้ ช ะ ม ด
มนุษยชน	ม น ุ ษ ย ช น
ทัพไชย	ท ั พ ไ ช ย
หนูตะเภา	ห น ู ต ะ เ ภ า
เซนต์ลูเชีย	เ ซ น ต ์ ล ู เ ช ี ย
ตริโปลี	ต ร ิ โ ป ล ี
เซอร์เบีย	เ ซ อ ร ์ เ บ ี ย
ศัลยกรรมเสริมสวย	ศ ั ล ย ก ร ร ม เ ส ร ิ ม ส ว ย
ลามะ	ล า ม ะ
กฎอัยการศึก	ก ฎ อ ั ย ก า ร ศ ึ ก
จารีต	จ า ร ี ต
ฮอลันดา	ฮ อ ล ั น ด า
ขมขื่น	ข ม ข ื ่ น
ผู้ฝึกสอน	ผ ู ้ ฝ ึ ก ส อ น
กาพย์	ก า พ ย ์
กระหนก	ก ร ะ ห น ก
ลวดเย็บกระดาษ	ล ว ด เ ย ็ บ ก ร ะ ด า ษ
ความเห็นชอบ	ค ว า ม เ ห ็ น ช อ บ
ไอโอ	ไ อ โ อ
การกลายพันธุ์	ก า ร ก ล า ย พ ั น ธ ุ ์
ศักย์	ศ ั ก ย ์
สาวไส้	ส า ว ไ ส ้
เตลิด	เ ต ล ิ ด
ปักษา	ป ั ก ษ า
ละมุด	ล ะ ม ุ ด
ความอัปมงคล	ค ว า ม อ ั ป ม ง ค ล
วัวสันหลังหวะ	ว ั ว ส ั น ห ล ั ง ห ว ะ
การประท้วง	ก า ร ป ร ะ ท ้ ว ง
ไล่ผี	ไ ล ่ ผ ี
นิวเคลียส	น ิ ว เ ค ล ี ย ส
ซออู้	ซ อ อ ู ้
ไร่นา	ไ ร ่ น า
ฃวา	ฃ ว า
แสงใต้	แ ส ง ใ ต ้
องค์อธิปัตย์	อ ง ค ์ อ ธ ิ ป ั ต ย ์
หนูน้อยหมวกแดง	ห น ู น ้ อ ย ห ม ว ก แ ด ง
วิเศษณานุประโยค	ว ิ เ ศ ษ ณ า น ุ ป ร ะ โ ย ค
อัสตานา	อ ั ส ต า น า
การหมิ่นประมาท	ก า ร ห ม ิ ่ น ป ร ะ ม า ท
บานพับ	บ า น พ ั บ
ปีแสง	ป ี แ ส ง
หูหนวกตาบอด	ห ู ห น ว ก ต า บ อ ด
วาบหวาม	ว า บ ห ว า ม
ช่วงชิง	ช ่ ว ง ช ิ ง
เบ้อเร่อ	เ บ ้ อ เ ร ่ อ
ต้าว	ต ้ า ว
สะพานไฟ	ส ะ พ า น ไ ฟ
ชลธี	ช ล ธ ี
นิติบัญญัติ	น ิ ต ิ บ ั ญ ญ ั ต ิ
การสวมเขา	ก า ร ส ว ม เ ข า
เกลือจืด	เ ก ล ื อ จ ื ด
คนใหญ่คนโต	ค น ใ ห ญ ่ ค น โ ต
เนื้อแดดเดียว	เ น ื ้ อ แ ด ด เ ด ี ย ว
ของกำนัล	ข อ ง ก ำ น ั ล
รัตน์	ร ั ต น ์
ฐานทัพ	ฐ า น ท ั พ
จุกนม	จ ุ ก น ม
อับเรณู	อ ั บ เ ร ณ ู
คันดิน	ค ั น ด ิ น
ผ้าฝ้าย	ผ ้ า ฝ ้ า ย
ตัวกลม	ต ั ว ก ล ม
เอกมัย	เ อ ก ม ั ย
การทหาร	ก า ร ท ห า ร
ไสย	ไ ส ย
ย่างกุ้ง	ย ่ า ง ก ุ ้ ง
ทุ่งหญ้า	ท ุ ่ ง ห ญ ้ า
นขลิขิต	น ข ล ิ ข ิ ต
เพียบพร้อม	เ พ ี ย บ พ ร ้ อ ม
สะพัง	ส ะ พ ั ง
พูลสวัสดิ์	พ ู ล ส ว ั ส ด ิ ์
โบท็อกซ์	โ บ ท ็ อ ก ซ ์
เป็ด	เ ป ็ ด
โศภิต	โ ศ ภ ิ ต
รองศาสตราจารย์	ร อ ง ศ า ส ต ร า จ า ร ย ์
เตาอบ	เ ต า อ บ
ถลอก	ถ ล อ ก
เซี่ยงไฮ้	เ ซ ี ่ ย ง ไ ฮ ้
จิปาถะ	จ ิ ป า ถ ะ
เข็มนาฬิกา	เ ข ็ ม น า ฬ ิ ก า
การผาย	ก า ร ผ า ย
เผ่น	เ ผ ่ น
นกต่อ	น ก ต ่ อ
หินอ่อน	ห ิ น อ ่ อ น
นักจี้	น ั ก จ ี ้
หนองบัวลำภู	ห น อ ง บ ั ว ล ำ ภ ู
โลภ	โ ล ภ
ฤทัย	ฤ ท ั ย
เกษตรกร	เ ก ษ ต ร ก ร
ไทเทเนียม	ไ ท เ ท เ น ี ย ม
บุญญาธิการ	บ ุ ญ ญ า ธ ิ ก า ร
บีเวอร์	บ ี เ ว อ ร ์
พายุหมุน	พ า ย ุ ห ม ุ น
คิดสั้น	ค ิ ด ส ั ้ น
หลานสาว	ห ล า น ส า ว
สิบเอ็ด	ส ิ บ เ อ ็ ด
น้ำมะนาว	น ้ ำ ม ะ น า ว
แอตแลนติก	แ อ ต แ ล น ต ิ ก
สูญหาย	ส ู ญ ห า ย
เข็มขัดนิรภัย	เ ข ็ ม ข ั ด น ิ ร ภ ั ย
ราชวงศ์	ร า ช ว ง ศ ์
หน้าบาง	ห น ้ า บ า ง
อภิสิทธิ์	อ ภ ิ ส ิ ท ธ ิ ์
ช็อกโกแลตชิป	ช ็ อ ก โ ก แ ล ต ช ิ ป
สาลี่	ส า ล ี ่
ความถ่วง	ค ว า ม ถ ่ ว ง
เครื่องชงกาแฟ	เ ค ร ื ่ อ ง ช ง ก า แ ฟ
แม่หม้าย	แ ม ่ ห ม ้ า ย
ชานมไข่มุก	ช า น ม ไ ข ่ ม ุ ก
บรูไน	บ ร ู ไ น
ความหลัง	ค ว า ม ห ล ั ง
จานฝนหมึก	จ า น ฝ น ห ม ึ ก
มัสมั่น	ม ั ส ม ั ่ น
ธราดล	ธ ร า ด ล
เจ้าโลก	เ จ ้ า โ ล ก
โจรสลัด	โ จ ร ส ล ั ด
ปุ่มกด	ป ุ ่ ม ก ด
ภัตตาคาร	ภ ั ต ต า ค า ร
ข่อย	ข ่ อ ย
สิบเอก	ส ิ บ เ อ ก
ทับศัพท์	ท ั บ ศ ั พ ท ์
มือสมัครเล่น	ม ื อ ส ม ั ค ร เ ล ่ น
ซูชิ	ซ ู ช ิ
ที่ว่าง	ท ี ่ ว ่ า ง
นอร์เทิร์นไอร์แลนด์	น อ ร ์ เ ท ิ ร ์ น ไ อ ร ์ แ ล น ด ์
ทอฟฟี	ท อ ฟ ฟ ี
ขร้า	ข ร ้ า
หลวม	ห ล ว ม
อาตมา	อ า ต ม า
โคกูรยอ	โ ค ก ู ร ย อ
ภูมิศาสตร์	ภ ู ม ิ ศ า ส ต ร ์
ตุลาการ	ต ุ ล า ก า ร
แผ่นพับ	แ ผ ่ น พ ั บ
ขาตั้งกล้อง	ข า ต ั ้ ง ก ล ้ อ ง
วิสาข	ว ิ ส า ข
ซีก	ซ ี ก
หมีควาย	ห ม ี ค ว า ย
ธวัช	ธ ว ั ช
บุษย์น้ำทอง	บ ุ ษ ย ์ น ้ ำ ท อ ง
เสือลายเมฆ	เ ส ื อ ล า ย เ ม ฆ
รวิวาร	ร ว ิ ว า ร
นาวิก	น า ว ิ ก
งานศพ	ง า น ศ พ
สีสวาด	ส ี ส ว า ด
หมัน	ห ม ั น
พวน	พ ว น
คลาน	ค ล า น
เต้ารับ	เ ต ้ า ร ั บ
ครุ่นคิด	ค ร ุ ่ น ค ิ ด
สารส้ม	ส า ร ส ้ ม
บิณฑบาตร	บ ิ ณ ฑ บ า ต ร
น้ำมันพริก	น ้ ำ ม ั น พ ร ิ ก
แมรี	แ ม ร ี
หมาต๋า	ห ม า ต ๋ า
มองบน	ม อ ง บ น
อิสรภาพ	อ ิ ส ร ภ า พ
ตุลย์	ต ุ ล ย ์
บุฟเฟต์	บ ุ ฟ เ ฟ ต ์
ตุง	ต ุ ง
หาเหาใส่หัว	ห า เ ห า ใ ส ่ ห ั ว
กัณฑ์	ก ั ณ ฑ ์
สัตว์สะเทินน้ำสะเทินบก	ส ั ต ว ์ ส ะ เ ท ิ น น ้ ำ ส ะ เ ท ิ น บ ก
ภาษาพูด	ภ า ษ า พ ู ด
แฟกซ์	แ ฟ ก ซ ์
ไซบูทรามีน	ไ ซ บ ู ท ร า ม ี น
เจาะยาง	เ จ า ะ ย า ง
มะเร็งเม็ดเลือดขาว	ม ะ เ ร ็ ง เ ม ็ ด เ ล ื อ ด ข า ว
ความยุติธรรม	ค ว า ม ย ุ ต ิ ธ ร ร ม
ความพิการ	ค ว า ม พ ิ ก า ร
นิพพาน	น ิ พ พ า น
ตั้งตัว	ต ั ้ ง ต ั ว
โบกรถ	โ บ ก ร ถ
ปอเปี๊ยะ	ป อ เ ป ี ๊ ย ะ
ตื้บ	ต ื ้ บ
เพรียง	เ พ ร ี ย ง
รีดเอาทรัพย์	ร ี ด เ อ า ท ร ั พ ย ์
ยี่โถ	ย ี ่ โ ถ
ริพับลิกัน	ร ิ พ ั บ ล ิ ก ั น
ทศกัณฐ์	ท ศ ก ั ณ ฐ ์
การจมปลัก	ก า ร จ ม ป ล ั ก
ชนวน	ช น ว น
ร้านเหล้า	ร ้ า น เ ห ล ้ า
ผัว	ผ ั ว
พราน	พ ร า น
หมอยา	ห ม อ ย า
เครื่องร่อน	เ ค ร ื ่ อ ง ร ่ อ น
สารภูมิต้านทาน	ส า ร ภ ู ม ิ ต ้ า น ท า น
เครื่องเร่งอนุภาค	เ ค ร ื ่ อ ง เ ร ่ ง อ น ุ ภ า ค
เกล็ดเลือดน้อย	เ ก ล ็ ด เ ล ื อ ด น ้ อ ย
กะลา	ก ะ ล า
ปีกลาย	ป ี ก ล า ย
ฝุ่นละออง	ฝ ุ ่ น ล ะ อ อ ง
กุด	ก ุ ด
ร้าบาน	ร ้ า บ า น
สารตรา	ส า ร ต ร า
กลวิธี	ก ล ว ิ ธ ี
ตังค์	ต ั ง ค ์
ลิฟต์	ล ิ ฟ ต ์
ความเหลื่อม	ค ว า ม เ ห ล ื ่ อ ม
เกียรติภูมิ	เ ก ี ย ร ต ิ ภ ู ม ิ
มรรยาท	ม ร ร ย า ท
อากาศยานไอพ่น	อ า ก า ศ ย า น ไ อ พ ่ น
ดึกดำบรรพ์	ด ึ ก ด ำ บ ร ร พ ์
มุกิ้ว	ม ุ ก ิ ้ ว
อ้อย	อ ้ อ ย
ระบำ	ร ะ บ ำ
สามสิบสอง	ส า ม ส ิ บ ส อ ง
กล่องดินสอ	ก ล ่ อ ง ด ิ น ส อ
กษาปณ์	ก ษ า ป ณ ์
วิชญะ	ว ิ ช ญ ะ
เสี้ยว	เ ส ี ้ ย ว
ซากดึกดำบรรพ์	ซ า ก ด ึ ก ด ำ บ ร ร พ ์
การนัดหมาย	ก า ร น ั ด ห ม า ย
ข้างบน	ข ้ า ง บ น
ตู้เพลง	ต ู ้ เ พ ล ง
โทรศัพท์สาธารณะ	โ ท ร ศ ั พ ท ์ ส า ธ า ร ณ ะ
กะเอว	ก ะ เ อ ว
ฟินแลนด์	ฟ ิ น แ ล น ด ์
ลักพาตัว	ล ั ก พ า ต ั ว
ตับแข็ง	ต ั บ แ ข ็ ง
แขนขา	แ ข น ข า
ไม่บ่อย	ไ ม ่ บ ่ อ ย
ละอองเรณู	ล ะ อ อ ง เ ร ณ ู
กระดิ่ง	ก ร ะ ด ิ ่ ง
หมึกยักษ์	ห ม ึ ก ย ั ก ษ ์
ราเม็ง	ร า เ ม ็ ง
ลีลาศ	ล ี ล า ศ
ดำเนิน	ด ำ เ น ิ น
ทศมี	ท ศ ม ี
เนยถั่วลิสง	เ น ย ถ ั ่ ว ล ิ ส ง
จรรยาบรรณ	จ ร ร ย า บ ร ร ณ
เดอะแบก	เ ด อ ะ แ บ ก
ออเดอร์	อ อ เ ด อ ร ์
คนผิวดำ	ค น ผ ิ ว ด ำ
เหลือม	เ ห ล ื อ ม
อิด	อ ิ ด
วัชพืช	ว ั ช พ ื ช
ครึ่งวงกลม	ค ร ึ ่ ง ว ง ก ล ม
พญาณ	พ ญ า ณ
ฉลองพระเนตร	ฉ ล อ ง พ ร ะ เ น ต ร
นักปราชญ์	น ั ก ป ร า ช ญ ์
เอสเปรันโต	เ อ ส เ ป ร ั น โ ต
มอนแทนา	ม อ น แ ท น า
สำเร็จความใคร่	ส ำ เ ร ็ จ ค ว า ม ใ ค ร ่
ไฟฟ้าสถิต	ไ ฟ ฟ ้ า ส ถ ิ ต
รูปเคารพ	ร ู ป เ ค า ร พ
การหวีด	ก า ร ห ว ี ด
พระราชสมภารเจ้า	พ ร ะ ร า ช ส ม ภ า ร เ จ ้ า
โทรอนโต	โ ท ร อ น โ ต
ดิสนีย์	ด ิ ส น ี ย ์
ประแจ	ป ร ะ แ จ
ฝีดาษลิง	ฝ ี ด า ษ ล ิ ง
สกู๊ตเตอร์	ส ก ู ๊ ต เ ต อ ร ์
พฤษภาคม	พ ฤ ษ ภ า ค ม
เกษียรสมุทร	เ ก ษ ี ย ร ส ม ุ ท ร
ตกลูก	ต ก ล ู ก
กระเหรี่ยง	ก ร ะ เ ห ร ี ่ ย ง
ล่องหน	ล ่ อ ง ห น
กระจอกเทศ	ก ร ะ จ อ ก เ ท ศ
สมหวัง	ส ม ห ว ั ง
กรรมาชีพ	ก ร ร ม า ช ี พ
โมโหหิว	โ ม โ ห ห ิ ว
ความพอใจ	ค ว า ม พ อ ใ จ
มลายู	ม ล า ย ู
หฤทัย	ห ฤ ท ั ย
ความขี้ขลาด	ค ว า ม ข ี ้ ข ล า ด
ปอน	ป อ น
มหาสมุทรแอตแลนติก	ม ห า ส ม ุ ท ร แ อ ต แ ล น ต ิ ก
ลิงลม	ล ิ ง ล ม
ยาเบื่อ	ย า เ บ ื ่ อ
รวงผึ้ง	ร ว ง ผ ึ ้ ง
บูคาเรสต์	บ ู ค า เ ร ส ต ์
คอร์รัปชั่น	ค อ ร ์ ร ั ป ช ั ่ น
ต่อมทอนซิล	ต ่ อ ม ท อ น ซ ิ ล
ตะกอน	ต ะ ก อ น
ตาวัน	ต า ว ั น
นักบัลเลต์	น ั ก บ ั ล เ ล ต ์
พิไนยกัน	พ ิ ไ น ย ก ั น
โบฮีเมีย	โ บ ฮ ี เ ม ี ย
หมดบุญ	ห ม ด บ ุ ญ
มอมเมา	ม อ ม เ ม า
การพลิก	ก า ร พ ล ิ ก
สระผม	ส ร ะ ผ ม
สายตาสั้น	ส า ย ต า ส ั ้ น
ตะไคร่	ต ะ ไ ค ร ่
เนยถั่ว	เ น ย ถ ั ่ ว
ความสบาย	ค ว า ม ส บ า ย
ขากรรไกร	ข า ก ร ร ไ ก ร
ขวาก	ข ว า ก
นรีเวชศาสตร์	น ร ี เ ว ช ศ า ส ต ร ์
ความยาวเส้นรอบวง	ค ว า ม ย า ว เ ส ้ น ร อ บ ว ง
หมอลำ	ห ม อ ล ำ
สาวดุ้น	ส า ว ด ุ ้ น
ผีเจาะปาก	ผ ี เ จ า ะ ป า ก
โอ๊ก	โ อ ๊ ก
บังคับบัญชา	บ ั ง ค ั บ บ ั ญ ช า
เนิ่นนาน	เ น ิ ่ น น า น
มหิบดี	ม ห ิ บ ด ี
ชาวสีรุ้ง	ช า ว ส ี ร ุ ้ ง
โรงเตี๊ยม	โ ร ง เ ต ี ๊ ย ม
ร่มชูชีพ	ร ่ ม ช ู ช ี พ
ทับทรวง	ท ั บ ท ร ว ง
เด็กชาย	เ ด ็ ก ช า ย
การเตรียมตัว	ก า ร เ ต ร ี ย ม ต ั ว
การบริการ	ก า ร บ ร ิ ก า ร
กล่องดนตรี	ก ล ่ อ ง ด น ต ร ี
ผู้เฒ่า	ผ ู ้ เ ฒ ่ า
เคืองใจ	เ ค ื อ ง ใ จ
เข็มทิศ	เ ข ็ ม ท ิ ศ
ใจกว้าง	ใ จ ก ว ้ า ง
ตาแมว	ต า แ ม ว
แม่เล้า	แ ม ่ เ ล ้ า
เกรงใจ	เ ก ร ง ใ จ
การอนุมัติ	ก า ร อ น ุ ม ั ต ิ
การคูณ	ก า ร ค ู ณ
ของแข็ง	ข อ ง แ ข ็ ง
สัมปทานการก	ส ั ม ป ท า น ก า ร ก
กระถางดอกไม้	ก ร ะ ถ า ง ด อ ก ไ ม ้
ปลาหมอตายเพราะปาก	ป ล า ห ม อ ต า ย เ พ ร า ะ ป า ก
วีรกรรม	ว ี ร ก ร ร ม
นักปล้น	น ั ก ป ล ้ น
เวียนนา	เ ว ี ย น น า
โพรแทกทิเนียม	โ พ ร แ ท ก ท ิ เ น ี ย ม
กะบังลม	ก ะ บ ั ง ล ม
แคนวาส	แ ค น ว า ส
ความกลัวดอกพิกุลจะร่วง	ค ว า ม ก ล ั ว ด อ ก พ ิ ก ุ ล จ ะ ร ่ ว ง
ปิดสวิตช์	ป ิ ด ส ว ิ ต ช ์
พริทอเรีย	พ ร ิ ท อ เ ร ี ย
ฟ้อน	ฟ ้ อ น
แหบ	แ ห บ
บุคลิกภาพ	บ ุ ค ล ิ ก ภ า พ
ซีนอน	ซ ี น อ น
หน้าวัว	ห น ้ า ว ั ว
ฟุ่มเฟือย	ฟ ุ ่ ม เ ฟ ื อ ย
รอมร่อ	ร อ ม ร ่ อ
สารกึ่งตัวนำ	ส า ร ก ึ ่ ง ต ั ว น ำ
อียิปต์	อ ี ย ิ ป ต ์
ลแวก	ล แ ว ก
ตุ๋ย	ต ุ ๋ ย
ฝุ่นเมือง	ฝ ุ ่ น เ ม ื อ ง
ตับแตก	ต ั บ แ ต ก
เครือรัฐ	เ ค ร ื อ ร ั ฐ
ส้อมเสียง	ส ้ อ ม เ ส ี ย ง
นิทรา	น ิ ท ร า
มดลูก	ม ด ล ู ก
เอกเทศสัญญา	เ อ ก เ ท ศ ส ั ญ ญ า
ตระพัง	ต ร ะ พ ั ง
คชาชาติ	ค ช า ช า ต ิ
วงรี	ว ง ร ี
โบ๋	โ บ ๋
ผีขนุน	ผ ี ข น ุ น
ข้อผูกมัด	ข ้ อ ผ ู ก ม ั ด
ชนม์พรรษา	ช น ม ์ พ ร ร ษ า
ไข่ฟู	ไ ข ่ ฟ ู
ถึก	ถ ึ ก
เหลื่อมล้ำ	เ ห ล ื ่ อ ม ล ้ ำ
รุงรัง	ร ุ ง ร ั ง
นมผง	น ม ผ ง
กระบอกฉีดยา	ก ร ะ บ อ ก ฉ ี ด ย า
ธำมรงค์	ธ ำ ม ร ง ค ์
ไสยศาสตร์	ไ ส ย ศ า ส ต ร ์
พิมเสน	พ ิ ม เ ส น
เผือ	เ ผ ื อ
ฝืด	ฝ ื ด
อาณานิคม	อ า ณ า น ิ ค ม
การจบเห่	ก า ร จ บ เ ห ่
ขี่ม้าขาว	ข ี ่ ม ้ า ข า ว
ฤๅษี	ฤ ๅ ษ ี
โพแดง	โ พ แ ด ง
คอหอย	ค อ ห อ ย
ใบประจำต่อ	ใ บ ป ร ะ จ ำ ต ่ อ
ยี่สิบสอง	ย ี ่ ส ิ บ ส อ ง
ยางลบ	ย า ง ล บ
ต่อว่า	ต ่ อ ว ่ า
ได้หน้าได้ตา	ไ ด ้ ห น ้ า ไ ด ้ ต า
เฟื้อง	เ ฟ ื ้ อ ง
พาย	พ า ย
ดรัมเมเยอร์	ด ร ั ม เ ม เ ย อ ร ์
อัธยาตมวิทยา	อ ั ธ ย า ต ม ว ิ ท ย า
โรคทางจิต	โ ร ค ท า ง จ ิ ต
ชุมทาง	ช ุ ม ท า ง
ปลดทุกข์	ป ล ด ท ุ ก ข ์
ศาสตราคม	ศ า ส ต ร า ค ม
ถ่านไฟฉาย	ถ ่ า น ไ ฟ ฉ า ย
ปุนัพสุ	ป ุ น ั พ ส ุ
ปฐมพยาบาล	ป ฐ ม พ ย า บ า ล
ดินปืน	ด ิ น ป ื น
นิด	น ิ ด
การติดเชื้อ	ก า ร ต ิ ด เ ช ื ้ อ
ท่วง	ท ่ ว ง
มาม่า	ม า ม ่ า
เขมือบ	เ ข ม ื อ บ
ฝนดาวตก	ฝ น ด า ว ต ก
หุ่นขี้ผึ้ง	ห ุ ่ น ข ี ้ ผ ึ ้ ง
ยอมความ	ย อ ม ค ว า ม
ถะ	ถ ะ
ขี้เปียก	ข ี ้ เ ป ี ย ก
อนิจภาพ	อ น ิ จ ภ า พ
กบในกะลาครอบ	ก บ ใ น ก ะ ล า ค ร อ บ
สวนผัก	ส ว น ผ ั ก
เสริมสวย	เ ส ร ิ ม ส ว ย
การฆ่าปิดปาก	ก า ร ฆ ่ า ป ิ ด ป า ก
จักษุแพทย์	จ ั ก ษ ุ แ พ ท ย ์
ใฝ	ใ ฝ
ผณิศวร	ผ ณ ิ ศ ว ร
ยอก	ย อ ก
ยิงกระต่าย	ย ิ ง ก ร ะ ต ่ า ย
ป่น	ป ่ น
มรณะ	ม ร ณ ะ
สันดาล	ส ั น ด า ล
สดับ	ส ด ั บ
พฤติการณ์	พ ฤ ต ิ ก า ร ณ ์
ตปท.	ต ป ท .
ทรงสิบสองหน้า	ท ร ง ส ิ บ ส อ ง ห น ้ า
พิพิธภัณฑสถาน	พ ิ พ ิ ธ ภ ั ณ ฑ ส ถ า น
ซึมเศร้า	ซ ึ ม เ ศ ร ้ า
บุรพทิศ	บ ุ ร พ ท ิ ศ
บิบิมบับ	บ ิ บ ิ ม บ ั บ
การรุก	ก า ร ร ุ ก
การชิง	ก า ร ช ิ ง
การสืบสวน	ก า ร ส ื บ ส ว น
บันไดเลื่อน	บ ั น ไ ด เ ล ื ่ อ น
เจ้าหนี้	เ จ ้ า ห น ี ้
ค่าโง่	ค ่ า โ ง ่
การเฝ้า	ก า ร เ ฝ ้ า
การจัด	ก า ร จ ั ด
ค่ะ	ค ่ ะ
บน	บ น
เพื่อน	เ พ ื ่ อ น
เด็ก	เ ด ็ ก
ทองหลาง	ท อ ง ห ล า ง
ปรมาภิไธย	ป ร ม า ภ ิ ไ ธ ย
จุน	จ ุ น
ยุติ	ย ุ ต ิ
นึ่ง	น ึ ่ ง
ข้อยกเว้น	ข ้ อ ย ก เ ว ้ น
ดื้อ	ด ื ้ อ
โพรง	โ พ ร ง
ฝาน	ฝ า น
สวน	ส ว น
มาก	ม า ก
โมโห	โ ม โ ห
นางงาม	น า ง ง า ม
ปิด	ป ิ ด
เชื้อสาย	เ ช ื ้ อ ส า ย
ปิด	ป ิ ด
ปิด	ป ิ ด
กุล	ก ุ ล
มาก	ม า ก
ประทับใจ	ป ร ะ ท ั บ ใ จ
เหลือบ	เ ห ล ื อ บ
การปั่น	ก า ร ป ั ่ น
ขนส่ง	ข น ส ่ ง
นึ่ง	น ึ ่ ง
ชานม	ช า น ม
นอย	น อ ย
ปิด	ป ิ ด
ประนีประนอม	ป ร ะ น ี ป ร ะ น อ ม
เมื่อ	เ ม ื ่ อ
ร้านอาหาร	ร ้ า น อ า ห า ร
ยาก	ย า ก
ช่อ	ช ่ อ
ปากีสถาน	ป า ก ี ส ถ า น
จาร	จ า ร
น้ำบาดาล	น ้ ำ บ า ด า ล
หมาด	ห ม า ด
ปั่น	ป ั ่ น
รักษา	ร ั ก ษ า
การประชาสัมพันธ์	ก า ร ป ร ะ ช า ส ั ม พ ั น ธ ์
เฮ	เ ฮ
มาก	ม า ก
โปรโมชั่น	โ ป ร โ ม ช ั ่ น
มาก	ม า ก
มาก	ม า ก
เยอะ	เ ย อ ะ
ใจร้อน	ใ จ ร ้ อ น
ห่วงใย	ห ่ ว ง ใ ย
ช็อกโกแลต	ช ็ อ ก โ ก แ ล ต
บรรยากาศ	บ ร ร ย า ก า ศ
แจ๊ส	แ จ ๊ ส
ปิด	ป ิ ด
บริวาร	บ ร ิ ว า ร
ดื้อ	ด ื ้ อ
มาก	ม า ก
มาก	ม า ก
ประสิทธิผล	ป ร ะ ส ิ ท ธ ิ ผ ล
ทางด่วน	ท า ง ด ่ ว น
หวั่น	ห ว ั ่ น
ฟู	ฟ ู
แคลเซียม	แ ค ล เ ซ ี ย ม
กาง	ก า ง
กินเจ	ก ิ น เ จ
การบูร	ก า ร บ ู ร
การจัด	ก า ร จ ั ด
เมื่อ	เ ม ื ่ อ
เปิด	เ ป ิ ด
ค่ะ	ค ่ ะ
เมื่อ	เ ม ื ่ อ
เมื่อ	เ ม ื ่ อ
สุขภาพจิต	ส ุ ข ภ า พ จ ิ ต
แยม	แ ย ม
อาวุธปืน	อ า ว ุ ธ ป ื น
นอย	น อ ย
การประชาสัมพันธ์	ก า ร ป ร ะ ช า ส ั ม พ ั น ธ ์
พสก	พ ส ก
เบลเยียม	เ บ ล เ ย ี ย ม
โปรโมชั่น	โ ป ร โ ม ช ั ่ น
ศาสตร์	ศ า ส ต ร ์
ดีใจ	ด ี ใ จ
เนรมิต	เ น ร ม ิ ต
ฟู	ฟ ู
สาหร่าย	ส า ห ร ่ า ย
นามธรรม	น า ม ธ ร ร ม
นอย	น อ ย
ผู้ช่วยศาสตราจารย์	ผ ู ้ ช ่ ว ย ศ า ส ต ร า จ า ร ย ์
ราเมศวร	ร า เ ม ศ ว ร
รักษา	ร ั ก ษ า
จัตุรัส	จ ั ต ุ ร ั ส
สถานที่	ส ถ า น ท ี ่
อวยพร	อ ว ย พ ร
เมื่อ	เ ม ื ่ อ
นอย	น อ ย
บน	บ น
ปิด	ป ิ ด
ทาย	ท า ย
ข้าม	ข ้ า ม
ปราก	ป ร า ก
ประมวลกฎหมาย	ป ร ะ ม ว ล ก ฎ ห ม า ย
อัปโหลด	อ ั ป โ ห ล ด
ทางซ้าย	ท า ง ซ ้ า ย
ปิด	ป ิ ด
งานเข้า	ง า น เ ข ้ า
มาก	ม า ก
มาก	ม า ก
มกร	ม ก ร
พูด	พ ู ด
นึ่ง	น ึ ่ ง
นักลงทุน	น ั ก ล ง ท ุ น
ยาก	ย า ก
ช่อ	ช ่ อ
พูด	พ ู ด
ยาก	ย า ก
ถุงพลาสติก	ถ ุ ง พ ล า ส ต ิ ก
โปรโมชั่น	โ ป ร โ ม ช ั ่ น
เปิด	เ ป ิ ด
มาก	ม า ก
เด็ก	เ ด ็ ก
เฮลิคอปเตอร์	เ ฮ ล ิ ค อ ป เ ต อ ร ์
คนงาน	ค น ง า น
สวน	ส ว น
ทิ้ง	ท ิ ้ ง
เปิด	เ ป ิ ด
ข้าม	ข ้ า ม
มาก	ม า ก
เด็ก	เ ด ็ ก
ฮาเร็ม	ฮ า เ ร ็ ม
สวน	ส ว น
แคลิฟอร์เนีย	แ ค ล ิ ฟ อ ร ์ เ น ี ย
เจาะ	เ จ า ะ
เพื่อน	เ พ ื ่ อ น
อินเทรนด์	อ ิ น เ ท ร น ด ์
ความกดดัน	ค ว า ม ก ด ด ั น
เอธิโอเปีย	เ อ ธ ิ โ อ เ ป ี ย
ทศ	ท ศ
คดี	ค ด ี
ชุดชั้นใน	ช ุ ด ช ั ้ น ใ น
ยาก	ย า ก
เชื่อมั่น	เ ช ื ่ อ ม ั ่ น
ประจำ	ป ร ะ จ ำ
ความซับซ้อน	ค ว า ม ซ ั บ ซ ้ อ น
พูด	พ ู ด
สนธิสัญญา	ส น ธ ิ ส ั ญ ญ า
ปิด	ป ิ ด
สถานที่	ส ถ า น ท ี ่
นอย	น อ ย
เปิด	เ ป ิ ด
ชนิด	ช น ิ ด
ศาสตร์	ศ า ส ต ร ์
ผ้า	ผ ้ า
เปิด	เ ป ิ ด
บน	บ น
บน	บ น
ทศ	ท ศ
อุรุกวัย	อ ุ ร ุ ก ว ั ย
ศาสตร์	ศ า ส ต ร ์
ลดราคา	ล ด ร า ค า
รักษา	ร ั ก ษ า
โรงสี	โ ร ง ส ี
อ้าง	อ ้ า ง
ยาก	ย า ก
สมมติ	ส ม ม ต ิ
แขนเสื้อ	แ ข น เ ส ื ้ อ
จาร	จ า ร
ตะขอ	ต ะ ข อ
เมื่อ	เ ม ื ่ อ
การกลืน	ก า ร ก ล ื น
สถานที่	ส ถ า น ท ี ่
โปรโมชั่น	โ ป ร โ ม ช ั ่ น
ทศ	ท ศ
ยี่หร่า	ย ี ่ ห ร ่ า
เมื่อ	เ ม ื ่ อ
ข้าม	ข ้ า ม
การชัก	ก า ร ช ั ก
รถยก	ร ถ ย ก
นึ่ง	น ึ ่ ง
เมื่อ	เ ม ื ่ อ
ดาย	ด า ย
เด็ก	เ ด ็ ก
งัด	ง ั ด
หมอก	ห ม อ ก
กำไล	ก ำ ไ ล
ทศ	ท ศ
ประจำ	ป ร ะ จ ำ
จุลภาค	จ ุ ล ภ า ค
อวสาน	อ ว ส า น
จาร	จ า ร
อิเหนา	อ ิ เ ห น า
เปลว	เ ป ล ว
เพื่อน	เ พ ื ่ อ น
มาก	ม า ก
ช่างไฟฟ้า	ช ่ า ง ไ ฟ ฟ ้ า
สวน	ส ว น
ร้านอาหาร	ร ้ า น อ า ห า ร
โมโห	โ ม โ ห
ชนิด	ช น ิ ด
บน	บ น
ขนส่ง	ข น ส ่ ง
เปิด	เ ป ิ ด
ปลีก	ป ล ี ก
ยาก	ย า ก
รักษา	ร ั ก ษ า
ปิด	ป ิ ด
อิสร	อ ิ ส ร
มกร	ม ก ร
ศาสตร์	ศ า ส ต ร ์
กรมธรรม	ก ร ม ธ ร ร ม
ศาสตร์	ศ า ส ต ร ์
ทศ	ท ศ
ทศ	ท ศ
กระดูกสันหลัง	ก ร ะ ด ู ก ส ั น ห ล ั ง
บน	บ น
บน	บ น
นอย	น อ ย
ค่ะ	ค ่ ะ
รักษา	ร ั ก ษ า
กุล	ก ุ ล
เมื่อ	เ ม ื ่ อ
ปิด	ป ิ ด
กลิ่น	ก ล ิ ่ น
มกร	ม ก ร
สวน	ส ว น
นอย	น อ ย
ปลีก	ป ล ี ก
ปิด	ป ิ ด
ล้วง	ล ้ ว ง
ทาย	ท า ย
เข่ง	เ ข ่ ง
เสี้ยน	เ ส ี ้ ย น
มิค	ม ิ ค
เพื่อน	เ พ ื ่ อ น
แอปเปิ้ล	แ อ ป เ ป ิ ้ ล
เปิด	เ ป ิ ด
บรรจบ	บ ร ร จ บ
กวางตุ้ง	ก ว า ง ต ุ ้ ง
แจม	แ จ ม
ปิด	ป ิ ด
ทศ	ท ศ
สถานที่	ส ถ า น ท ี ่
มั่นใจ	ม ั ่ น ใ จ
ทศ	ท ศ
เคี้ยว	เ ค ี ้ ย ว
ผ้า	ผ ้ า
เบิร์น	เ บ ิ ร ์ น
ค่าเทอม	ค ่ า เ ท อ ม
ตรุษจีน	ต ร ุ ษ จ ี น
ปั่น	ป ั ่ น
คั่ง	ค ั ่ ง
มกร	ม ก ร
ข้าม	ข ้ า ม
เปิด	เ ป ิ ด
ข้าม	ข ้ า ม
ทาย	ท า ย
บรรษัท	บ ร ร ษ ั ท
ประจำ	ป ร ะ จ ำ
การทำอาหาร	ก า ร ท ำ อ า ห า ร
โปรโมชั่น	โ ป ร โ ม ช ั ่ น
จาร	จ า ร
ข้าม	ข ้ า ม
แล็บ	แ ล ็ บ
มั่นใจ	ม ั ่ น ใ จ
ชนิด	ช น ิ ด
เพื่อน	เ พ ื ่ อ น
ช่อ	ช ่ อ
เฮ	เ ฮ
สัตว์น้ำ	ส ั ต ว ์ น ้ ำ
เด็ก	เ ด ็ ก
ทุกที	ท ุ ก ท ี
รัม	ร ั ม
ศาสตร์	ศ า ส ต ร ์
นึ่ง	น ึ ่ ง
มาก	ม า ก
บน	บ น
มาก	ม า ก
ข้าม	ข ้ า ม
ทศ	ท ศ
ช่อ	ช ่ อ
เมื่อ	เ ม ื ่ อ
เปิด	เ ป ิ ด
ของโจร	ข อ ง โ จ ร
ทศ	ท ศ
นึ่ง	น ึ ่ ง
นอย	น อ ย
เปิด	เ ป ิ ด
แม้	แ ม ้
โคโลญจ์	โ ค โ ล ญ จ ์
การอำนวย	ก า ร อ ำ น ว ย
ปิด	ป ิ ด
พิพิธภัณฑ์สัตว์น้ำ	พ ิ พ ิ ธ ภ ั ณ ฑ ์ ส ั ต ว ์ น ้ ำ
ยาก	ย า ก
ประติมากร	ป ร ะ ต ิ ม า ก ร
เมื่อ	เ ม ื ่ อ
ช่อ	ช ่ อ
ศาสตร์	ศ า ส ต ร ์
การสนทนา	ก า ร ส น ท น า
ปิด	ป ิ ด
เยีย	เ ย ี ย
แผนปฏิบัติ	แ ผ น ป ฏ ิ บ ั ต ิ
แนะนำ	แ น ะ น ำ
มาก	ม า ก
โปรโมชั่น	โ ป ร โ ม ช ั ่ น
บน	บ น
บน	บ น
เจาะ	เ จ า ะ
การมี	ก า ร ม ี
ช่อ	ช ่ อ
แพ่ง	แ พ ่ ง
นึ่ง	น ึ ่ ง
เหยี่ยว	เ ห ย ี ่ ย ว
อ้าง	อ ้ า ง
น้ำอัดลม	น ้ ำ อ ั ด ล ม
เปิด	เ ป ิ ด
ของขลัง	ข อ ง ข ล ั ง
ร้านอาหาร	ร ้ า น อ า ห า ร
ประมวลกฎหมาย	ป ร ะ ม ว ล ก ฎ ห ม า ย
รัม	ร ั ม
คดี	ค ด ี
นัดหมาย	น ั ด ห ม า ย
๑๗	๑ ๗
แม้	แ ม ้
ฝั่ง	ฝ ั ่ ง
มาก	ม า ก
เด็ก	เ ด ็ ก
เมื่อ	เ ม ื ่ อ
ของเหลว	ข อ ง เ ห ล ว
มาก	ม า ก
มาก	ม า ก
พูด	พ ู ด
ทิ้ง	ท ิ ้ ง
ยาก	ย า ก
เพื่อน	เ พ ื ่ อ น
ตะเกียง	ต ะ เ ก ี ย ง
มกร	ม ก ร
แนะนำ	แ น ะ น ำ
ชนิด	ช น ิ ด
ข้าม	ข ้ า ม
หยาด	ห ย า ด
เผยอ	เ ผ ย อ
อ้าง	อ ้ า ง
พูด	พ ู ด
เรือดำน้ำ	เ ร ื อ ด ำ น ้ ำ
ปลูกฝัง	ป ล ู ก ฝ ั ง
การจัด	ก า ร จ ั ด
โปรโมชั่น	โ ป ร โ ม ช ั ่ น
เคี้ยว	เ ค ี ้ ย ว
ฮานอย	ฮ า น อ ย
นอย	น อ ย
ส่วนรวม	ส ่ ว น ร ว ม
โรงพัก	โ ร ง พ ั ก
สัญญาณไฟจราจร	ส ั ญ ญ า ณ ไ ฟ จ ร า จ ร
จาร	จ า ร
ส่วนรวม	ส ่ ว น ร ว ม
ประจำ	ป ร ะ จ ำ
โม่ง	โ ม ่ ง
ลิบ	ล ิ บ
รักษา	ร ั ก ษ า
เพื่อน	เ พ ื ่ อ น
นอย	น อ ย
เมื่อ	เ ม ื ่ อ
ไพฑูรย์	ไ พ ฑ ู ร ย ์
มาก	ม า ก
ค่านิยม	ค ่ า น ิ ย ม
เหยี่ยว	เ ห ย ี ่ ย ว
ยุติ	ย ุ ต ิ
อิ่มตัว	อ ิ ่ ม ต ั ว
คันจิ	ค ั น จ ิ
บน	บ น
ข้าม	ข ้ า ม
รักษา	ร ั ก ษ า
ทะเลจีนใต้	ท ะ เ ล จ ี น ใ ต ้
นักลงทุน	น ั ก ล ง ท ุ น
รักษา	ร ั ก ษ า
แนะนำ	แ น ะ น ำ
เปิด	เ ป ิ ด
ปิด	ป ิ ด
ยาก	ย า ก
ถ่วงเวลา	ถ ่ ว ง เ ว ล า
ใบขับขี่	ใ บ ข ั บ ข ี ่
เปิด	เ ป ิ ด
รักษา	ร ั ก ษ า
อาวุธปืน	อ า ว ุ ธ ป ื น
เปิด	เ ป ิ ด
นอย	น อ ย
เดลี	เ ด ล ี
มาก	ม า ก
นอย	น อ ย
เมื่อ	เ ม ื ่ อ
ผ้า	ผ ้ า
อธิฐาน	อ ธ ิ ฐ า น
มาก	ม า ก
เท่าไหร่	เ ท ่ า ไ ห ร ่
เส้นประสาท	เ ส ้ น ป ร ะ ส า ท
บน	บ น
เด็ก	เ ด ็ ก
นอย	น อ ย
เมื่อ	เ ม ื ่ อ
คุณพระ	ค ุ ณ พ ร ะ
คดี	ค ด ี
ผู้ชม	ผ ู ้ ช ม
ชำระ	ช ำ ร ะ
น็อก	น ็ อ ก
งานเข้า	ง า น เ ข ้ า
กำมะหยี	ก ำ ม ะ ห ย ี
ศาสตร์	ศ า ส ต ร ์
เฮ	เ ฮ
มาก	ม า ก
เอาเปรียบ	เ อ า เ ป ร ี ย บ
กันชน	ก ั น ช น
นึ่ง	น ึ ่ ง
ทรงผม	ท ร ง ผ ม
การจัด	ก า ร จ ั ด
โรคระบาด	โ ร ค ร ะ บ า ด
บน	บ น
คดี	ค ด ี
มาก	ม า ก
วิกิพีเดีย	ว ิ ก ิ พ ี เ ด ี ย
ก้าม	ก ้ า ม
เด็ก	เ ด ็ ก
นอย	น อ ย
ช่อ	ช ่ อ
การจัด	ก า ร จ ั ด
ช่อ	ช ่ อ
เข่ง	เ ข ่ ง
เมื่อ	เ ม ื ่ อ
ข้าม	ข ้ า ม
เมื่อ	เ ม ื ่ อ
เมื่อ	เ ม ื ่ อ
สืบทอด	ส ื บ ท อ ด
มกร	ม ก ร
ประมง	ป ร ะ ม ง
ประจำ	ป ร ะ จ ำ
ตุล	ต ุ ล
สถานที่	ส ถ า น ท ี ่
นึ่ง	น ึ ่ ง
โม่	โ ม ่
ขับไล่	ข ั บ ไ ล ่
ฤดูฝน	ฤ ด ู ฝ น
เปิด	เ ป ิ ด
แม้	แ ม ้
รธน.	ร ธ น .
เมื่อ	เ ม ื ่ อ
สิ้นสุด	ส ิ ้ น ส ุ ด
บน	บ น
ผ้า	ผ ้ า
สันหลัง	ส ั น ห ล ั ง
เชื่อมั่น	เ ช ื ่ อ ม ั ่ น
ประทับใจ	ป ร ะ ท ั บ ใ จ
กุล	ก ุ ล
มาก	ม า ก
สงบ	ส ง บ
หมวก	ห ม ว ก
อวกาศ	อ ว ก า ศ
มาก	ม า ก
ประจำ	ป ร ะ จ ำ
ยาก	ย า ก
ข้าม	ข ้ า ม
บน	บ น
ศาสตร์	ศ า ส ต ร ์
น้อยใจ	น ้ อ ย ใ จ
บน	บ น
เส้นประสาท	เ ส ้ น ป ร ะ ส า ท
นอย	น อ ย
ซามูไร	ซ า ม ู ไ ร
ทศ	ท ศ
ยาก	ย า ก
เมื่อ	เ ม ื ่ อ
ศาสตร์	ศ า ส ต ร ์
ยาก	ย า ก
เมื่อ	เ ม ื ่ อ
ไพบูลย์	ไ พ บ ู ล ย ์
ใบขับขี่	ใ บ ข ั บ ข ี ่
ประจำ	ป ร ะ จ ำ
การแถลงข่าว	ก า ร แ ถ ล ง ข ่ า ว
การอำนวย	ก า ร อ ำ น ว ย
มกร	ม ก ร
ทศ	ท ศ
นึ่ง	น ึ ่ ง
ไครเมีย	ไ ค ร เ ม ี ย
ชนิด	ช น ิ ด
การจัด	ก า ร จ ั ด
เปิด	เ ป ิ ด
แนะนำ	แ น ะ น ำ
อาวุธปืน	อ า ว ุ ธ ป ื น
โพรง	โ พ ร ง
การป่วย	ก า ร ป ่ ว ย
นายแพทย์	น า ย แ พ ท ย ์
รักษา	ร ั ก ษ า
พ่อมด	พ ่ อ ม ด
ถุงเท้า	ถ ุ ง เ ท ้ า
ตลาดหลักทรัพย์	ต ล า ด ห ล ั ก ท ร ั พ ย ์
คิริ	ค ิ ร ิ
เปิด	เ ป ิ ด
จำนอง	จ ำ น อ ง
ขึง	ข ึ ง
เป็นห่วง	เ ป ็ น ห ่ ว ง
ยาก	ย า ก
บน	บ น
บน	บ น
กิจการ	ก ิ จ ก า ร
จาร	จ า ร
ความหนาแน่น	ค ว า ม ห น า แ น ่ น
มาก	ม า ก
ร้านอาหาร	ร ้ า น อ า ห า ร
๒๐	๒ ๐
ทศ	ท ศ
ศิริ	ศ ิ ร ิ
ปิด	ป ิ ด
อิสร	อ ิ ส ร
เตารีด	เ ต า ร ี ด
ค่ะ	ค ่ ะ
ทรงผม	ท ร ง ผ ม
มกร	ม ก ร
ค้าน	ค ้ า น
ทศ	ท ศ
บน	บ น
แม้	แ ม ้
สะเก็ดเงิน	ส ะ เ ก ็ ด เ ง ิ น
ปิด	ป ิ ด
มั่นใจ	ม ั ่ น ใ จ
ค่ะ	ค ่ ะ
สันนิษฐาน	ส ั น น ิ ษ ฐ า น
อุปทาน	อ ุ ป ท า น
นักบัญชี	น ั ก บ ั ญ ช ี
เปิด	เ ป ิ ด
เฮ	เ ฮ
แนะนำ	แ น ะ น ำ
เต้น	เ ต ้ น
นอย	น อ ย
กุล	ก ุ ล
น้ำมันพืช	น ้ ำ ม ั น พ ื ช
พูด	พ ู ด
ประติมากร	ป ร ะ ต ิ ม า ก ร
โรงหนัง	โ ร ง ห น ั ง
เยอะ	เ ย อ ะ
อดกลั้น	อ ด ก ล ั ้ น
ความแซ่บ	ค ว า ม แ ซ ่ บ
ฝั่ง	ฝ ั ่ ง
แนะนำ	แ น ะ น ำ
ยุติ	ย ุ ต ิ
เพื่อน	เ พ ื ่ อ น
เปิด	เ ป ิ ด
นักข่าว	น ั ก ข ่ า ว
ศาสตร์	ศ า ส ต ร ์
นึ่ง	น ึ ่ ง
ทุเรียน	ท ุ เ ร ี ย น
เลี้ยงดู	เ ล ี ้ ย ง ด ู
บน	บ น
สำมะโน	ส ำ ม ะ โ น
ความลึก	ค ว า ม ล ึ ก
รักษา	ร ั ก ษ า
หัก	ห ั ก
กุล	ก ุ ล
รักษา	ร ั ก ษ า
ดิสก์	ด ิ ส ก ์
เถียง	เ ถ ี ย ง
หมาป่า	ห ม า ป ่ า
คดี	ค ด ี
โยม	โ ย ม
เจาะ	เ จ า ะ
มกร	ม ก ร
ผงก	ผ ง ก
ผ้า	ผ ้ า
ซีเรีย	ซ ี เ ร ี ย
ทศ	ท ศ
กินี	ก ิ น ี
โจน	โ จ น
ดาม	ด า ม
รัม	ร ั ม
ไก่ทอด	ไ ก ่ ท อ ด
ภูฏาน	ภ ู ฏ า น
ประจำ	ป ร ะ จ ำ
ช่อ	ช ่ อ
รักษา	ร ั ก ษ า
ข้ออ้าง	ข ้ อ อ ้ า ง
หมวก	ห ม ว ก
การพยาบาล	ก า ร พ ย า บ า ล
แนะนำ	แ น ะ น ำ
เฮ	เ ฮ
โง่	โ ง ่
ประคอง	ป ร ะ ค อ ง
รับประทาน	ร ั บ ป ร ะ ท า น
ศาสตร์	ศ า ส ต ร ์
กุล	ก ุ ล
นึ่ง	น ึ ่ ง
เต้น	เ ต ้ น
ทุกที	ท ุ ก ท ี
ข้าวโพด	ข ้ า ว โ พ ด
กรัม	ก ร ั ม
ปิด	ป ิ ด
แคลเซียม	แ ค ล เ ซ ี ย ม
การกรอก	ก า ร ก ร อ ก
คั้น	ค ั ้ น
โก่ง	โ ก ่ ง
ยุติ	ย ุ ต ิ
กิจการ	ก ิ จ ก า ร
มาก	ม า ก
ลดราคา	ล ด ร า ค า
สงบ	ส ง บ
นอย	น อ ย
เปิด	เ ป ิ ด
กิจการ	ก ิ จ ก า ร
เท่าไหร่	เ ท ่ า ไ ห ร ่
หดหู่	ห ด ห ู ่
พรสวรรค์	พ ร ส ว ร ร ค ์
วลี	ว ล ี
คล้ำ	ค ล ้ ำ
สังขาร	ส ั ง ข า ร
รบ.	ร บ .
ฟาก	ฟ า ก
พืชผัก	พ ื ช ผ ั ก
ปากีสถาน	ป า ก ี ส ถ า น
รับประทาน	ร ั บ ป ร ะ ท า น
ประจำ	ป ร ะ จ ำ
ไอศกรีม	ไ อ ศ ก ร ี ม
ทศ	ท ศ
เมื่อ	เ ม ื ่ อ
ค่ะ	ค ่ ะ
นึ่ง	น ึ ่ ง
แม้	แ ม ้
เมื่อ	เ ม ื ่ อ
การมี	ก า ร ม ี
ลัทธิ	ล ั ท ธ ิ
พยานหลักฐาน	พ ย า น ห ล ั ก ฐ า น
บน	บ น
ทศ	ท ศ
แนะนำ	แ น ะ น ำ
รักษา	ร ั ก ษ า
ดำน้ำ	ด ำ น ้ ำ
การจัด	ก า ร จ ั ด
มาก	ม า ก
เนื้อเยื่อ	เ น ื ้ อ เ ย ื ่ อ
แนะนำ	แ น ะ น ำ
เต้น	เ ต ้ น
เรียง	เ ร ี ย ง
โมเม	โ ม เ ม
บน	บ น
ยาก	ย า ก
บน	บ น
สวน	ส ว น
ทศ	ท ศ
สถานที่	ส ถ า น ท ี ่
ข้าม	ข ้ า ม
เยีย	เ ย ี ย
มาก	ม า ก
สถานที่	ส ถ า น ท ี ่
สถานที่	ส ถ า น ท ี ่
ร้อนใน	ร ้ อ น ใ น
ชำระ	ช ำ ร ะ
เหยียด	เ ห ย ี ย ด
ริ้วรอย	ร ิ ้ ว ร อ ย
ทาย	ท า ย
ผ้า	ผ ้ า
นิติธรรม	น ิ ต ิ ธ ร ร ม
เมื่อ	เ ม ื ่ อ
ถุงพลาสติก	ถ ุ ง พ ล า ส ต ิ ก
ประหาร	ป ร ะ ห า ร
ดาดฟ้า	ด า ด ฟ ้ า
หน้าตาย	ห น ้ า ต า ย
เมื่อ	เ ม ื ่ อ
ทศ	ท ศ
มาก	ม า ก
หมอบ	ห ม อ บ
แม้	แ ม ้
นึ่ง	น ึ ่ ง
เนื้อคู่	เ น ื ้ อ ค ู ่
จอร์แดน	จ อ ร ์ แ ด น
พูด	พ ู ด
สวนสาธารณะ	ส ว น ส า ธ า ร ณ ะ
โดยสาร	โ ด ย ส า ร
กอง	ก อ ง
ดาย	ด า ย
ยาก	ย า ก
พิบัติ	พ ิ บ ั ต ิ
กางเกง	ก า ง เ ก ง
ทิด	ท ิ ด
ภาพประกอบ	ภ า พ ป ร ะ ก อ บ
ช่างไฟฟ้า	ช ่ า ง ไ ฟ ฟ ้ า
เจาะ	เ จ า ะ
บรรยากาศ	บ ร ร ย า ก า ศ
ข้าม	ข ้ า ม
การจัด	ก า ร จ ั ด
เบ็ด	เ บ ็ ด
การแถลงข่าว	ก า ร แ ถ ล ง ข ่ า ว
เลอะ	เ ล อ ะ
ไพล	ไ พ ล
อาถรรพ์	อ า ถ ร ร พ ์
มาก	ม า ก
ระทึก	ร ะ ท ึ ก
ประมง	ป ร ะ ม ง
มกร	ม ก ร
เปิด	เ ป ิ ด
นึ่ง	น ึ ่ ง
ประจำ	ป ร ะ จ ำ
สถานที่	ส ถ า น ท ี ่
กระจุก	ก ร ะ จ ุ ก
เปิด	เ ป ิ ด
คำนำ	ค ำ น ำ
ชำระ	ช ำ ร ะ
อารมณ์ขัน	อ า ร ม ณ ์ ข ั น
พูด	พ ู ด
ไกด์	ไ ก ด ์
สโมสร	ส โ ม ส ร
ผู้สนับสนุน	ผ ู ้ ส น ั บ ส น ุ น
เยิ้ม	เ ย ิ ้ ม
เณร	เ ณ ร
เปิด	เ ป ิ ด
เปิด	เ ป ิ ด
ยุติ	ย ุ ต ิ
โทรสาร	โ ท ร ส า ร
น้ำส้ม	น ้ ำ ส ้ ม
แม้	แ ม ้
ลามา	ล า ม า
ไฮโซ	ไ ฮ โ ซ
นอย	น อ ย
บรรยากาศ	บ ร ร ย า ก า ศ
มาเล	ม า เ ล
บน	บ น
พูด	พ ู ด
นอย	น อ ย
เมื่อ	เ ม ื ่ อ
แอก	แ อ ก
นอย	น อ ย
ช่อ	ช ่ อ
รักษา	ร ั ก ษ า
มั่นใจ	ม ั ่ น ใ จ
สรรเสริญ	ส ร ร เ ส ร ิ ญ
นอย	น อ ย
สนิม	ส น ิ ม
จำคุก	จ ำ ค ุ ก
ฟู	ฟ ู
สวน	ส ว น
รักษา	ร ั ก ษ า
สงบ	ส ง บ
การปฏิรูป	ก า ร ป ฏ ิ ร ู ป
เลขา	เ ล ข า
โม่	โ ม ่
เขือ	เ ข ื อ
มาก	ม า ก
ยาก	ย า ก
เวทย์มนต์	เ ว ท ย ์ ม น ต ์
นัดหมาย	น ั ด ห ม า ย
ตะโก	ต ะ โ ก
ความคม	ค ว า ม ค ม
เปิด	เ ป ิ ด
เลี้ยงดู	เ ล ี ้ ย ง ด ู
ออกซิเจน	อ อ ก ซ ิ เ จ น
วรรณ	ว ร ร ณ
แมง	แ ม ง
เยีย	เ ย ี ย
มิลลิกรัม	ม ิ ล ล ิ ก ร ั ม
ไก่	ไ ก ่
ประจำ	ป ร ะ จ ำ
เถิด	เ ถ ิ ด
มาก	ม า ก
เขือ	เ ข ื อ
เมื่อ	เ ม ื ่ อ
เมื่อ	เ ม ื ่ อ
ประจำ	ป ร ะ จ ำ
ไก่	ไ ก ่
ทศ	ท ศ
มาก	ม า ก
นอย	น อ ย
น้ำส้ม	น ้ ำ ส ้ ม
อยู่กิน	อ ย ู ่ ก ิ น
ยาก	ย า ก
กอง	ก อ ง
เปลือกตา	เ ป ล ื อ ก ต า
เปิด	เ ป ิ ด
ล้าหลัง	ล ้ า ห ล ั ง
ทศ	ท ศ
เด็ก	เ ด ็ ก
แซะ	แ ซ ะ
ทศ	ท ศ
ตากอากาศ	ต า ก อ า ก า ศ
มกร	ม ก ร
บรรยากาศ	บ ร ร ย า ก า ศ
พื้นบ้าน	พ ื ้ น บ ้ า น
ศาสตร์	ศ า ส ต ร ์
ร้านอาหาร	ร ้ า น อ า ห า ร
กงสุล	ก ง ส ุ ล
เยอะ	เ ย อ ะ
เมื่อ	เ ม ื ่ อ
ศิริ	ศ ิ ร ิ
เด็ก	เ ด ็ ก
มกร	ม ก ร
ช่อ	ช ่ อ
งานเข้า	ง า น เ ข ้ า
อึ้ง	อ ึ ้ ง
เพื่อน	เ พ ื ่ อ น
โปรโมชั่น	โ ป ร โ ม ช ั ่ น
กระแสไฟฟ้า	ก ร ะ แ ส ไ ฟ ฟ ้ า
มาก	ม า ก
เด็ก	เ ด ็ ก
การจัด	ก า ร จ ั ด
นึ่ง	น ึ ่ ง
เครื่องสูบน้ำ	เ ค ร ื ่ อ ง ส ู บ น ้ ำ
ร้องไห้	ร ้ อ ง ไ ห ้
ทศ	ท ศ
มาก	ม า ก
ฟาด	ฟ า ด
ไม้เรียว	ไ ม ้ เ ร ี ย ว
เยอะ	เ ย อ ะ
ดิ่ง	ด ิ ่ ง
เด็ก	เ ด ็ ก
ทรงกลม	ท ร ง ก ล ม
สถานที่	ส ถ า น ท ี ่
ปิด	ป ิ ด
ปิด	ป ิ ด
บน	บ น
ยาก	ย า ก
พายุฝน	พ า ย ุ ฝ น
เคลือบ	เ ค ล ื อ บ
ปิด	ป ิ ด
เทือก	เ ท ื อ ก
ใบเสร็จ	ใ บ เ ส ร ็ จ
บน	บ น
แม้	แ ม ้
อภัย	อ ภ ั ย
เปิด	เ ป ิ ด
มาก	ม า ก
ค่ะ	ค ่ ะ
อมตะ	อ ม ต ะ
เฮ	เ ฮ
แนะนำ	แ น ะ น ำ
นอย	น อ ย
กระซิบ	ก ร ะ ซ ิ บ
มิจฉาชีพ	ม ิ จ ฉ า ช ี พ
นอย	น อ ย
มกร	ม ก ร
จาร	จ า ร
เพื่อน	เ พ ื ่ อ น
หมี่	ห ม ี ่
ความเพลิดเพลิน	ค ว า ม เ พ ล ิ ด เ พ ล ิ น
รัม	ร ั ม
ยาก	ย า ก
เปิด	เ ป ิ ด
กระบอง	ก ร ะ บ อ ง
เมื่อ	เ ม ื ่ อ
ลดราคา	ล ด ร า ค า
ดาม	ด า ม
เซลเซียส	เ ซ ล เ ซ ี ย ส
แบงก์	แ บ ง ก ์
ปิด	ป ิ ด
การลา	ก า ร ล า
พุ่ม	พ ุ ่ ม
แซะ	แ ซ ะ
โดยสาร	โ ด ย ส า ร
เปิด	เ ป ิ ด
นอย	น อ ย
คาร์โบไฮเดรต	ค า ร ์ โ บ ไ ฮ เ ด ร ต
ลดราคา	ล ด ร า ค า
ปปช.	ป ป ช .
บน	บ น
แม้	แ ม ้
เด็ก	เ ด ็ ก
ทศ	ท ศ
เจาะ	เ จ า ะ
กงสุล	ก ง ส ุ ล
เยอะ	เ ย อ ะ
กิจการ	ก ิ จ ก า ร
บรรยากาศ	บ ร ร ย า ก า ศ
มาก	ม า ก
จาร	จ า ร
ม่อน	ม ่ อ น
ปราก	ป ร า ก
ตัวหนังสือ	ต ั ว ห น ั ง ส ื อ
ปฏิวัติ	ป ฏ ิ ว ั ต ิ
การเกาะ	ก า ร เ ก า ะ
เงื่อน	เ ง ื ่ อ น
นึ่ง	น ึ ่ ง
ตุล	ต ุ ล
มาก	ม า ก
ศาสตร์	ศ า ส ต ร ์
แนะนำ	แ น ะ น ำ
ปิด	ป ิ ด
มาก	ม า ก
กลั้น	ก ล ั ้ น
รักษา	ร ั ก ษ า
นายแพทย์	น า ย แ พ ท ย ์
มะม่วง	ม ะ ม ่ ว ง
แมง	แ ม ง
บางกอก	บ า ง ก อ ก
มาก	ม า ก
พูด	พ ู ด
ตัวการ	ต ั ว ก า ร
เพื่อน	เ พ ื ่ อ น
เยอะ	เ ย อ ะ
ทศ	ท ศ
คาวบอย	ค า ว บ อ ย
สวน	ส ว น
เยอะ	เ ย อ ะ
ปราก	ป ร า ก
ปราก	ป ร า ก
ขนส่ง	ข น ส ่ ง
ไก่	ไ ก ่
บน	บ น
ทศ	ท ศ
บน	บ น
เปิด	เ ป ิ ด
ปิด	ป ิ ด
ประสิทธิผล	ป ร ะ ส ิ ท ธ ิ ผ ล
ทศ	ท ศ
ป่าน	ป ่ า น
มาก	ม า ก
หัด	ห ั ด
ป้อมตำรวจ	ป ้ อ ม ต ำ ร ว จ
การนั่ง	ก า ร น ั ่ ง
กระด้าง	ก ร ะ ด ้ า ง
เมื่อ	เ ม ื ่ อ
มั่นใจ	ม ั ่ น ใ จ
ผ้า	ผ ้ า
เห็บ	เ ห ็ บ
ผ้า	ผ ้ า
ไหล่	ไ ห ล ่
มาก	ม า ก
สหพัน	ส ห พ ั น
เพื่อน	เ พ ื ่ อ น
ศาสตร์	ศ า ส ต ร ์
มาก	ม า ก
อุปสรรค	อ ุ ป ส ร ร ค
กอง	ก อ ง
นอย	น อ ย
ปิด	ป ิ ด
เมื่อ	เ ม ื ่ อ
รุ่นพี่	ร ุ ่ น พ ี ่
อดิเรก	อ ด ิ เ ร ก
แม้	แ ม ้
ราชกุมารี	ร า ช ก ุ ม า ร ี
กองทัพเรือ	ก อ ง ท ั พ เ ร ื อ
ขนมหวาน	ข น ม ห ว า น
ยาก	ย า ก
ปั่น	ป ั ่ น
นอย	น อ ย
ทุกที	ท ุ ก ท ี
ไซเบอร์	ไ ซ เ บ อ ร ์
ของโจร	ข อ ง โ จ ร
แนะนำ	แ น ะ น ำ
วรรณ	ว ร ร ณ
มกร	ม ก ร
มั่นใจ	ม ั ่ น ใ จ
ช่อ	ช ่ อ
ยาก	ย า ก
มาก	ม า ก
ช่อ	ช ่ อ
กอง	ก อ ง
ครั้งนั้น	ค ร ั ้ ง น ั ้ น
มาก	ม า ก
เมื่อ	เ ม ื ่ อ
บน	บ น
บน	บ น
จ้ะ	จ ้ ะ
ภาวนา	ภ า ว น า
การปฏิรูป	ก า ร ป ฏ ิ ร ู ป
ปิด	ป ิ ด
โม่	โ ม ่
นึ่ง	น ึ ่ ง
นอย	น อ ย
คดี	ค ด ี
แนะนำ	แ น ะ น ำ
ปิด	ป ิ ด
เรียง	เ ร ี ย ง
เปิด	เ ป ิ ด
เปิด	เ ป ิ ด
ทศ	ท ศ
เคลือบ	เ ค ล ื อ บ
มาก	ม า ก
นึ่ง	น ึ ่ ง
คั่ง	ค ั ่ ง
บรรยากาศ	บ ร ร ย า ก า ศ
เฮ	เ ฮ
ผ้า	ผ ้ า
ดาม	ด า ม
ทศ	ท ศ
เฟิร์ม	เ ฟ ิ ร ์ ม
สันนิษฐาน	ส ั น น ิ ษ ฐ า น
ศิริ	ศ ิ ร ิ
สาธุ	ส า ธ ุ
โปรโมชั่น	โ ป ร โ ม ช ั ่ น
แนะนำ	แ น ะ น ำ
พี่เลี้ยง	พ ี ่ เ ล ี ้ ย ง
เด็ก	เ ด ็ ก
เงื่อน	เ ง ื ่ อ น
โลหิตจาง	โ ล ห ิ ต จ า ง
ข้าม	ข ้ า ม
ชนิด	ช น ิ ด
ช่อ	ช ่ อ
ผดุง	ผ ด ุ ง
นอย	น อ ย
เด็ก	เ ด ็ ก
รักษา	ร ั ก ษ า
ปิด	ป ิ ด
ใจร้อน	ใ จ ร ้ อ น
รัม	ร ั ม
เมื่อ	เ ม ื ่ อ
ทศ	ท ศ
เหลน	เ ห ล น
ทนต์	ท น ต ์
แนะนำ	แ น ะ น ำ
ผ้า	ผ ้ า
พู่	พ ู ่
ตรุษจีน	ต ร ุ ษ จ ี น
อากาศยาน	อ า ก า ศ ย า น
คดี	ค ด ี
กระดูกเชิงกราน	ก ร ะ ด ู ก เ ช ิ ง ก ร า น
สเต็ก	ส เ ต ็ ก
ความรุ่งเรือง	ค ว า ม ร ุ ่ ง เ ร ื อ ง
บัลลังก์	บ ั ล ล ั ง ก ์
บดินทร	บ ด ิ น ท ร
พราหมณ์	พ ร า ห ม ณ ์
การจัด	ก า ร จ ั ด
แรงดึงดูด	แ ร ง ด ึ ง ด ู ด
อ้าง	อ ้ า ง
ทศ	ท ศ
นึ่ง	น ึ ่ ง
ทศ	ท ศ
ไก่	ไ ก ่
แจม	แ จ ม
ฝ่ายค้าน	ฝ ่ า ย ค ้ า น
รับประทาน	ร ั บ ป ร ะ ท า น
อภัย	อ ภ ั ย
มุข	ม ุ ข
ผู้ค้า	ผ ู ้ ค ้ า
พูด	พ ู ด
กุล	ก ุ ล
ช่อ	ช ่ อ
ทศ	ท ศ
ลิสบอน	ล ิ ส บ อ น
เปิด	เ ป ิ ด
ช่อ	ช ่ อ
ทั้งวัน	ท ั ้ ง ว ั น
ทศ	ท ศ
ยุติ	ย ุ ต ิ
การเฝ้า	ก า ร เ ฝ ้ า
จาร	จ า ร
ท้องเดิน	ท ้ อ ง เ ด ิ น
เนเธอร์แลนด์	เ น เ ธ อ ร ์ แ ล น ด ์
นอย	น อ ย
รักษา	ร ั ก ษ า
แสก	แ ส ก
นึ่ง	น ึ ่ ง
แม้	แ ม ้
นึ่ง	น ึ ่ ง
ลีมูซีน	ล ี ม ู ซ ี น
มาก	ม า ก
เกลอ	เ ก ล อ
ผ้า	ผ ้ า
ประทับใจ	ป ร ะ ท ั บ ใ จ
ใบไม้ผลิ	ใ บ ไ ม ้ ผ ล ิ
นอย	น อ ย
หุง	ห ุ ง
พืชผัก	พ ื ช ผ ั ก
บน	บ น
อ้าง	อ ้ า ง
ข้าม	ข ้ า ม
หัตถี	ห ั ต ถ ี
เหลือบ	เ ห ล ื อ บ
ขนส่ง	ข น ส ่ ง
กระบอง	ก ร ะ บ อ ง
ปิด	ป ิ ด
สโมสร	ส โ ม ส ร
ชู้	ช ู ้
แม้	แ ม ้
ศาสตร์	ศ า ส ต ร ์
แม้	แ ม ้
ทศ	ท ศ
สงบ	ส ง บ
เพื่อน	เ พ ื ่ อ น
ข้าม	ข ้ า ม
สืบพันธุ์	ส ื บ พ ั น ธ ุ ์
การจัด	ก า ร จ ั ด
วัคซีน	ว ั ค ซ ี น
อ้าง	อ ้ า ง
พีซี	พ ี ซ ี
กรัม	ก ร ั ม
เฮลิคอปเตอร์	เ ฮ ล ิ ค อ ป เ ต อ ร ์
บน	บ น
มาก	ม า ก
พูด	พ ู ด
มาก	ม า ก
ข้าม	ข ้ า ม
อิสร	อ ิ ส ร
มาก	ม า ก
พ่อมด	พ ่ อ ม ด
ตุล	ต ุ ล
โกดัง	โ ก ด ั ง
ยาก	ย า ก
ปราก	ป ร า ก
สถานที่	ส ถ า น ท ี ่
เมื่อ	เ ม ื ่ อ
บน	บ น
นอย	น อ ย
กาง	ก า ง
บน	บ น
สาธุ	ส า ธ ุ
พูด	พ ู ด
แนะนำ	แ น ะ น ำ
เงื่อน	เ ง ื ่ อ น
กอง	ก อ ง
ปราก	ป ร า ก
ยาก	ย า ก
ปราก	ป ร า ก
อิสร	อ ิ ส ร
โจรกรรม	โ จ ร ก ร ร ม
เฟค	เ ฟ ค
ประติมากรรม	ป ร ะ ต ิ ม า ก ร ร ม
เลยไป	เ ล ย ไ ป
เบิกบาน	เ บ ิ ก บ า น
แรงเสียดทาน	แ ร ง เ ส ี ย ด ท า น
การจัด	ก า ร จ ั ด
ประทับใจ	ป ร ะ ท ั บ ใ จ
บรรยากาศ	บ ร ร ย า ก า ศ
ก้อง	ก ้ อ ง
ปิด	ป ิ ด
เมื่อ	เ ม ื ่ อ
เท่าไหร่	เ ท ่ า ไ ห ร ่
เถียง	เ ถ ี ย ง
กอง	ก อ ง
ร้องไห้	ร ้ อ ง ไ ห ้
เรียง	เ ร ี ย ง
ข้าม	ข ้ า ม
สังสรรค์	ส ั ง ส ร ร ค ์
ทิ้ง	ท ิ ้ ง
ชู้	ช ู ้
สั่งเสีย	ส ั ่ ง เ ส ี ย
เพื่อน	เ พ ื ่ อ น
รักษา	ร ั ก ษ า
ราชบุรี	ร า ช บ ุ ร ี
มั่นใจ	ม ั ่ น ใ จ
ปิด	ป ิ ด
ชำระ	ช ำ ร ะ
โถง	โ ถ ง
กุล	ก ุ ล
เฮ	เ ฮ
นอย	น อ ย
เมื่อ	เ ม ื ่ อ
ทศ	ท ศ
เขือ	เ ข ื อ
มาก	ม า ก
คำพิพากษา	ค ำ พ ิ พ า ก ษ า
เด็ก	เ ด ็ ก
ลิ่มเลือด	ล ิ ่ ม เ ล ื อ ด
ทิ้ง	ท ิ ้ ง
นูน	น ู น
เยอะ	เ ย อ ะ
นอย	น อ ย
ลิบ	ล ิ บ
กุล	ก ุ ล
การบูร	ก า ร บ ู ร
มาก	ม า ก
จาร	จ า ร
บน	บ น
จาร	จ า ร
สืบทอด	ส ื บ ท อ ด
ม่อน	ม ่ อ น
แฮมสเตอร์	แ ฮ ม ส เ ต อ ร ์
เปิด	เ ป ิ ด
อภิปราย	อ ภ ิ ป ร า ย
รักษา	ร ั ก ษ า
มีเพศสัมพันธ์	ม ี เ พ ศ ส ั ม พ ั น ธ ์
ช่อ	ช ่ อ
ชนิด	ช น ิ ด
นึ่ง	น ึ ่ ง
กาด	ก า ด
เปื่อย	เ ป ื ่ อ ย
หมาป่า	ห ม า ป ่ า
บน	บ น
เด็ก	เ ด ็ ก
นักลงทุน	น ั ก ล ง ท ุ น
ผ้า	ผ ้ า
ผ้า	ผ ้ า
ประจำ	ป ร ะ จ ำ
หม่อน	ห ม ่ อ น
เพื่อน	เ พ ื ่ อ น
สวน	ส ว น
มาก	ม า ก
มิค	ม ิ ค
ความคาดหมาย	ค ว า ม ค า ด ห ม า ย
นอย	น อ ย
เมื่อ	เ ม ื ่ อ
เจ้าค่ะ	เ จ ้ า ค ่ ะ
บน	บ น
ฟู	ฟ ู
ยอดรวม	ย อ ด ร ว ม
เมื่อ	เ ม ื ่ อ
รัม	ร ั ม
ปิด	ป ิ ด
เมื่อ	เ ม ื ่ อ
ตุล	ต ุ ล
หัด	ห ั ด
นึ่ง	น ึ ่ ง
หม้อแปลง	ห ม ้ อ แ ป ล ง
การต่อต้าน	ก า ร ต ่ อ ต ้ า น
นึ่ง	น ึ ่ ง
มาก	ม า ก
สุภาพสตรี	ส ุ ภ า พ ส ต ร ี
ทุ่น	ท ุ ่ น
กะได	ก ะ ไ ด
ถังดับเพลิง	ถ ั ง ด ั บ เ พ ล ิ ง
ยาก	ย า ก
เมื่อ	เ ม ื ่ อ
มาก	ม า ก
ข้าม	ข ้ า ม
บน	บ น
ยาก	ย า ก
อุปสรรค	อ ุ ป ส ร ร ค
สังขาร	ส ั ง ข า ร
แม้	แ ม ้
อิ้ง	อ ิ ้ ง
ข้าม	ข ้ า ม
ดีใจ	ด ี ใ จ
ศาสตร์	ศ า ส ต ร ์
เมื่อ	เ ม ื ่ อ
ยาก	ย า ก
ศิวะ	ศ ิ ว ะ
ปล้อง	ป ล ้ อ ง
ทักษิณ	ท ั ก ษ ิ ณ
ยืดหยุ่น	ย ื ด ห ย ุ ่ น
แผ่นดินใหญ่	แ ผ ่ น ด ิ น ใ ห ญ ่
ตุล	ต ุ ล
นอย	น อ ย
จาร	จ า ร
ธิดา	ธ ิ ด า
มาเล	ม า เ ล
แพ่ง	แ พ ่ ง
ปราจีนบุรี	ป ร า จ ี น บ ุ ร ี
วิ่ง	ว ิ ่ ง
ทึบ	ท ึ บ
ทศ	ท ศ
แนะนำ	แ น ะ น ำ
เปิด	เ ป ิ ด
ปราก	ป ร า ก
ยูง	ย ู ง
ครู่	ค ร ู ่
ฝั่ง	ฝ ั ่ ง
ตรรกะ	ต ร ร ก ะ
อภัย	อ ภ ั ย
รักษา	ร ั ก ษ า
คริสเตียน	ค ร ิ ส เ ต ี ย น
บน	บ น
ยาก	ย า ก
เลื่อย	เ ล ื ่ อ ย
ความคาดหมาย	ค ว า ม ค า ด ห ม า ย
จาร	จ า ร
สีไม้	ส ี ไ ม ้
ปิด	ป ิ ด
แนะนำ	แ น ะ น ำ
ศาสตร์	ศ า ส ต ร ์
วรรณ	ว ร ร ณ
นึ่ง	น ึ ่ ง
เยีย	เ ย ี ย
ดีเจ	ด ี เ จ
เยอะ	เ ย อ ะ
สโมสร	ส โ ม ส ร
ยาก	ย า ก
นิวเคลียร์	น ิ ว เ ค ล ี ย ร ์
อัตราส่วน	อ ั ต ร า ส ่ ว น
ยาก	ย า ก
ประจำ	ป ร ะ จ ำ
ทศ	ท ศ
ทศ	ท ศ
ทุกที	ท ุ ก ท ี
เมื่อ	เ ม ื ่ อ
กานต์	ก า น ต ์
ประจำ	ป ร ะ จ ำ
นึ่ง	น ึ ่ ง
มาก	ม า ก
นอย	น อ ย
ร้านอาหาร	ร ้ า น อ า ห า ร
ทางลัด	ท า ง ล ั ด
เฮ	เ ฮ
ถุงยาง	ถ ุ ง ย า ง
เท่าไหร่	เ ท ่ า ไ ห ร ่
สนิม	ส น ิ ม
มาก	ม า ก
สวน	ส ว น
เบอร์เกอร์	เ บ อ ร ์ เ ก อ ร ์
เด็ก	เ ด ็ ก
ขนมหวาน	ข น ม ห ว า น
เพื่อน	เ พ ื ่ อ น
การสัมมนา	ก า ร ส ั ม ม น า
นอย	น อ ย
เมื่อ	เ ม ื ่ อ
ไวยากรณ์	ไ ว ย า ก ร ณ ์
เพื่อน	เ พ ื ่ อ น
ปิด	ป ิ ด
เมื่อ	เ ม ื ่ อ
ทรัมป์	ท ร ั ม ป ์
เมื่อ	เ ม ื ่ อ
โรงหนัง	โ ร ง ห น ั ง
คดี	ค ด ี
เปิด	เ ป ิ ด
กระซิบ	ก ร ะ ซ ิ บ
การจัด	ก า ร จ ั ด
ปรบมือ	ป ร บ ม ื อ
ไก่	ไ ก ่
จาร	จ า ร
ชอบธรรม	ช อ บ ธ ร ร ม
ศาสตร์	ศ า ส ต ร ์
กาง	ก า ง
หล่ม	ห ล ่ ม
แซบ	แ ซ บ
มาก	ม า ก
มวยไทย	ม ว ย ไ ท ย
สุม	ส ุ ม
เจาะ	เ จ า ะ
นึ่ง	น ึ ่ ง
อินซูลิน	อ ิ น ซ ู ล ิ น
เพื่อน	เ พ ื ่ อ น
ชนิด	ช น ิ ด
ประคอง	ป ร ะ ค อ ง
พูด	พ ู ด
ความมืด	ค ว า ม ม ื ด
เนรมิต	เ น ร ม ิ ต
นึ่ง	น ึ ่ ง
เลขา	เ ล ข า
เมื่อ	เ ม ื ่ อ
เมื่อ	เ ม ื ่ อ
ฟู	ฟ ู
บน	บ น
ตะโก	ต ะ โ ก
การมี	ก า ร ม ี
เงื่อน	เ ง ื ่ อ น
ยาก	ย า ก
ร็อก	ร ็ อ ก
น้ำพุ	น ้ ำ พ ุ
ทศ	ท ศ
เมื่อ	เ ม ื ่ อ
ทศ	ท ศ
รับประทาน	ร ั บ ป ร ะ ท า น
เมลเบิร์น	เ ม ล เ บ ิ ร ์ น
มาก	ม า ก
คดี	ค ด ี
เขือ	เ ข ื อ
เปิด	เ ป ิ ด
เอมิเรตส์	เ อ ม ิ เ ร ต ส ์
ปิด	ป ิ ด
ข้าม	ข ้ า ม
ยาก	ย า ก
กระดูกเชิงกราน	ก ร ะ ด ู ก เ ช ิ ง ก ร า น
รักษา	ร ั ก ษ า
มะรุ	ม ะ ร ุ
ครู่	ค ร ู ่
จอภาพ	จ อ ภ า พ
ไหวพริบ	ไ ห ว พ ร ิ บ
เซลฟี่	เ ซ ล ฟ ี ่
กินี	ก ิ น ี
สุญญากาศ	ส ุ ญ ญ า ก า ศ
นอย	น อ ย
กาญจนบุรี	ก า ญ จ น บ ุ ร ี
ห้องทดลอง	ห ้ อ ง ท ด ล อ ง
ทาย	ท า ย
เจาะ	เ จ า ะ
ประคอง	ป ร ะ ค อ ง
นักลงทุน	น ั ก ล ง ท ุ น
เด็ก	เ ด ็ ก
อึ้ง	อ ึ ้ ง
สมมติ	ส ม ม ต ิ
ไหล่	ไ ห ล ่
แม้	แ ม ้
แนะนำ	แ น ะ น ำ
สถานที่	ส ถ า น ท ี ่
ดาย	ด า ย
ปิด	ป ิ ด
ดีเจ	ด ี เ จ
เกาลัด	เ ก า ล ั ด
ข้าม	ข ้ า ม
เปิด	เ ป ิ ด
อภัย	อ ภ ั ย
ดำน้ำ	ด ำ น ้ ำ
มาก	ม า ก
ผู้สนับสนุน	ผ ู ้ ส น ั บ ส น ุ น
หมาด	ห ม า ด
ทศ	ท ศ
ปรากฎการณ์	ป ร า ก ฎ ก า ร ณ ์
ประชาธิปัตย์	ป ร ะ ช า ธ ิ ป ั ต ย ์
นอย	น อ ย
ถ้อยคำ	ถ ้ อ ย ค ำ
ข้าม	ข ้ า ม
นึ่ง	น ึ ่ ง
สหพัน	ส ห พ ั น
เยีย	เ ย ี ย
มาก	ม า ก
ทิ้ง	ท ิ ้ ง
โปรโมชั่น	โ ป ร โ ม ช ั ่ น
ข้าวสวย	ข ้ า ว ส ว ย
ปลีก	ป ล ี ก
คชา	ค ช า
มกร	ม ก ร
พูด	พ ู ด
บน	บ น
โปรโมชั่น	โ ป ร โ ม ช ั ่ น
แม่นาง	แ ม ่ น า ง
สถานที่	ส ถ า น ท ี ่
เพื่อน	เ พ ื ่ อ น
เปิด	เ ป ิ ด
โดยสาร	โ ด ย ส า ร
วรรณ	ว ร ร ณ
กิจการ	ก ิ จ ก า ร
เถียง	เ ถ ี ย ง
เมื่อ	เ ม ื ่ อ
นอย	น อ ย
กอง	ก อ ง
ข้ามหัว	ข ้ า ม ห ั ว
เอะใจ	เ อ ะ ใ จ
แม้	แ ม ้
พระองค์	พ ร ะ อ ง ค ์
เพื่อน	เ พ ื ่ อ น
อะลูมิเนียม	อ ะ ล ู ม ิ เ น ี ย ม
รักษา	ร ั ก ษ า
ผู้ชม	ผ ู ้ ช ม
ห้องเครื่อง	ห ้ อ ง เ ค ร ื ่ อ ง
ลบหลู่	ล บ ห ล ู ่
คดี	ค ด ี
กอง	ก อ ง
สถานที่	ส ถ า น ท ี ่
เท่ห์	เ ท ่ ห ์
มาก	ม า ก
ล้น	ล ้ น
กลัด	ก ล ั ด
พฤกษา	พ ฤ ก ษ า
มาก	ม า ก
ประกันชีวิต	ป ร ะ ก ั น ช ี ว ิ ต
จาร	จ า ร
มาก	ม า ก
เมื่อ	เ ม ื ่ อ
ร้านเสริมสวย	ร ้ า น เ ส ร ิ ม ส ว ย
ฟู	ฟ ู
จาร	จ า ร
บน	บ น
คราบหินปูน	ค ร า บ ห ิ น ป ู น
พลุ	พ ล ุ
ปราก	ป ร า ก
บน	บ น
อิสร	อ ิ ส ร
สโมสร	ส โ ม ส ร
สงบ	ส ง บ
อภัย	อ ภ ั ย
รัม	ร ั ม
กุล	ก ุ ล
เท่าไหร่	เ ท ่ า ไ ห ร ่
มวน	ม ว น
ปิด	ป ิ ด
กระดูกเชิงกราน	ก ร ะ ด ู ก เ ช ิ ง ก ร า น
เท่าไหร่	เ ท ่ า ไ ห ร ่
คริสเตียน	ค ร ิ ส เ ต ี ย น
ข้ออักเสบ	ข ้ อ อ ั ก เ ส บ
กลิ่น	ก ล ิ ่ น
วอลเลย์บอล	ว อ ล เ ล ย ์ บ อ ล
ข้าม	ข ้ า ม
ทิ้ง	ท ิ ้ ง
ฉุด	ฉ ุ ด
เต้น	เ ต ้ น
ด้วง	ด ้ ว ง
มกร	ม ก ร
พูด	พ ู ด
ไม่สบาย	ไ ม ่ ส บ า ย
บน	บ น
จำเลย	จ ำ เ ล ย
มาก	ม า ก
นึ่ง	น ึ ่ ง
การบูร	ก า ร บ ู ร
มาก	ม า ก
แกนนำ	แ ก น น ำ
ทศ	ท ศ
ประจำ	ป ร ะ จ ำ
นอย	น อ ย
วิเชียร	ว ิ เ ช ี ย ร
เพื่อน	เ พ ื ่ อ น
เพื่อน	เ พ ื ่ อ น
มกร	ม ก ร
ลิบ	ล ิ บ
ฝั่ง	ฝ ั ่ ง
ปลีก	ป ล ี ก
พูด	พ ู ด
การเคารพ	ก า ร เ ค า ร พ
กะทะ	ก ะ ท ะ
ข้าม	ข ้ า ม
จอน	จ อ น
เคลื่อนที่	เ ค ล ื ่ อ น ท ี ่
ยาก	ย า ก
แม้	แ ม ้
เซ็กส์	เ ซ ็ ก ส ์
เปิด	เ ป ิ ด
สถานที่	ส ถ า น ท ี ่
ข้าม	ข ้ า ม
มาก	ม า ก
ปลีก	ป ล ี ก
เฟค	เ ฟ ค
มาก	ม า ก
เงินตรา	เ ง ิ น ต ร า
บรรยากาศ	บ ร ร ย า ก า ศ
กุล	ก ุ ล
การเชิญ	ก า ร เ ช ิ ญ
ทศ	ท ศ
อิสริยาภรณ์	อ ิ ส ร ิ ย า ภ ร ณ ์
คทา	ค ท า
แนะนำ	แ น ะ น ำ
นอย	น อ ย
ข่มขู่	ข ่ ม ข ู ่
มาก	ม า ก
ติมอร์	ต ิ ม อ ร ์
มาก	ม า ก
กระทิง	ก ร ะ ท ิ ง
เภสัชกร	เ ภ ส ั ช ก ร
กรัม	ก ร ั ม
ฝั่ง	ฝ ั ่ ง
การอนุญาต	ก า ร อ น ุ ญ า ต
ชนิด	ช น ิ ด
ตุล	ต ุ ล
ดีใจ	ด ี ใ จ
มาก	ม า ก
นอย	น อ ย
ปั่น	ป ั ่ น
นอย	น อ ย
มกร	ม ก ร
เจาะ	เ จ า ะ
ทิ้ง	ท ิ ้ ง
ประทับใจ	ป ร ะ ท ั บ ใ จ
ผู้แทน	ผ ู ้ แ ท น
มาก	ม า ก
ยุติ	ย ุ ต ิ
เมื่อ	เ ม ื ่ อ
ขอบพระคุณ	ข อ บ พ ร ะ ค ุ ณ
ย่าม	ย ่ า ม
ไก่	ไ ก ่
ข้าม	ข ้ า ม
ทศ	ท ศ
หมวกนิรภัย	ห ม ว ก น ิ ร ภ ั ย
กุ๊ก	ก ุ ๊ ก
การจัด	ก า ร จ ั ด
รัม	ร ั ม
ลิ่มเลือด	ล ิ ่ ม เ ล ื อ ด
เปิด	เ ป ิ ด
สั่งเสีย	ส ั ่ ง เ ส ี ย
มาก	ม า ก
นารายณ์	น า ร า ย ณ ์
มาก	ม า ก
มาก	ม า ก
เกษียณ	เ ก ษ ี ย ณ
ใจจดใจจ่อ	ใ จ จ ด ใ จ จ ่ อ
จับผิด	จ ั บ ผ ิ ด
การดิ้นรน	ก า ร ด ิ ้ น ร น
สถานที่	ส ถ า น ท ี ่
แนะนำ	แ น ะ น ำ
วรรณ	ว ร ร ณ
เพื่อน	เ พ ื ่ อ น
มาก	ม า ก
การมี	ก า ร ม ี
การเลิก	ก า ร เ ล ิ ก
นอย	น อ ย
สโมสร	ส โ ม ส ร
พื้นบ้าน	พ ื ้ น บ ้ า น
มาเล	ม า เ ล
ช่อ	ช ่ อ
ร่าย	ร ่ า ย
ประจำ	ป ร ะ จ ำ
มาก	ม า ก
รักษา	ร ั ก ษ า
ปราณ	ป ร า ณ
เมื่อ	เ ม ื ่ อ
คนร้าย	ค น ร ้ า ย
เคลื่อนที่	เ ค ล ื ่ อ น ท ี ่
รักษา	ร ั ก ษ า
มาเล	ม า เ ล
กุล	ก ุ ล
ยาก	ย า ก
พูด	พ ู ด
เด็ก	เ ด ็ ก
ทศ	ท ศ
มาก	ม า ก
อภิปราย	อ ภ ิ ป ร า ย
การมี	ก า ร ม ี
อิจฉา	อ ิ จ ฉ า
หม้อน้ำ	ห ม ้ อ น ้ ำ
คทา	ค ท า
เย้ายวน	เ ย ้ า ย ว น
คีย์บอร์ด	ค ี ย ์ บ อ ร ์ ด
แบบฉบับ	แ บ บ ฉ บ ั บ
เปลือกตา	เ ป ล ื อ ก ต า
ทศ	ท ศ
เฮ	เ ฮ
ประจำ	ป ร ะ จ ำ
เยอะ	เ ย อ ะ
มาก	ม า ก
นอย	น อ ย
พระองค์	พ ร ะ อ ง ค ์
ปิด	ป ิ ด
ตะขอ	ต ะ ข อ
เปิด	เ ป ิ ด
ตรรกะ	ต ร ร ก ะ
นึ่ง	น ึ ่ ง
ผ้า	ผ ้ า
โมเดล	โ ม เ ด ล
เมื่อ	เ ม ื ่ อ
แนะนำ	แ น ะ น ำ
ลดราคา	ล ด ร า ค า
การจัด	ก า ร จ ั ด
ลามา	ล า ม า
จาร	จ า ร
เมื่อ	เ ม ื ่ อ
สำเนียง	ส ำ เ น ี ย ง
ไพศาล	ไ พ ศ า ล
ดีวีดี	ด ี ว ี ด ี
อัตราส่วน	อ ั ต ร า ส ่ ว น
ลำเลียง	ล ำ เ ล ี ย ง
ศาสตร์	ศ า ส ต ร ์
รุ้ง	ร ุ ้ ง
มาก	ม า ก
รักษา	ร ั ก ษ า
กร่อน	ก ร ่ อ น
ข้ออักเสบ	ข ้ อ อ ั ก เ ส บ
เยี่ยมเยียน	เ ย ี ่ ย ม เ ย ี ย น
ฆาตกรต่อเนื่อง	ฆ า ต ก ร ต ่ อ เ น ื ่ อ ง
ทิ้ง	ท ิ ้ ง
ฆาตกร	ฆ า ต ก ร
เด็ก	เ ด ็ ก
เมื่อ	เ ม ื ่ อ
ซิว	ซ ิ ว
ธูป	ธ ู ป
บรรยากาศ	บ ร ร ย า ก า ศ
ผ้า	ผ ้ า
สงบ	ส ง บ
พื้นหลัง	พ ื ้ น ห ล ั ง
อภัย	อ ภ ั ย
มาก	ม า ก
กระชาก	ก ร ะ ช า ก
ยาก	ย า ก
มาก	ม า ก
ดีเจ	ด ี เ จ
แม้	แ ม ้
ลูกดอก	ล ู ก ด อ ก
เมื่อ	เ ม ื ่ อ
เฟก	เ ฟ ก
พูด	พ ู ด
สิบสาม	ส ิ บ ส า ม
มกร	ม ก ร
จาร	จ า ร
การประชาสัมพันธ์	ก า ร ป ร ะ ช า ส ั ม พ ั น ธ ์
เคลือบ	เ ค ล ื อ บ
กระชาก	ก ร ะ ช า ก
ข้าม	ข ้ า ม
เพื่อน	เ พ ื ่ อ น
ยาก	ย า ก
ตุล	ต ุ ล
แย่ง	แ ย ่ ง
พูด	พ ู ด
ประจำ	ป ร ะ จ ำ
ช่อ	ช ่ อ
เมื่อ	เ ม ื ่ อ
เต่ง	เ ต ่ ง
ชนิด	ช น ิ ด
ขีดจำกัด	ข ี ด จ ำ ก ั ด
บอดี้	บ อ ด ี ้
ซีรี่ย์	ซ ี ร ี ่ ย ์
การมี	ก า ร ม ี
โปรโมชั่น	โ ป ร โ ม ช ั ่ น
มาก	ม า ก
มาก	ม า ก
ทศ	ท ศ
ดาย	ด า ย
ทศ	ท ศ
บน	บ น
ความเจริญ	ค ว า ม เ จ ร ิ ญ
นักลงทุน	น ั ก ล ง ท ุ น
นึ่ง	น ึ ่ ง
ฟาด	ฟ า ด
ประจำ	ป ร ะ จ ำ
เปิด	เ ป ิ ด
นึ่ง	น ึ ่ ง
ฝันร้าย	ฝ ั น ร ้ า ย
เอี่ยม	เ อ ี ่ ย ม
ทศ	ท ศ
เต้าน้ำ	เ ต ้ า น ้ ำ
ออกเสียง	อ อ ก เ ส ี ย ง
สงบ	ส ง บ
กอง	ก อ ง
พูด	พ ู ด
ชีววิทยา	ช ี ว ว ิ ท ย า
เปิด	เ ป ิ ด
ของกิน	ข อ ง ก ิ น
มาเล	ม า เ ล
นอย	น อ ย
ทศ	ท ศ
ตีกลับ	ต ี ก ล ั บ
ไหล่	ไ ห ล ่
ยาก	ย า ก
ทศ	ท ศ
นึ่ง	น ึ ่ ง
เยอะ	เ ย อ ะ
ไอร์แลนด์	ไ อ ร ์ แ ล น ด ์
ทศ	ท ศ
จาร	จ า ร
มกร	ม ก ร
ช่อ	ช ่ อ
ปราก	ป ร า ก
ชาวนา	ช า ว น า
การจัด	ก า ร จ ั ด
นึ่ง	น ึ ่ ง
ลานจอดรถ	ล า น จ อ ด ร ถ
ทศ	ท ศ
เด็ก	เ ด ็ ก
เปิด	เ ป ิ ด
ธูป	ธ ู ป
เนรมิต	เ น ร ม ิ ต
นอย	น อ ย
มั่นใจ	ม ั ่ น ใ จ
นึ่ง	น ึ ่ ง
มาก	ม า ก
เลขา	เ ล ข า
จาร	จ า ร
ปรนนิบัติ	ป ร น น ิ บ ั ต ิ
นึ่ง	น ึ ่ ง
เพื่อน	เ พ ื ่ อ น
โค้ท	โ ค ้ ท
เซลฟี่	เ ซ ล ฟ ี ่
มาก	ม า ก
ชำระ	ช ำ ร ะ
มาก	ม า ก
โจ๋	โ จ ๋
เชื่อมั่น	เ ช ื ่ อ ม ั ่ น
เยอะ	เ ย อ ะ
นอย	น อ ย
ผ้าขนหนู	ผ ้ า ข น ห น ู
ชนิด	ช น ิ ด
ยาก	ย า ก
๑๔	๑ ๔
อวยพร	อ ว ย พ ร
ออกซิเจน	อ อ ก ซ ิ เ จ น
เปิด	เ ป ิ ด
นอย	น อ ย
มาก	ม า ก
สิบสอง	ส ิ บ ส อ ง
โจน	โ จ น
เพื่อน	เ พ ื ่ อ น
กรัม	ก ร ั ม
ร้านอาหาร	ร ้ า น อ า ห า ร
ทศ	ท ศ
ชนิด	ช น ิ ด
กุล	ก ุ ล
มาก	ม า ก
ข้าม	ข ้ า ม
ลูกศร	ล ู ก ศ ร
เมื่อ	เ ม ื ่ อ
รักษา	ร ั ก ษ า
เดลี	เ ด ล ี
ช่อ	ช ่ อ
ปิด	ป ิ ด
ลำตัว	ล ำ ต ั ว
หลอดไฟ	ห ล อ ด ไ ฟ
ข้าม	ข ้ า ม
ลำตัว	ล ำ ต ั ว
เด็ก	เ ด ็ ก
มั่นใจ	ม ั ่ น ใ จ
เมื่อ	เ ม ื ่ อ
ข้าม	ข ้ า ม
นึ่ง	น ึ ่ ง
การจัด	ก า ร จ ั ด
เด็ก	เ ด ็ ก
ปลีก	ป ล ี ก
ลามา	ล า ม า
แนะนำ	แ น ะ น ำ
เมื่อ	เ ม ื ่ อ
ร้านอาหาร	ร ้ า น อ า ห า ร
บน	บ น
รักษา	ร ั ก ษ า
วิชญ	ว ิ ช ญ
เปิด	เ ป ิ ด
กุล	ก ุ ล
น้ำเต้า	น ้ ำ เ ต ้ า
ประติมากรรม	ป ร ะ ต ิ ม า ก ร ร ม
นูน	น ู น
ทศ	ท ศ
บน	บ น
ร้านอาหาร	ร ้ า น อ า ห า ร
ยาก	ย า ก
ปิด	ป ิ ด
แรงจูงใจ	แ ร ง จ ู ง ใ จ
เมื่อ	เ ม ื ่ อ
โง่	โ ง ่
ตากล้อง	ต า ก ล ้ อ ง
จาร	จ า ร
การมี	ก า ร ม ี
เคลือบ	เ ค ล ื อ บ
การบูร	ก า ร บ ู ร
มกร	ม ก ร
ตะโก	ต ะ โ ก
นอย	น อ ย
มัสยิด	ม ั ส ย ิ ด
พู่	พ ู ่
วิจิตร	ว ิ จ ิ ต ร
ปิด	ป ิ ด
การมี	ก า ร ม ี
กลุ้ม	ก ล ุ ้ ม
กระดาษแข็ง	ก ร ะ ด า ษ แ ข ็ ง
คนงาน	ค น ง า น
ค่าเช่า	ค ่ า เ ช ่ า
มาก	ม า ก
ปิด	ป ิ ด
จาร	จ า ร
อุรุกวัย	อ ุ ร ุ ก ว ั ย
ร้อยเอ็ด	ร ้ อ ย เ อ ็ ด
ข้าม	ข ้ า ม
โปรโมชั่น	โ ป ร โ ม ช ั ่ น
ทศ	ท ศ
ปลอบ	ป ล อ บ
ชาวไร่	ช า ว ไ ร ่
การจัด	ก า ร จ ั ด
ปิด	ป ิ ด
มาก	ม า ก
ยาก	ย า ก
เคลื่อนที่	เ ค ล ื ่ อ น ท ี ่
กอง	ก อ ง
บน	บ น
เงื่อน	เ ง ื ่ อ น
เตียงหัก	เ ต ี ย ง ห ั ก
สถานที่	ส ถ า น ท ี ่
มาก	ม า ก
ปิด	ป ิ ด
บน	บ น
การอำนวย	ก า ร อ ำ น ว ย
ชำระ	ช ำ ร ะ
เมื่อ	เ ม ื ่ อ
มาก	ม า ก
สะเก็ดเงิน	ส ะ เ ก ็ ด เ ง ิ น
เมื่อ	เ ม ื ่ อ
วรรณ	ว ร ร ณ
จาร	จ า ร
นอย	น อ ย
ยาก	ย า ก
สำส่อน	ส ำ ส ่ อ น
ปิด	ป ิ ด
แม้	แ ม ้
รักษา	ร ั ก ษ า
ศาสตร์	ศ า ส ต ร ์
นอย	น อ ย
จาร	จ า ร
ตลาดน้ำ	ต ล า ด น ้ ำ
ทศ	ท ศ
ชาวไร่	ช า ว ไ ร ่
ประทับใจ	ป ร ะ ท ั บ ใ จ
ฝ้าย	ฝ ้ า ย
ฟู	ฟ ู
ลดราคา	ล ด ร า ค า
รังสรรค์	ร ั ง ส ร ร ค ์
มาก	ม า ก
การจัด	ก า ร จ ั ด
มาก	ม า ก
สวน	ส ว น
ปิด	ป ิ ด
นึ่ง	น ึ ่ ง
แนะนำ	แ น ะ น ำ
เชื่อมั่น	เ ช ื ่ อ ม ั ่ น
บน	บ น
นอย	น อ ย
เพื่อน	เ พ ื ่ อ น
เมื่อ	เ ม ื ่ อ
เมื่อ	เ ม ื ่ อ
ปิด	ป ิ ด
แจม	แ จ ม
เต้น	เ ต ้ น
เปิด	เ ป ิ ด
ทศ	ท ศ
เข็ญ	เ ข ็ ญ
บิกินี	บ ิ ก ิ น ี
รองเท้าแตะ	ร อ ง เ ท ้ า แ ต ะ
บน	บ น
ช้อน	ช ้ อ น
เยอะ	เ ย อ ะ
ประจำ	ป ร ะ จ ำ
กลิ่น	ก ล ิ ่ น
เมื่อ	เ ม ื ่ อ
เท่ห์	เ ท ่ ห ์
มาก	ม า ก
เมื่อ	เ ม ื ่ อ
นึ่ง	น ึ ่ ง
กิจการ	ก ิ จ ก า ร
ผ้า	ผ ้ า
นางงาม	น า ง ง า ม
เคลือบ	เ ค ล ื อ บ
โกดัง	โ ก ด ั ง
ปิด	ป ิ ด
กุล	ก ุ ล
ปั่น	ป ั ่ น
ปัสสาวะ	ป ั ส ส า ว ะ
เฮ	เ ฮ
บน	บ น
เตารีด	เ ต า ร ี ด
สถานที่	ส ถ า น ท ี ่
ซิลิคอน	ซ ิ ล ิ ค อ น
นอย	น อ ย
เปิด	เ ป ิ ด
ข้าม	ข ้ า ม
ปิด	ป ิ ด
ข้อเท้า	ข ้ อ เ ท ้ า
ปราณ	ป ร า ณ
เพื่อน	เ พ ื ่ อ น
เปิด	เ ป ิ ด
นึ่ง	น ึ ่ ง
ประทับใจ	ป ร ะ ท ั บ ใ จ
ของว่าง	ข อ ง ว ่ า ง
กุล	ก ุ ล
อดุลยเดช	อ ด ุ ล ย เ ด ช
โปสเตอร์	โ ป ส เ ต อ ร ์
เศียร	เ ศ ี ย ร
ธูป	ธ ู ป
ทศ	ท ศ
รักษา	ร ั ก ษ า
หอการค้า	ห อ ก า ร ค ้ า
คทา	ค ท า
อิ๊ง	อ ิ ๊ ง
ความดำ	ค ว า ม ด ำ
สถานที่	ส ถ า น ท ี ่
ยาก	ย า ก
ศาสตร์	ศ า ส ต ร ์
รัม	ร ั ม
มาเล	ม า เ ล
บน	บ น
กะหล่ำ	ก ะ ห ล ่ ำ
วิชชุ	ว ิ ช ช ุ
ปราณ	ป ร า ณ
ลูกสะใภ้	ล ู ก ส ะ ใ ภ ้
เจาะ	เ จ า ะ
ประจำ	ป ร ะ จ ำ
ที่ใด	ท ี ่ ใ ด
แนะนำ	แ น ะ น ำ
สงบ	ส ง บ
นอย	น อ ย
หมอก	ห ม อ ก
ความผิดหวัง	ค ว า ม ผ ิ ด ห ว ั ง
เด็กสาว	เ ด ็ ก ส า ว
วลี	ว ล ี
จินดา	จ ิ น ด า
ขนส่ง	ข น ส ่ ง
กลิ่น	ก ล ิ ่ น
ช่องท้อง	ช ่ อ ง ท ้ อ ง
ปิด	ป ิ ด
น้ำเต้า	น ้ ำ เ ต ้ า
ชำระ	ช ำ ร ะ
เพื่อน	เ พ ื ่ อ น
หมวก	ห ม ว ก
เยีย	เ ย ี ย
ปลีก	ป ล ี ก
โสม	โ ส ม
ตู่	ต ู ่
บน	บ น
ศาสตร์	ศ า ส ต ร ์
กุล	ก ุ ล
อึ้ง	อ ึ ้ ง
นึ่ง	น ึ ่ ง
ทศ	ท ศ
เด็ก	เ ด ็ ก
ปิด	ป ิ ด
เปย์	เ ป ย ์
คดี	ค ด ี
นอย	น อ ย
เกษียณ	เ ก ษ ี ย ณ
รายปี	ร า ย ป ี
ปิด	ป ิ ด
อ้าง	อ ้ า ง
เดลี	เ ด ล ี
ชาวประมง	ช า ว ป ร ะ ม ง
ขนส่ง	ข น ส ่ ง
กฐิน	ก ฐ ิ น
บน	บ น
มาก	ม า ก
แรงม้า	แ ร ง ม ้ า
ค่ะ	ค ่ ะ
สำนวน	ส ำ น ว น
ปิด	ป ิ ด
มาก	ม า ก
ข้าม	ข ้ า ม
สืบทอด	ส ื บ ท อ ด
ค่ะ	ค ่ ะ
การจัด	ก า ร จ ั ด
แคนาดา	แ ค น า ด า
คงเส้นคงวา	ค ง เ ส ้ น ค ง ว า
รัม	ร ั ม
ใบเสร็จ	ใ บ เ ส ร ็ จ
นึ่ง	น ึ ่ ง
นาวี	น า ว ี
เปิด	เ ป ิ ด
เนรมิต	เ น ร ม ิ ต
เสฉวน	เ ส ฉ ว น
ชนิด	ช น ิ ด
ปราก	ป ร า ก
ห่วงใย	ห ่ ว ง ใ ย
ทศ	ท ศ
แนะนำ	แ น ะ น ำ
การจัด	ก า ร จ ั ด
จอน	จ อ น
บน	บ น
สำเนียง	ส ำ เ น ี ย ง
แม้	แ ม ้
พูด	พ ู ด
มาก	ม า ก
อิสร	อ ิ ส ร
เปลือกตา	เ ป ล ื อ ก ต า
ตัวหนังสือ	ต ั ว ห น ั ง ส ื อ
หมี่	ห ม ี ่
คัมภีร์	ค ั ม ภ ี ร ์
มาก	ม า ก
สถานการณ์ฉุกเฉิน	ส ถ า น ก า ร ณ ์ ฉ ุ ก เ ฉ ิ น
อัตลักษณ์	อ ั ต ล ั ก ษ ณ ์
ผ้าไหม	ผ ้ า ไ ห ม
เด็ก	เ ด ็ ก
เด็ก	เ ด ็ ก
จาร	จ า ร
มาก	ม า ก
ระทึก	ร ะ ท ึ ก
รุ่นน้อง	ร ุ ่ น น ้ อ ง
แนะนำ	แ น ะ น ำ
ความดัน	ค ว า ม ด ั น
อิสริยาภรณ์	อ ิ ส ร ิ ย า ภ ร ณ ์
รักษา	ร ั ก ษ า
คล้ำ	ค ล ้ ำ
กิจการ	ก ิ จ ก า ร
แน่ว	แ น ่ ว
นายจ้าง	น า ย จ ้ า ง
รศ.	ร ศ .
ข้าม	ข ้ า ม
กันชน	ก ั น ช น
ความอ้วน	ค ว า ม อ ้ ว น
บุคคลล้มละลาย	บ ุ ค ค ล ล ้ ม ล ะ ล า ย
ลงชื่อ	ล ง ช ื ่ อ
ชำระ	ช ำ ร ะ
แม้	แ ม ้
กาง	ก า ง
กินี	ก ิ น ี
สถานที่	ส ถ า น ท ี ่
ข้าม	ข ้ า ม
มั่นใจ	ม ั ่ น ใ จ
ทศ	ท ศ
คั่ง	ค ั ่ ง
การจัด	ก า ร จ ั ด
เมื่อ	เ ม ื ่ อ
ประคอง	ป ร ะ ค อ ง
อดุลยเดช	อ ด ุ ล ย เ ด ช
บน	บ น
นึ่ง	น ึ ่ ง
จาร	จ า ร
ความเท่าเทียม	ค ว า ม เ ท ่ า เ ท ี ย ม
บน	บ น
เปิด	เ ป ิ ด
ดาย	ด า ย
ศิริ	ศ ิ ร ิ
ศาสตร์	ศ า ส ต ร ์
ทศ	ท ศ
ฟู	ฟ ู
มาก	ม า ก
กินเมือง	ก ิ น เ ม ื อ ง
สวน	ส ว น
เพื่อน	เ พ ื ่ อ น
กระเช้า	ก ร ะ เ ช ้ า
พรุน	พ ร ุ น
ข้าม	ข ้ า ม
บน	บ น
ร้านอาหาร	ร ้ า น อ า ห า ร
หมวก	ห ม ว ก
ราชบุรี	ร า ช บ ุ ร ี
ทศ	ท ศ
เหลือบ	เ ห ล ื อ บ
ฟู	ฟ ู
เสมหะ	เ ส ม ห ะ
เซรามิก	เ ซ ร า ม ิ ก
กะหล่ำ	ก ะ ห ล ่ ำ
เพื่อน	เ พ ื ่ อ น
การจัด	ก า ร จ ั ด
เฮ	เ ฮ
ปิด	ป ิ ด
กระพริบ	ก ร ะ พ ร ิ บ
แนะนำ	แ น ะ น ำ
ปราก	ป ร า ก
ผ้า	ผ ้ า
ผ้า	ผ ้ า
วิเชียร	ว ิ เ ช ี ย ร
มาก	ม า ก
มาก	ม า ก
รุ่นพี่	ร ุ ่ น พ ี ่
ปราก	ป ร า ก
นึ่ง	น ึ ่ ง
โปรโมชั่น	โ ป ร โ ม ช ั ่ น
อุทัยธานี	อ ุ ท ั ย ธ า น ี
ทิวา	ท ิ ว า
คนเดียว	ค น เ ด ี ย ว
ยาก	ย า ก
ปิด	ป ิ ด
ค้าน	ค ้ า น
เต้น	เ ต ้ น
มาก	ม า ก
การประชาสัมพันธ์	ก า ร ป ร ะ ช า ส ั ม พ ั น ธ ์
รสชาด	ร ส ช า ด
การอธิบาย	ก า ร อ ธ ิ บ า ย
เริ่ด	เ ร ิ ่ ด
ปราจีนบุรี	ป ร า จ ี น บ ุ ร ี
ช่างฝีมือ	ช ่ า ง ฝ ี ม ื อ
ท่าอากาศยาน	ท ่ า อ า ก า ศ ย า น
คนเดียว	ค น เ ด ี ย ว
มาก	ม า ก
เรียง	เ ร ี ย ง
มกร	ม ก ร
ความเพลิดเพลิน	ค ว า ม เ พ ล ิ ด เ พ ล ิ น
ปิด	ป ิ ด
เขื่อง	เ ข ื ่ อ ง
บน	บ น
ไม่สบาย	ไ ม ่ ส บ า ย
ประจำ	ป ร ะ จ ำ
ข้าม	ข ้ า ม
อิสร	อ ิ ส ร
ดอม	ด อ ม
ปิด	ป ิ ด
โอมาน	โ อ ม า น
สัตว์น้ำ	ส ั ต ว ์ น ้ ำ
บน	บ น
เซ็กซี่	เ ซ ็ ก ซ ี ่
เปลือกตา	เ ป ล ื อ ก ต า
สถานที่	ส ถ า น ท ี ่
การมี	ก า ร ม ี
ยาก	ย า ก
นิพนธ์	น ิ พ น ธ ์
เกลือ	เ ก ล ื อ
นอย	น อ ย
ตราด	ต ร า ด
โคม่า	โ ค ม ่ า
เด็ก	เ ด ็ ก
วรรณ	ว ร ร ณ
นึ่ง	น ึ ่ ง
เลขา	เ ล ข า
หัด	ห ั ด
พื้นบ้าน	พ ื ้ น บ ้ า น
สวน	ส ว น
ปิด	ป ิ ด
ร้านอาหาร	ร ้ า น อ า ห า ร
ผ้า	ผ ้ า
มั่นใจ	ม ั ่ น ใ จ
นึ่ง	น ึ ่ ง
โสม	โ ส ม
ข้ามชาติ	ข ้ า ม ช า ต ิ
ภาพประกอบ	ภ า พ ป ร ะ ก อ บ
ปท.	ป ท .
ผู้สอน	ผ ู ้ ส อ น
อัตลักษณ์	อ ั ต ล ั ก ษ ณ ์
เมื่อ	เ ม ื ่ อ
มั่นใจ	ม ั ่ น ใ จ
รับประทาน	ร ั บ ป ร ะ ท า น
เดลี	เ ด ล ี
ชนิด	ช น ิ ด
กอง	ก อ ง
เบิร์น	เ บ ิ ร ์ น
เด็ก	เ ด ็ ก
เงื่อน	เ ง ื ่ อ น
การปฏิรูป	ก า ร ป ฏ ิ ร ู ป
หัก	ห ั ก
คล้ำ	ค ล ้ ำ
เพื่อน	เ พ ื ่ อ น
สงบ	ส ง บ
เงื่อน	เ ง ื ่ อ น
ชัง	ช ั ง
ยาก	ย า ก
เมื่อ	เ ม ื ่ อ
บน	บ น
นึ่ง	น ึ ่ ง
ยาก	ย า ก
แขนเสื้อ	แ ข น เ ส ื ้ อ
อภัย	อ ภ ั ย
ร่ำไห้	ร ่ ำ ไ ห ้
ประจำ	ป ร ะ จ ำ
ศักราช	ศ ั ก ร า ช
อาสน	อ า ส น
นอย	น อ ย
มาก	ม า ก
ทิด	ท ิ ด
ติชม	ต ิ ช ม
แม้	แ ม ้
เท่าไหร่	เ ท ่ า ไ ห ร ่
ช่างไฟฟ้า	ช ่ า ง ไ ฟ ฟ ้ า
เวชศาสตร์	เ ว ช ศ า ส ต ร ์
ล้น	ล ้ น
บน	บ น
มาก	ม า ก
เกษียณ	เ ก ษ ี ย ณ
ฐิติ	ฐ ิ ต ิ
ช่อ	ช ่ อ
แนะนำ	แ น ะ น ำ
เฟื่องฟู	เ ฟ ื ่ อ ง ฟ ู
นึ่ง	น ึ ่ ง
ยาก	ย า ก
เยอะ	เ ย อ ะ
มาก	ม า ก
พุง	พ ุ ง
รากหญ้า	ร า ก ห ญ ้ า
เชอร์รี่	เ ช อ ร ์ ร ี ่
คละ	ค ล ะ
แนะนำ	แ น ะ น ำ
ปิด	ป ิ ด
รักษา	ร ั ก ษ า
ใบไม้ผลิ	ใ บ ไ ม ้ ผ ล ิ
พายุฝน	พ า ย ุ ฝ น
เพื่อน	เ พ ื ่ อ น
ปัสสาวะ	ป ั ส ส า ว ะ
ปิด	ป ิ ด
หวง	ห ว ง
เมื่อ	เ ม ื ่ อ
ธงชัย	ธ ง ช ั ย
การจัด	ก า ร จ ั ด
นึ่ง	น ึ ่ ง
ทศ	ท ศ
จาร	จ า ร
อักษรศาสตร์	อ ั ก ษ ร ศ า ส ต ร ์
กระชาก	ก ร ะ ช า ก
ปิด	ป ิ ด
กอง	ก อ ง
ข้าวต้ม	ข ้ า ว ต ้ ม
พูด	พ ู ด
ปิด	ป ิ ด
เด็ก	เ ด ็ ก
เม็กซิโก	เ ม ็ ก ซ ิ โ ก
สายไฟฟ้า	ส า ย ไ ฟ ฟ ้ า
กาง	ก า ง
เปิด	เ ป ิ ด
ลามา	ล า ม า
ยาก	ย า ก
รักษา	ร ั ก ษ า
นึ่ง	น ึ ่ ง
ศิริ	ศ ิ ร ิ
สมมติ	ส ม ม ต ิ
สวน	ส ว น
เรียง	เ ร ี ย ง
ทศ	ท ศ
นอย	น อ ย
โอมาน	โ อ ม า น
จิงโจ้	จ ิ ง โ จ ้
ทศ	ท ศ
พิพาท	พ ิ พ า ท
ยาก	ย า ก
ช่อ	ช ่ อ
ผู้ชม	ผ ู ้ ช ม
มกร	ม ก ร
แนะนำ	แ น ะ น ำ
จอร์แดน	จ อ ร ์ แ ด น
คดี	ค ด ี
เหล็กดัด	เ ห ล ็ ก ด ั ด
บน	บ น
สามล้อ	ส า ม ล ้ อ
คดี	ค ด ี
ชนิด	ช น ิ ด
เบิร์น	เ บ ิ ร ์ น
ปิด	ป ิ ด
บน	บ น
เรือรบ	เ ร ื อ ร บ
นอย	น อ ย
ทุกที	ท ุ ก ท ี
นอย	น อ ย
แม้	แ ม ้
มาเล	ม า เ ล
ยาก	ย า ก
วิ่ง	ว ิ ่ ง
ประตูน้ำ	ป ร ะ ต ู น ้ ำ
ช่อ	ช ่ อ
เปิด	เ ป ิ ด
มาก	ม า ก
เฟค	เ ฟ ค
ประจำ	ป ร ะ จ ำ
ตากล้อง	ต า ก ล ้ อ ง
รักษา	ร ั ก ษ า
ชนิด	ช น ิ ด
เรียง	เ ร ี ย ง
ความดัน	ค ว า ม ด ั น
มาก	ม า ก
เปิด	เ ป ิ ด
บน	บ น
กวางตุ้ง	ก ว า ง ต ุ ้ ง
ตลาดหลักทรัพย์	ต ล า ด ห ล ั ก ท ร ั พ ย ์
อิสร	อ ิ ส ร
เสย	เ ส ย
สถานที่	ส ถ า น ท ี ่
คชา	ค ช า
ของว่าง	ข อ ง ว ่ า ง
การบูร	ก า ร บ ู ร
เปียกปอน	เ ป ี ย ก ป อ น
ปิด	ป ิ ด
ไพล	ไ พ ล
ปราก	ป ร า ก
เด็ก	เ ด ็ ก
ช่อ	ช ่ อ
สันหลัง	ส ั น ห ล ั ง
เคลือบ	เ ค ล ื อ บ
ค้าน	ค ้ า น
ทศ	ท ศ
พรหมวิหาร	พ ร ห ม ว ิ ห า ร
ยาก	ย า ก
จุน	จ ุ น
ธัญพืช	ธ ั ญ พ ื ช
ชิ่ง	ช ิ ่ ง
เปิด	เ ป ิ ด
ปิด	ป ิ ด
เต้น	เ ต ้ น
ชำระ	ช ำ ร ะ
ผ้า	ผ ้ า
นอย	น อ ย
ซึง	ซ ึ ง
ทาย	ท า ย
ลำคอ	ล ำ ค อ
ดาย	ด า ย
เส้นชัย	เ ส ้ น ช ั ย
นอย	น อ ย
ทั้งวัน	ท ั ้ ง ว ั น
ทศ	ท ศ
สวน	ส ว น
นึ่ง	น ึ ่ ง
เปิด	เ ป ิ ด
เด็ก	เ ด ็ ก
ค้าน	ค ้ า น
บน	บ น
โมเลกุล	โ ม เ ล ก ุ ล
ผ้า	ผ ้ า
พื้นหลัง	พ ื ้ น ห ล ั ง
มนุษยสัมพันธ์	ม น ุ ษ ย ส ั ม พ ั น ธ ์
ศาสตร์	ศ า ส ต ร ์
พันธุ์พืช	พ ั น ธ ุ ์ พ ื ช
ลามา	ล า ม า
ยาก	ย า ก
กลุ้ม	ก ล ุ ้ ม
ทศ	ท ศ
อะลูมิเนียม	อ ะ ล ู ม ิ เ น ี ย ม
ฆาตกร	ฆ า ต ก ร
ความดัน	ค ว า ม ด ั น
นึ่ง	น ึ ่ ง
งัด	ง ั ด
โปสเตอร์	โ ป ส เ ต อ ร ์
ลัทธิ	ล ั ท ธ ิ
ลำเลียง	ล ำ เ ล ี ย ง
มะม่วง	ม ะ ม ่ ว ง
ประจำ	ป ร ะ จ ำ
เจาะ	เ จ า ะ
ทศ	ท ศ
ทิด	ท ิ ด
แล่น	แ ล ่ น
บน	บ น
เคลื่อนที่	เ ค ล ื ่ อ น ท ี ่
เผชิญหน้า	เ ผ ช ิ ญ ห น ้ า
วรรณ	ว ร ร ณ
การจัด	ก า ร จ ั ด
อัยการ	อ ั ย ก า ร
มั่นใจ	ม ั ่ น ใ จ
แคมป์	แ ค ม ป ์
ศาสตร์	ศ า ส ต ร ์
ยิ้มแย้มแจ่มใส	ย ิ ้ ม แ ย ้ ม แ จ ่ ม ใ ส
บน	บ น
เมืองนอก	เ ม ื อ ง น อ ก
บน	บ น
มาก	ม า ก
ครั้งนั้น	ค ร ั ้ ง น ั ้ น
บ่ม	บ ่ ม
นึ่ง	น ึ ่ ง
นึ่ง	น ึ ่ ง
ยาก	ย า ก
ไพลิน	ไ พ ล ิ น
ปิด	ป ิ ด
เยอะ	เ ย อ ะ
แนะนำ	แ น ะ น ำ
มาก	ม า ก
ค่านิยม	ค ่ า น ิ ย ม
มาก	ม า ก
แรงจูงใจ	แ ร ง จ ู ง ใ จ
การจัด	ก า ร จ ั ด
นายแพทย์	น า ย แ พ ท ย ์
วอด	ว อ ด
มาเล	ม า เ ล
จักรพรรดิ	จ ั ก ร พ ร ร ด ิ
กลิ่น	ก ล ิ ่ น
เมื่อ	เ ม ื ่ อ
ราชบุรี	ร า ช บ ุ ร ี
มกร	ม ก ร
ดิ้นรน	ด ิ ้ น ร น
ทศ	ท ศ
ช่อ	ช ่ อ
เฮ	เ ฮ
ความซับซ้อน	ค ว า ม ซ ั บ ซ ้ อ น
ร่างทรง	ร ่ า ง ท ร ง
หนาม	ห น า ม
นึ่ง	น ึ ่ ง
คดี	ค ด ี
จัตุรัส	จ ั ต ุ ร ั ส
คล้ำ	ค ล ้ ำ
ทศ	ท ศ
แนะนำ	แ น ะ น ำ
เมื่อ	เ ม ื ่ อ
ปราก	ป ร า ก
เหล็กดัด	เ ห ล ็ ก ด ั ด
เมื่อ	เ ม ื ่ อ
เปิด	เ ป ิ ด
มาก	ม า ก
กาญจนบุรี	ก า ญ จ น บ ุ ร ี
ปิด	ป ิ ด
ทศ	ท ศ
เพื่อน	เ พ ื ่ อ น
ชนิด	ช น ิ ด
กิจการ	ก ิ จ ก า ร
หม่อมหลวง	ห ม ่ อ ม ห ล ว ง
อภัย	อ ภ ั ย
ยาก	ย า ก
ดาย	ด า ย
รักษา	ร ั ก ษ า
ลำคอ	ล ำ ค อ
มะตูม	ม ะ ต ู ม
อภัย	อ ภ ั ย
ช่อ	ช ่ อ
กุล	ก ุ ล
แนะนำ	แ น ะ น ำ
บน	บ น
มาก	ม า ก
บน	บ น
พายุ	พ า ย ุ
นอย	น อ ย
ตัวเชื่อม	ต ั ว เ ช ื ่ อ ม
ใบ้	ใ บ ้
ช่องว่าง	ช ่ อ ง ว ่ า ง
เมื่อ	เ ม ื ่ อ
ขอบพระคุณ	ข อ บ พ ร ะ ค ุ ณ
โบว์	โ บ ว ์
เยอะ	เ ย อ ะ
เมื่อ	เ ม ื ่ อ
ยาก	ย า ก
ชำระ	ช ำ ร ะ
ทรงตัว	ท ร ง ต ั ว
บน	บ น
พระองค์	พ ร ะ อ ง ค ์
ยาก	ย า ก
รถยก	ร ถ ย ก
ทั้งวัน	ท ั ้ ง ว ั น
จาร	จ า ร
กิจการ	ก ิ จ ก า ร
เมื่อ	เ ม ื ่ อ
โง่	โ ง ่
พยานหลักฐาน	พ ย า น ห ล ั ก ฐ า น
ค่ะ	ค ่ ะ
เลขา	เ ล ข า
ฮานอย	ฮ า น อ ย
เก็บเกี่ยว	เ ก ็ บ เ ก ี ่ ย ว
บน	บ น
ปิด	ป ิ ด
ผ้าไหม	ผ ้ า ไ ห ม
ร้านอาหาร	ร ้ า น อ า ห า ร
จาร	จ า ร
บน	บ น
เผชิญหน้า	เ ผ ช ิ ญ ห น ้ า
รักษา	ร ั ก ษ า
กลีบ	ก ล ี บ
แน่วแน่	แ น ่ ว แ น ่
นึ่ง	น ึ ่ ง
ยาก	ย า ก
เปิด	เ ป ิ ด
การโจมตี	ก า ร โ จ ม ต ี
มาก	ม า ก
บน	บ น
มกร	ม ก ร
ข้าม	ข ้ า ม
ยิว	ย ิ ว
ศิริ	ศ ิ ร ิ
ตุล	ต ุ ล
เด็ก	เ ด ็ ก
เพ้อ	เ พ ้ อ
จาร	จ า ร
รักษา	ร ั ก ษ า
แนะนำ	แ น ะ น ำ
นึ่ง	น ึ ่ ง
เสียงอ่าน	เ ส ี ย ง อ ่ า น
แม้	แ ม ้
ศาลเจ้า	ศ า ล เ จ ้ า
มาก	ม า ก
บรรยากาศ	บ ร ร ย า ก า ศ
แอก	แ อ ก
ผ้า	ผ ้ า
เท่าไหร่	เ ท ่ า ไ ห ร ่
สแควร์	ส แ ค ว ร ์
สีห์	ส ี ห ์
เมื่อ	เ ม ื ่ อ
กล้องถ่ายภาพ	ก ล ้ อ ง ถ ่ า ย ภ า พ
บัลลังก์	บ ั ล ล ั ง ก ์
คดี	ค ด ี
เนื้อเยื่อ	เ น ื ้ อ เ ย ื ่ อ
บน	บ น
ช่อ	ช ่ อ
อวกาศ	อ ว ก า ศ
บัลลังก์	บ ั ล ล ั ง ก ์
ค่ะ	ค ่ ะ
แม้	แ ม ้
ครั้งนั้น	ค ร ั ้ ง น ั ้ น
ริ้วรอย	ร ิ ้ ว ร อ ย
ปิด	ป ิ ด
เบิกบาน	เ บ ิ ก บ า น
ปิด	ป ิ ด
ปิด	ป ิ ด
มกร	ม ก ร
จอร์แดน	จ อ ร ์ แ ด น
นึ่ง	น ึ ่ ง
หลานชาย	ห ล า น ช า ย
ยาก	ย า ก
มาก	ม า ก
จินดา	จ ิ น ด า
มาก	ม า ก
เยอะ	เ ย อ ะ
มาก	ม า ก
แนะนำ	แ น ะ น ำ
แนะนำ	แ น ะ น ำ
วุ้น	ว ุ ้ น
ข้าม	ข ้ า ม
นอย	น อ ย
ยาก	ย า ก
ทศ	ท ศ
มาก	ม า ก
พูด	พ ู ด
รักษา	ร ั ก ษ า
แม้	แ ม ้
เพื่อน	เ พ ื ่ อ น
แอปเปิ้ล	แ อ ป เ ป ิ ้ ล
มุ้ง	ม ุ ้ ง
สายไฟฟ้า	ส า ย ไ ฟ ฟ ้ า
การจัด	ก า ร จ ั ด
ร้อนใน	ร ้ อ น ใ น
โปรโมชั่น	โ ป ร โ ม ช ั ่ น
ผู้แทน	ผ ู ้ แ ท น
แม้	แ ม ้
ปิด	ป ิ ด
ปิด	ป ิ ด
หมวก	ห ม ว ก
การนอนหลับ	ก า ร น อ น ห ล ั บ
สโมสร	ส โ ม ส ร
หอการค้า	ห อ ก า ร ค ้ า
ทิ้ง	ท ิ ้ ง
มาก	ม า ก
ยาก	ย า ก
สถานที่	ส ถ า น ท ี ่
รักษา	ร ั ก ษ า
ข้าม	ข ้ า ม
อิสร	อ ิ ส ร
แสงอาทิตย์	แ ส ง อ า ท ิ ต ย ์
ศาสตร์	ศ า ส ต ร ์
ทศ	ท ศ
ผ้าไหม	ผ ้ า ไ ห ม
ปิด	ป ิ ด
หิมาลัย	ห ิ ม า ล ั ย
ทศ	ท ศ
กางเกง	ก า ง เ ก ง
เมื่อ	เ ม ื ่ อ
กิจการ	ก ิ จ ก า ร
ศาสตร์	ศ า ส ต ร ์
มกร	ม ก ร
เมื่อ	เ ม ื ่ อ
จุ่ม	จ ุ ่ ม
นอย	น อ ย
โปรโมชั่น	โ ป ร โ ม ช ั ่ น
เมื่อ	เ ม ื ่ อ
ห้วง	ห ้ ว ง
เงื่อน	เ ง ื ่ อ น
ไก่	ไ ก ่
ไล่ออก	ไ ล ่ อ อ ก
ยาก	ย า ก
จ้ะ	จ ้ ะ
การรับมือ	ก า ร ร ั บ ม ื อ
บางกอก	บ า ง ก อ ก
เช่นเคย	เ ช ่ น เ ค ย
เครื่องซักผ้า	เ ค ร ื ่ อ ง ซ ั ก ผ ้ า
คั่ง	ค ั ่ ง
ป.ป.ช.	ป . ป . ช .
บน	บ น
อธิษฐาน	อ ธ ิ ษ ฐ า น
ไก่	ไ ก ่
หมอก	ห ม อ ก
บน	บ น
บน	บ น
เกลือ	เ ก ล ื อ
นึ่ง	น ึ ่ ง
ปิด	ป ิ ด
เลขา	เ ล ข า
สวัสดิภาพ	ส ว ั ส ด ิ ภ า พ
เมื่อ	เ ม ื ่ อ
เด็ก	เ ด ็ ก
จาร	จ า ร
ขอบพระคุณ	ข อ บ พ ร ะ ค ุ ณ
แนะนำ	แ น ะ น ำ
เมื่อ	เ ม ื ่ อ
น็อก	น ็ อ ก
บน	บ น
ทศ	ท ศ
รักษา	ร ั ก ษ า
บรรเลง	บ ร ร เ ล ง
ชิ่ง	ช ิ ่ ง
ไก่	ไ ก ่
มาก	ม า ก
นึ่ง	น ึ ่ ง
ไวยากรณ์	ไ ว ย า ก ร ณ ์
พูด	พ ู ด
ปิด	ป ิ ด
ทิ้ง	ท ิ ้ ง
จาร	จ า ร
พจน์	พ จ น ์
สโมสร	ส โ ม ส ร
ชีววิทยา	ช ี ว ว ิ ท ย า
เปิด	เ ป ิ ด
การจัด	ก า ร จ ั ด
ชำระ	ช ำ ร ะ
ผ้า	ผ ้ า
เด็ก	เ ด ็ ก
ช่อ	ช ่ อ
แม่พิมพ์	แ ม ่ พ ิ ม พ ์
แม้	แ ม ้
แน่ชัด	แ น ่ ช ั ด
ช่อ	ช ่ อ
ไก่	ไ ก ่
เมื่อ	เ ม ื ่ อ
พูด	พ ู ด
ยุติ	ย ุ ต ิ
บน	บ น
เงินตรา	เ ง ิ น ต ร า
ปัสสาวะ	ป ั ส ส า ว ะ
ทศ	ท ศ
หลอดไฟ	ห ล อ ด ไ ฟ
มอนเตเนโกร	ม อ น เ ต เ น โ ก ร
บน	บ น
บรรยากาศ	บ ร ร ย า ก า ศ
มั่นใจ	ม ั ่ น ใ จ
ทศ	ท ศ
ยาก	ย า ก
การแห่	ก า ร แ ห ่
เจาะ	เ จ า ะ
คดี	ค ด ี
โรมัน	โ ร ม ั น
ยาก	ย า ก
ประมง	ป ร ะ ม ง
ศาสตร์	ศ า ส ต ร ์
ค้าน	ค ้ า น
สโมสร	ส โ ม ส ร
มุข	ม ุ ข
เพื่อน	เ พ ื ่ อ น
แสงอาทิตย์	แ ส ง อ า ท ิ ต ย ์
ปิด	ป ิ ด
ศาสตร์	ศ า ส ต ร ์
เหลือบ	เ ห ล ื อ บ
ตำหนิ	ต ำ ห น ิ
ยาก	ย า ก
ปลอบ	ป ล อ บ
คนค้า	ค น ค ้ า
เต้น	เ ต ้ น
อยุติธรรม	อ ย ุ ต ิ ธ ร ร ม
สมัน	ส ม ั น
ยาก	ย า ก
เมื่อ	เ ม ื ่ อ
๑๗	๑ ๗
ศาสตร์	ศ า ส ต ร ์
ผักกาดหอม	ผ ั ก ก า ด ห อ ม
มาก	ม า ก
กราด	ก ร า ด
ล้น	ล ้ น
เฮ	เ ฮ
ช่อ	ช ่ อ
นึ่ง	น ึ ่ ง
เมื่อ	เ ม ื ่ อ
วรรณ	ว ร ร ณ
มาก	ม า ก
เมื่อ	เ ม ื ่ อ
หอศิลป์	ห อ ศ ิ ล ป ์
บน	บ น
การเฝ้า	ก า ร เ ฝ ้ า
พูด	พ ู ด
ทศ	ท ศ
วงแหวน	ว ง แ ห ว น
ข้าม	ข ้ า ม
พูด	พ ู ด
กอง	ก อ ง
แม้	แ ม ้
กระทง	ก ร ะ ท ง
นอย	น อ ย
เนื้อเยื่อ	เ น ื ้ อ เ ย ื ่ อ
แม้	แ ม ้
มาเล	ม า เ ล
เปิด	เ ป ิ ด
โปรโมชั่น	โ ป ร โ ม ช ั ่ น
เตารีด	เ ต า ร ี ด
เพื่อน	เ พ ื ่ อ น
บน	บ น
เฮ	เ ฮ
สิ้นสุด	ส ิ ้ น ส ุ ด
เด็ก	เ ด ็ ก
ฝั่ง	ฝ ั ่ ง
ตะขอ	ต ะ ข อ
ปิงปอง	ป ิ ง ป อ ง
นึ่ง	น ึ ่ ง
นายจ้าง	น า ย จ ้ า ง
เร้าใจ	เ ร ้ า ใ จ
ปราก	ป ร า ก
น้ำพริก	น ้ ำ พ ร ิ ก
ผ้า	ผ ้ า
รักษา	ร ั ก ษ า
เซเลบ	เ ซ เ ล บ
เฮ	เ ฮ
บรรยากาศ	บ ร ร ย า ก า ศ
สมโภช	ส ม โ ภ ช
บน	บ น
ใฝ่	ใ ฝ ่
จาร	จ า ร
เมื่อ	เ ม ื ่ อ
บน	บ น
ค้าน	ค ้ า น
มอบตัว	ม อ บ ต ั ว
ลำเลียง	ล ำ เ ล ี ย ง
ทึบ	ท ึ บ
แนะนำ	แ น ะ น ำ
ปิด	ป ิ ด
ประจำ	ป ร ะ จ ำ
มาก	ม า ก
ลี้ภัย	ล ี ้ ภ ั ย
เยีย	เ ย ี ย
เมื่อ	เ ม ื ่ อ
เมื่อ	เ ม ื ่ อ
รักษา	ร ั ก ษ า
ปราก	ป ร า ก
บน	บ น
เมื่อ	เ ม ื ่ อ
ทัพเรือ	ท ั พ เ ร ื อ
มุง	ม ุ ง
มาเล	ม า เ ล
คนกรุง	ค น ก ร ุ ง
แผนปฏิบัติ	แ ผ น ป ฏ ิ บ ั ต ิ
เพื่อน	เ พ ื ่ อ น
คาราโอเกะ	ค า ร า โ อ เ ก ะ
เปิด	เ ป ิ ด
เมื่อ	เ ม ื ่ อ
ฝันดี	ฝ ั น ด ี
ยาก	ย า ก
มาก	ม า ก
แนะนำ	แ น ะ น ำ
กลิ่น	ก ล ิ ่ น
ร้านอาหาร	ร ้ า น อ า ห า ร
แม้	แ ม ้
ค้าน	ค ้ า น
ดอกจัน	ด อ ก จ ั น
ทำซ้ำ	ท ำ ซ ้ ำ
เฮ	เ ฮ
ร้านอาหาร	ร ้ า น อ า ห า ร
หูย	ห ู ย
แจกจ่าย	แ จ ก จ ่ า ย
การถ่ายภาพ	ก า ร ถ ่ า ย ภ า พ
เมโทร	เ ม โ ท ร
ติมอร์	ต ิ ม อ ร ์
ระทึก	ร ะ ท ึ ก
เมื่อ	เ ม ื ่ อ
มาก	ม า ก
ข้าม	ข ้ า ม
วัฒนะ	ว ั ฒ น ะ
มาก	ม า ก
พุง	พ ุ ง
น้ำอัดลม	น ้ ำ อ ั ด ล ม
เมื่อ	เ ม ื ่ อ
ทศ	ท ศ
ลดราคา	ล ด ร า ค า
มั่นใจ	ม ั ่ น ใ จ
พูด	พ ู ด
มาก	ม า ก
เปิด	เ ป ิ ด
สหพัน	ส ห พ ั น
นึ่ง	น ึ ่ ง
เมื่อ	เ ม ื ่ อ
ร้อยเอ็ด	ร ้ อ ย เ อ ็ ด
ภู่	ภ ู ่
กระหาย	ก ร ะ ห า ย
แบบจำลอง	แ บ บ จ ำ ล อ ง
มกร	ม ก ร
ผ้า	ผ ้ า
การสวม	ก า ร ส ว ม
เมื่อ	เ ม ื ่ อ
แม้	แ ม ้
ข่มขู่	ข ่ ม ข ู ่
มาก	ม า ก
ยาก	ย า ก
ข้าม	ข ้ า ม
ทศ	ท ศ
สวนน้ำ	ส ว น น ้ ำ
พระราชกฤษฎีกา	พ ร ะ ร า ช ก ฤ ษ ฎ ี ก า
ทรงผม	ท ร ง ผ ม
แม้	แ ม ้
รักษา	ร ั ก ษ า
ดาม	ด า ม
ศาสตร์	ศ า ส ต ร ์
การจัด	ก า ร จ ั ด
เนตร	เ น ต ร
เอี่ยม	เ อ ี ่ ย ม
รักษา	ร ั ก ษ า
ปิด	ป ิ ด
สถานที่	ส ถ า น ท ี ่
เยอะ	เ ย อ ะ
เด็ก	เ ด ็ ก
มาก	ม า ก
อวกาศ	อ ว ก า ศ
โถง	โ ถ ง
หัก	ห ั ก
หยาด	ห ย า ด
เมื่อ	เ ม ื ่ อ
ดีใจ	ด ี ใ จ
บริดจ์	บ ร ิ ด จ ์
จาร	จ า ร
โซเวียต	โ ซ เ ว ี ย ต
สันติภาพ	ส ั น ต ิ ภ า พ
น้ำย่อย	น ้ ำ ย ่ อ ย
เนเธอร์แลนด์	เ น เ ธ อ ร ์ แ ล น ด ์
สงบ	ส ง บ
กระทง	ก ร ะ ท ง
นอย	น อ ย
สี่เหลี่ยมคางหมู	ส ี ่ เ ห ล ี ่ ย ม ค า ง ห ม ู
เปิด	เ ป ิ ด
ปรบ	ป ร บ
เปิด	เ ป ิ ด
ซุง	ซ ุ ง
เหยียด	เ ห ย ี ย ด
ยาก	ย า ก
เหยียด	เ ห ย ี ย ด
ข้าม	ข ้ า ม
จักรพรรดิ	จ ั ก ร พ ร ร ด ิ
นึ่ง	น ึ ่ ง
เปิด	เ ป ิ ด
ข้าวสวย	ข ้ า ว ส ว ย
บรรยากาศ	บ ร ร ย า ก า ศ
ข้าม	ข ้ า ม
เมื่อ	เ ม ื ่ อ
เศรษฐศาสตร์	เ ศ ร ษ ฐ ศ า ส ต ร ์
ประจำ	ป ร ะ จ ำ
ประท้วง	ป ร ะ ท ้ ว ง
ซีรีย์	ซ ี ร ี ย ์
พูด	พ ู ด
มาก	ม า ก
ไฟหน้า	ไ ฟ ห น ้ า
เมื่อ	เ ม ื ่ อ
แนะนำ	แ น ะ น ำ
นอย	น อ ย
ผ้า	ผ ้ า
เชื่อมั่น	เ ช ื ่ อ ม ั ่ น
มลภาวะ	ม ล ภ า ว ะ
นอย	น อ ย
คนเดียว	ค น เ ด ี ย ว
หัวหอม	ห ั ว ห อ ม
เฮ	เ ฮ
นายจ้าง	น า ย จ ้ า ง
ปิติ	ป ิ ต ิ
นึ่ง	น ึ ่ ง
ทราบฝ่าละอองธุลีพระบาท	ท ร า บ ฝ ่ า ล ะ อ อ ง ธ ุ ล ี พ ร ะ บ า ท
อ้าง	อ ้ า ง
เงินตรา	เ ง ิ น ต ร า
ปิด	ป ิ ด
ชัง	ช ั ง
จาร	จ า ร
ปลาบปลื้ม	ป ล า บ ป ล ื ้ ม
ชำระ	ช ำ ร ะ
หนาม	ห น า ม
หัด	ห ั ด
ฐิติ	ฐ ิ ต ิ
ฟู	ฟ ู
คดี	ค ด ี
เลอะ	เ ล อ ะ
เวชศาสตร์	เ ว ช ศ า ส ต ร ์
จาร	จ า ร
บน	บ น
การเผา	ก า ร เ ผ า
เหนือธรรมชาติ	เ ห น ื อ ธ ร ร ม ช า ต ิ
เชื่อมั่น	เ ช ื ่ อ ม ั ่ น
คนเดียว	ค น เ ด ี ย ว
เพื่อน	เ พ ื ่ อ น
สวน	ส ว น
ใฝ่	ใ ฝ ่
แคว้น	แ ค ว ้ น
ปั่น	ป ั ่ น
จอน	จ อ น
เจาะ	เ จ า ะ
ทศ	ท ศ
ปิด	ป ิ ด
มาก	ม า ก
เมื่อ	เ ม ื ่ อ
นึ่ง	น ึ ่ ง
เคลือบ	เ ค ล ื อ บ
เปิด	เ ป ิ ด
เจาะ	เ จ า ะ
ภาพประกอบ	ภ า พ ป ร ะ ก อ บ
เด็ก	เ ด ็ ก
นึ่ง	น ึ ่ ง
อ้าง	อ ้ า ง
เด็ก	เ ด ็ ก
จำคุก	จ ำ ค ุ ก
มาก	ม า ก
ความเพลิดเพลิน	ค ว า ม เ พ ล ิ ด เ พ ล ิ น
ทศ	ท ศ
ทิ้ง	ท ิ ้ ง
น้ำทิ้ง	น ้ ำ ท ิ ้ ง
สัมนา	ส ั ม น า
ทศ	ท ศ
เพื่อน	เ พ ื ่ อ น
ราชบุรี	ร า ช บ ุ ร ี
ตุล	ต ุ ล
ตั้งโต๊ะ	ต ั ้ ง โ ต ๊ ะ
ประทับใจ	ป ร ะ ท ั บ ใ จ
ฟู	ฟ ู
ซิว	ซ ิ ว
อารยะ	อ า ร ย ะ
จั่ว	จ ั ่ ว
ฝั่ง	ฝ ั ่ ง
เพื่อน	เ พ ื ่ อ น
ประจำ	ป ร ะ จ ำ
ข้าม	ข ้ า ม
โครต	โ ค ร ต
การมี	ก า ร ม ี
วิตกกังวล	ว ิ ต ก ก ั ง ว ล
ทศ	ท ศ
ข้ออ้าง	ข ้ อ อ ้ า ง
อธิษฐาน	อ ธ ิ ษ ฐ า น
ภาพประกอบ	ภ า พ ป ร ะ ก อ บ
ยาก	ย า ก
การทำอาหาร	ก า ร ท ำ อ า ห า ร
เป็นห่วง	เ ป ็ น ห ่ ว ง
ไพล	ไ พ ล
ประทับใจ	ป ร ะ ท ั บ ใ จ
ผ่อง	ผ ่ อ ง
เบิร์น	เ บ ิ ร ์ น
นึ่ง	น ึ ่ ง
กาง	ก า ง
มกร	ม ก ร
ช่อ	ช ่ อ
ตื่นตัว	ต ื ่ น ต ั ว
คดี	ค ด ี
น้ำพุ	น ้ ำ พ ุ
นอย	น อ ย
ข้าม	ข ้ า ม
โปรโมชั่น	โ ป ร โ ม ช ั ่ น
คนเดียว	ค น เ ด ี ย ว
หูก	ห ู ก
จาร	จ า ร
ยาก	ย า ก
ศาสตร์	ศ า ส ต ร ์
หิมาลัย	ห ิ ม า ล ั ย
วิเชียร	ว ิ เ ช ี ย ร
เงื่อน	เ ง ื ่ อ น
ร่าย	ร ่ า ย
รัม	ร ั ม
หัก	ห ั ก
เมื่อ	เ ม ื ่ อ
ช่อ	ช ่ อ
ชำระ	ช ำ ร ะ
กรัม	ก ร ั ม
ศาสตร์	ศ า ส ต ร ์
ความคม	ค ว า ม ค ม
ยาก	ย า ก
เมื่อ	เ ม ื ่ อ
ปิด	ป ิ ด
ทศ	ท ศ
รักษา	ร ั ก ษ า
กาฬสินธุ์	ก า ฬ ส ิ น ธ ุ ์
ดำน้ำ	ด ำ น ้ ำ
ดาม	ด า ม
สิบสอง	ส ิ บ ส อ ง
ขัดขวาง	ข ั ด ข ว า ง
ช่อ	ช ่ อ
พูด	พ ู ด
แนะนำ	แ น ะ น ำ
ประจำ	ป ร ะ จ ำ
โปรดเกล้าฯ	โ ป ร ด เ ก ล ้ า ฯ
รัฐวิสาหกิจ	ร ั ฐ ว ิ ส า ห ก ิ จ
ติดเตียง	ต ิ ด เ ต ี ย ง
ปราก	ป ร า ก
แนะนำ	แ น ะ น ำ
ยาก	ย า ก
ฟาด	ฟ า ด
รักษาการ	ร ั ก ษ า ก า ร
ศิริ	ศ ิ ร ิ
จาร	จ า ร
หรีด	ห ร ี ด
มาก	ม า ก
คชา	ค ช า
เรียง	เ ร ี ย ง
ผ้า	ผ ้ า
ตัดต่อ	ต ั ด ต ่ อ
ประจำ	ป ร ะ จ ำ
ไก่	ไ ก ่
ผ้า	ผ ้ า
ข้าม	ข ้ า ม
วิตกกังวล	ว ิ ต ก ก ั ง ว ล
ร่าน	ร ่ า น
ทศ	ท ศ
เยอะ	เ ย อ ะ
แม้	แ ม ้
มั่นใจ	ม ั ่ น ใ จ
เปิด	เ ป ิ ด
ทศ	ท ศ
สถานที่	ส ถ า น ท ี ่
แนะนำ	แ น ะ น ำ
กัวลาลัมเปอร์	ก ั ว ล า ล ั ม เ ป อ ร ์
เคลื่อนที่	เ ค ล ื ่ อ น ท ี ่
เด็ก	เ ด ็ ก
ความสับสน	ค ว า ม ส ั บ ส น
มาก	ม า ก
เมื่อ	เ ม ื ่ อ
แมง	แ ม ง
พูด	พ ู ด
โยม	โ ย ม
วรรณยุกต์	ว ร ร ณ ย ุ ก ต ์
แบบฉบับ	แ บ บ ฉ บ ั บ
ทาสี	ท า ส ี
เขือ	เ ข ื อ
นักการเมือง	น ั ก ก า ร เ ม ื อ ง
ทางแยก	ท า ง แ ย ก
สบง	ส บ ง
ทศ	ท ศ
กลองยาว	ก ล อ ง ย า ว
เฉลย	เ ฉ ล ย
โดยสาร	โ ด ย ส า ร
เปิด	เ ป ิ ด
เปิด	เ ป ิ ด
บน	บ น
กระโชก	ก ร ะ โ ช ก
ยาก	ย า ก
โสม	โ ส ม
ยุติ	ย ุ ต ิ
สิ้นสุด	ส ิ ้ น ส ุ ด
ร้านอาหาร	ร ้ า น อ า ห า ร
เลี่ยน	เ ล ี ่ ย น
บน	บ น
ชนิด	ช น ิ ด
ยาก	ย า ก
เปิด	เ ป ิ ด
งานเข้า	ง า น เ ข ้ า
กระดูกเชิงกราน	ก ร ะ ด ู ก เ ช ิ ง ก ร า น
ก้นกบ	ก ้ น ก บ
ยาหม่อง	ย า ห ม ่ อ ง
ปิด	ป ิ ด
ความเท่าเทียม	ค ว า ม เ ท ่ า เ ท ี ย ม
เมื่อ	เ ม ื ่ อ
ข้าม	ข ้ า ม
เท่ห์	เ ท ่ ห ์
สวน	ส ว น
เม็ดเลือด	เ ม ็ ด เ ล ื อ ด
เฉก	เ ฉ ก
เพื่อน	เ พ ื ่ อ น
สารประกอบ	ส า ร ป ร ะ ก อ บ
มาก	ม า ก
รัม	ร ั ม
อากร	อ า ก ร
มัมมี่	ม ั ม ม ี ่
วัฒนะ	ว ั ฒ น ะ
มกร	ม ก ร
อิสร	อ ิ ส ร
เมื่อ	เ ม ื ่ อ
เป็นห่วง	เ ป ็ น ห ่ ว ง
ปิด	ป ิ ด
ปิด	ป ิ ด
ช่างไฟฟ้า	ช ่ า ง ไ ฟ ฟ ้ า
รวน	ร ว น
อภัย	อ ภ ั ย
ขจร	ข จ ร
กอง	ก อ ง
น้ำส้ม	น ้ ำ ส ้ ม
ปราก	ป ร า ก
เปิด	เ ป ิ ด
ช่อ	ช ่ อ
มาก	ม า ก
แม้	แ ม ้
โรงสี	โ ร ง ส ี
ข้าม	ข ้ า ม
รักษา	ร ั ก ษ า
บน	บ น
แม้	แ ม ้
เปิด	เ ป ิ ด
ข้าม	ข ้ า ม
บน	บ น
วิจิตร	ว ิ จ ิ ต ร
คล้ำ	ค ล ้ ำ
นึ่ง	น ึ ่ ง
ค้าน	ค ้ า น
ชนิด	ช น ิ ด
แนะนำ	แ น ะ น ำ
กระชาก	ก ร ะ ช า ก
เกลือ	เ ก ล ื อ
นุ่ง	น ุ ่ ง
มกร	ม ก ร
เปิด	เ ป ิ ด
ลานจอดรถ	ล า น จ อ ด ร ถ
ส่าย	ส ่ า ย
เมื่อ	เ ม ื ่ อ
ศาสตร์	ศ า ส ต ร ์
กุล	ก ุ ล
เชื่อมั่น	เ ช ื ่ อ ม ั ่ น
มาก	ม า ก
ชนิด	ช น ิ ด
กิจการ	ก ิ จ ก า ร
คอเต่า	ค อ เ ต ่ า
คุกกี้	ค ุ ก ก ี ้
ยาก	ย า ก
ถุงพลาสติก	ถ ุ ง พ ล า ส ต ิ ก
มังคล	ม ั ง ค ล
ศาสตร์	ศ า ส ต ร ์
เมื่อ	เ ม ื ่ อ
เมื่อ	เ ม ื ่ อ
ชำระ	ช ำ ร ะ
จาร	จ า ร
วรรณ	ว ร ร ณ
สิ้นสุด	ส ิ ้ น ส ุ ด
บน	บ น
ทศ	ท ศ
มาก	ม า ก
อิสร	อ ิ ส ร
มาก	ม า ก
เมื่อ	เ ม ื ่ อ
ชนิด	ช น ิ ด
ม่อน	ม ่ อ น
บน	บ น
ถุงพลาสติก	ถ ุ ง พ ล า ส ต ิ ก
ภาพประกอบ	ภ า พ ป ร ะ ก อ บ
ทศ	ท ศ
เปิด	เ ป ิ ด
ชนิด	ช น ิ ด
ผ้า	ผ ้ า
เพื่อน	เ พ ื ่ อ น
เชื่อมั่น	เ ช ื ่ อ ม ั ่ น
ไข่มุก	ไ ข ่ ม ุ ก
นอย	น อ ย
นึ่ง	น ึ ่ ง
มาก	ม า ก
เมื่อ	เ ม ื ่ อ
กลิ่น	ก ล ิ ่ น
ลำคอ	ล ำ ค อ
มาเล	ม า เ ล
ซุง	ซ ุ ง
การกลืน	ก า ร ก ล ื น
ภาพประกอบ	ภ า พ ป ร ะ ก อ บ
เมื่อ	เ ม ื ่ อ
นอย	น อ ย
เท่าไหร่	เ ท ่ า ไ ห ร ่
ประทับใจ	ป ร ะ ท ั บ ใ จ
เฮ	เ ฮ
ทศ	ท ศ
ทศ	ท ศ
เมื่อ	เ ม ื ่ อ
กุล	ก ุ ล
มั่นใจ	ม ั ่ น ใ จ
เลขา	เ ล ข า
เฉลย	เ ฉ ล ย
ปิด	ป ิ ด
ล้น	ล ้ น
รับประทาน	ร ั บ ป ร ะ ท า น
มั่นใจ	ม ั ่ น ใ จ
ธิดา	ธ ิ ด า
สโมสร	ส โ ม ส ร
ฟาด	ฟ า ด
เศรษฐศาสตร์	เ ศ ร ษ ฐ ศ า ส ต ร ์
ศาสตร์	ศ า ส ต ร ์
จาร	จ า ร
ส่วนรวม	ส ่ ว น ร ว ม
ปิด	ป ิ ด
ริ้วรอย	ร ิ ้ ว ร อ ย
กระตือรือร้น	ก ร ะ ต ื อ ร ื อ ร ้ น
แผ่นเสียง	แ ผ ่ น เ ส ี ย ง
ปิด	ป ิ ด
ทศ	ท ศ
การจัด	ก า ร จ ั ด
ฉุด	ฉ ุ ด
วรรณ	ว ร ร ณ
เด็ก	เ ด ็ ก
ข้าม	ข ้ า ม
มาก	ม า ก
เพื่อน	เ พ ื ่ อ น
บรรยากาศ	บ ร ร ย า ก า ศ
แนะนำ	แ น ะ น ำ
การทุจริต	ก า ร ท ุ จ ร ิ ต
นอย	น อ ย
เซ็กซี่	เ ซ ็ ก ซ ี ่
นูน	น ู น
ตอม	ต อ ม
ความหวาน	ค ว า ม ห ว า น
ปิด	ป ิ ด
เกาลัด	เ ก า ล ั ด
เท่าไหร่	เ ท ่ า ไ ห ร ่
มาก	ม า ก
เมื่อ	เ ม ื ่ อ
มกร	ม ก ร
เมื่อ	เ ม ื ่ อ
หัด	ห ั ด
แอปเปิ้ล	แ อ ป เ ป ิ ้ ล
ทักษิณ	ท ั ก ษ ิ ณ
การโยน	ก า ร โ ย น
นอย	น อ ย
มูส	ม ู ส
ประจำ	ป ร ะ จ ำ
คาปรับ	ค า ป ร ั บ
ม่อน	ม ่ อ น
กระเช้า	ก ร ะ เ ช ้ า
เศียร	เ ศ ี ย ร
อวัยวะเพศหญิง	อ ว ั ย ว ะ เ พ ศ ห ญ ิ ง
ศาสตร์	ศ า ส ต ร ์
สำลัก	ส ำ ล ั ก
เบิร์น	เ บ ิ ร ์ น
มิค	ม ิ ค
ผ้า	ผ ้ า
เส้นผ่านศูนย์กลาง	เ ส ้ น ผ ่ า น ศ ู น ย ์ ก ล า ง
มาก	ม า ก
นอย	น อ ย
นารายณ์	น า ร า ย ณ ์
นึ่ง	น ึ ่ ง
มาก	ม า ก
เปลือกตา	เ ป ล ื อ ก ต า
การจัด	ก า ร จ ั ด
พูด	พ ู ด
ปิด	ป ิ ด
บน	บ น
เศรษฐศาสตร์	เ ศ ร ษ ฐ ศ า ส ต ร ์
ทศ	ท ศ
เฮ	เ ฮ
ข้าม	ข ้ า ม
เคลื่อนที่	เ ค ล ื ่ อ น ท ี ่
เด็ก	เ ด ็ ก
ผู้ชม	ผ ู ้ ช ม
ใบตอง	ใ บ ต อ ง
เพื่อน	เ พ ื ่ อ น
ชนิด	ช น ิ ด
บน	บ น
ยาก	ย า ก
รักษา	ร ั ก ษ า
เนื้อเยื่อ	เ น ื ้ อ เ ย ื ่ อ
พูด	พ ู ด
บน	บ น
เนื้องอก	เ น ื ้ อ ง อ ก
ผ้า	ผ ้ า
เด็ก	เ ด ็ ก
แมง	แ ม ง
มาก	ม า ก
โคเปนเฮเกน	โ ค เ ป น เ ฮ เ ก น
บน	บ น
กุล	ก ุ ล
ร้านอาหาร	ร ้ า น อ า ห า ร
นึ่ง	น ึ ่ ง
เมื่อ	เ ม ื ่ อ
สถานที่	ส ถ า น ท ี ่
เภสัชกร	เ ภ ส ั ช ก ร
ฝั่ง	ฝ ั ่ ง
ชอบธรรม	ช อ บ ธ ร ร ม
เปิด	เ ป ิ ด
ค้อน	ค ้ อ น
ค่านิยม	ค ่ า น ิ ย ม
เฉลย	เ ฉ ล ย
เส้นผ่านศูนย์กลาง	เ ส ้ น ผ ่ า น ศ ู น ย ์ ก ล า ง
เมื่อ	เ ม ื ่ อ
โดยสาร	โ ด ย ส า ร
บน	บ น
ปิด	ป ิ ด
มะม่วง	ม ะ ม ่ ว ง
ทศ	ท ศ
ไพศาล	ไ พ ศ า ล
มกร	ม ก ร
การจัด	ก า ร จ ั ด
สันนิษฐาน	ส ั น น ิ ษ ฐ า น
การจัด	ก า ร จ ั ด
บน	บ น
หมวก	ห ม ว ก
รัม	ร ั ม
สวน	ส ว น
หัก	ห ั ก
ยาก	ย า ก
เมลเบิร์น	เ ม ล เ บ ิ ร ์ น
หวั่น	ห ว ั ่ น
สวน	ส ว น
เคลื่อนที่	เ ค ล ื ่ อ น ท ี ่
ปิด	ป ิ ด
มาตราส่วน	ม า ต ร า ส ่ ว น
มกร	ม ก ร
ยาก	ย า ก
จาร	จ า ร
คลุก	ค ล ุ ก
นิวเคลียร์	น ิ ว เ ค ล ี ย ร ์
ยาก	ย า ก
ประจำ	ป ร ะ จ ำ
ไข่มุก	ไ ข ่ ม ุ ก
ปิด	ป ิ ด
แม้	แ ม ้
ย่าม	ย ่ า ม
ดาย	ด า ย
การจัด	ก า ร จ ั ด
พูด	พ ู ด
นอย	น อ ย
มาก	ม า ก
เครื่องซักผ้า	เ ค ร ื ่ อ ง ซ ั ก ผ ้ า
ยาก	ย า ก
เด็ก	เ ด ็ ก
แรงดึงดูด	แ ร ง ด ึ ง ด ู ด
อคติ	อ ค ต ิ
การจัด	ก า ร จ ั ด
จาร	จ า ร
ยาก	ย า ก
ทรงผม	ท ร ง ผ ม
โดยสาร	โ ด ย ส า ร
ผู้ชม	ผ ู ้ ช ม
โปรโมชั่น	โ ป ร โ ม ช ั ่ น
สงบ	ส ง บ
ชำระ	ช ำ ร ะ
นึ่ง	น ึ ่ ง
วรรณ	ว ร ร ณ
วัคซีน	ว ั ค ซ ี น
ผ้า	ผ ้ า
ของกิน	ข อ ง ก ิ น
๑๔	๑ ๔
ศาสตร์	ศ า ส ต ร ์
กระแสไฟฟ้า	ก ร ะ แ ส ไ ฟ ฟ ้ า
ช่อ	ช ่ อ
จักรเย็บ	จ ั ก ร เ ย ็ บ
มิค	ม ิ ค
เซ็กซี่	เ ซ ็ ก ซ ี ่
นึ่ง	น ึ ่ ง
นึ่ง	น ึ ่ ง
พูด	พ ู ด
เกลือ	เ ก ล ื อ
สหภาพยุโรป	ส ห ภ า พ ย ุ โ ร ป
หยาด	ห ย า ด
แนะนำ	แ น ะ น ำ
ปิด	ป ิ ด
ประจาน	ป ร ะ จ า น
สารประกอบ	ส า ร ป ร ะ ก อ บ
น้ำลาย	น ้ ำ ล า ย
ชนิด	ช น ิ ด
สืบทอด	ส ื บ ท อ ด
รัม	ร ั ม
กอง	ก อ ง
ปากีสถาน	ป า ก ี ส ถ า น
จิ๋ว	จ ิ ๋ ว
มหายาน	ม ห า ย า น
เครื่องฉาย	เ ค ร ื ่ อ ง ฉ า ย
การจัด	ก า ร จ ั ด
ทูล	ท ู ล
ปิด	ป ิ ด
ค่ะ	ค ่ ะ
ลดราคา	ล ด ร า ค า
เมื่อ	เ ม ื ่ อ
มาก	ม า ก
ประจำ	ป ร ะ จ ำ
ดาม	ด า ม
แนะนำ	แ น ะ น ำ
บน	บ น
เฮ	เ ฮ
บน	บ น
ทิ้ง	ท ิ ้ ง
เบ็ด	เ บ ็ ด
แตงกวา	แ ต ง ก ว า
ปลูกฝัง	ป ล ู ก ฝ ั ง
เร้าใจ	เ ร ้ า ใ จ
กำบัง	ก ำ บ ั ง
นอย	น อ ย
มอญ	ม อ ญ
บน	บ น
ระนาว	ร ะ น า ว
ถ่อง	ถ ่ อ ง
เด็ก	เ ด ็ ก
ข้าม	ข ้ า ม
เปิด	เ ป ิ ด
บน	บ น
ทศ	ท ศ
รัตนตรัย	ร ั ต น ต ร ั ย
ความอดทน	ค ว า ม อ ด ท น
ผ้า	ผ ้ า
ประจำ	ป ร ะ จ ำ
เมื่อ	เ ม ื ่ อ
ผลพลอยได้	ผ ล พ ล อ ย ไ ด ้
ฝั่ง	ฝ ั ่ ง
บน	บ น
เถียง	เ ถ ี ย ง
อ้าง	อ ้ า ง
คดี	ค ด ี
ยาเม็ด	ย า เ ม ็ ด
ตุล	ต ุ ล
ศิริ	ศ ิ ร ิ
ร้านอาหาร	ร ้ า น อ า ห า ร
เกษตรศาสตร์	เ ก ษ ต ร ศ า ส ต ร ์
แม้	แ ม ้
นึ่ง	น ึ ่ ง
เพื่อน	เ พ ื ่ อ น
การจัด	ก า ร จ ั ด
นึ่ง	น ึ ่ ง
โสม	โ ส ม
กริ่ง	ก ร ิ ่ ง
ทศ	ท ศ
ฝ่าฝืน	ฝ ่ า ฝ ื น
เกลือ	เ ก ล ื อ
จาร	จ า ร
ผ้า	ผ ้ า
เพื่อน	เ พ ื ่ อ น
ปลอบ	ป ล อ บ
ปราก	ป ร า ก
คลุก	ค ล ุ ก
ฟู	ฟ ู
นอย	น อ ย
ผ้า	ผ ้ า
เรียง	เ ร ี ย ง
เฮ	เ ฮ
หอยนางรม	ห อ ย น า ง ร ม
จาร	จ า ร
พระองค์	พ ร ะ อ ง ค ์
พระองค์	พ ร ะ อ ง ค ์
เฮ	เ ฮ
ดวงใจ	ด ว ง ใ จ
สะพานลอย	ส ะ พ า น ล อ ย
แนะนำ	แ น ะ น ำ
นึ่ง	น ึ ่ ง
จาร	จ า ร
ภัยแล้ง	ภ ั ย แ ล ้ ง
ตัวประกัน	ต ั ว ป ร ะ ก ั น
มาก	ม า ก
ผ้า	ผ ้ า
ศิริ	ศ ิ ร ิ
ทศ	ท ศ
เด็ก	เ ด ็ ก
นอย	น อ ย
ทศ	ท ศ
นอย	น อ ย
สุขภาพจิต	ส ุ ข ภ า พ จ ิ ต
อ้าง	อ ้ า ง
ปราจีนบุรี	ป ร า จ ี น บ ุ ร ี
เด็ก	เ ด ็ ก
ยาก	ย า ก
การผจญภัย	ก า ร ผ จ ญ ภ ั ย
กัลปังหา	ก ั ล ป ั ง ห า
ปิด	ป ิ ด
มกร	ม ก ร
นอย	น อ ย
พูด	พ ู ด
โรงไฟฟ้า	โ ร ง ไ ฟ ฟ ้ า
สิ้นสุด	ส ิ ้ น ส ุ ด
ปราณ	ป ร า ณ
วงแหวน	ว ง แ ห ว น
เอกราช	เ อ ก ร า ช
มาก	ม า ก
พรุน	พ ร ุ น
แกมมา	แ ก ม ม า
ปิด	ป ิ ด
ศาสตร์	ศ า ส ต ร ์
กุล	ก ุ ล
อากาศยาน	อ า ก า ศ ย า น
คดี	ค ด ี
เมื่อ	เ ม ื ่ อ
เฉลิมฉลอง	เ ฉ ล ิ ม ฉ ล อ ง
เมื่อ	เ ม ื ่ อ
เปิด	เ ป ิ ด
ทศ	ท ศ
ฮาร์ดแวร์	ฮ า ร ์ ด แ ว ร ์
น้ำส้ม	น ้ ำ ส ้ ม
แนะนำ	แ น ะ น ำ
เปิด	เ ป ิ ด
กางเกง	ก า ง เ ก ง
ค่ะ	ค ่ ะ
เปิด	เ ป ิ ด
เมื่อ	เ ม ื ่ อ
กลึง	ก ล ึ ง
เลอะ	เ ล อ ะ
ปิด	ป ิ ด
อึดอัด	อ ึ ด อ ั ด
อ้าง	อ ้ า ง
คอลัมน์	ค อ ล ั ม น ์
รัม	ร ั ม
เยีย	เ ย ี ย
เปิด	เ ป ิ ด
จันทรคราส	จ ั น ท ร ค ร า ส
คำวินิจฉัย	ค ำ ว ิ น ิ จ ฉ ั ย
บน	บ น
เปิด	เ ป ิ ด
อุปทาน	อ ุ ป ท า น
การสัมมนา	ก า ร ส ั ม ม น า
เสมหะ	เ ส ม ห ะ
แนะนำ	แ น ะ น ำ
คนเดียว	ค น เ ด ี ย ว
กอง	ก อ ง
รัม	ร ั ม
นอย	น อ ย
มาก	ม า ก
ความซับซ้อน	ค ว า ม ซ ั บ ซ ้ อ น
นอย	น อ ย
สุขภาพจิต	ส ุ ข ภ า พ จ ิ ต
ปัสสาวะ	ป ั ส ส า ว ะ
เปิด	เ ป ิ ด
ถุงเท้า	ถ ุ ง เ ท ้ า
ยาก	ย า ก
แม่ซื้อ	แ ม ่ ซ ื ้ อ
ครีบ	ค ร ี บ
เงื่อน	เ ง ื ่ อ น
ทศ	ท ศ
ยาก	ย า ก
แนะนำ	แ น ะ น ำ
บน	บ น
ยูง	ย ู ง
จินดา	จ ิ น ด า
ล้น	ล ้ น
เปิด	เ ป ิ ด
มกร	ม ก ร
นึ่ง	น ึ ่ ง
ข้าม	ข ้ า ม
เยอะ	เ ย อ ะ
เรียง	เ ร ี ย ง
วิตกกังวล	ว ิ ต ก ก ั ง ว ล
พายุ	พ า ย ุ
ความหิว	ค ว า ม ห ิ ว
ดาย	ด า ย
รักษาการ	ร ั ก ษ า ก า ร
ยาก	ย า ก
จั่ว	จ ั ่ ว
นึ่ง	น ึ ่ ง
ตราด	ต ร า ด
ถีบ	ถ ี บ
มาก	ม า ก
ยุติ	ย ุ ต ิ
เยีย	เ ย ี ย
เฮ	เ ฮ
วิจิตร	ว ิ จ ิ ต ร
มาก	ม า ก
นึ่ง	น ึ ่ ง
นึ่ง	น ึ ่ ง
โดยสาร	โ ด ย ส า ร
วินาศ	ว ิ น า ศ
ประทับใจ	ป ร ะ ท ั บ ใ จ
นึ่ง	น ึ ่ ง
เนตร	เ น ต ร
เด็ก	เ ด ็ ก
ผ้า	ผ ้ า
การชอบ	ก า ร ช อ บ
กอง	ก อ ง
ไนท์คลับ	ไ น ท ์ ค ล ั บ
ฮาร์ดแวร์	ฮ า ร ์ ด แ ว ร ์
วรรณ	ว ร ร ณ
มันหมู	ม ั น ห ม ู
แอนติเจน	แ อ น ต ิ เ จ น
เยือก	เ ย ื อ ก
ปิด	ป ิ ด
ผอม	ผ อ ม
มาก	ม า ก
เขียวหวาน	เ ข ี ย ว ห ว า น
ชนิด	ช น ิ ด
ประมง	ป ร ะ ม ง
อธิษฐาน	อ ธ ิ ษ ฐ า น
กอง	ก อ ง
ทรงผม	ท ร ง ผ ม
ค้าน	ค ้ า น
ทศ	ท ศ
เจาะ	เ จ า ะ
ไหล่	ไ ห ล ่
ถีบ	ถ ี บ
บน	บ น
ร้องไห้	ร ้ อ ง ไ ห ้
รักษา	ร ั ก ษ า
คอลัมน์	ค อ ล ั ม น ์
ตุล	ต ุ ล
ผ้า	ผ ้ า
เลี้ยงดู	เ ล ี ้ ย ง ด ู
บน	บ น
เยอะ	เ ย อ ะ
เท่าไหร่	เ ท ่ า ไ ห ร ่
ทศ	ท ศ
นอย	น อ ย
แม้	แ ม ้
กางเกง	ก า ง เ ก ง
นึ่ง	น ึ ่ ง
มั่นใจ	ม ั ่ น ใ จ
เมื่อ	เ ม ื ่ อ
อึ้ง	อ ึ ้ ง
ปิด	ป ิ ด
ผ้า	ผ ้ า
อลังการงานสร้าง	อ ล ั ง ก า ร ง า น ส ร ้ า ง
ค่ะ	ค ่ ะ
ขับไล่	ข ั บ ไ ล ่
บน	บ น
นอย	น อ ย
มังคล	ม ั ง ค ล
กระทา	ก ร ะ ท า
มาก	ม า ก
มาก	ม า ก
เมื่อ	เ ม ื ่ อ
ข้าม	ข ้ า ม
ทศ	ท ศ
ร้านอาหาร	ร ้ า น อ า ห า ร
ฟอสฟอรัส	ฟ อ ส ฟ อ ร ั ส
ตัวหนังสือ	ต ั ว ห น ั ง ส ื อ
สวน	ส ว น
การจัด	ก า ร จ ั ด
การแถลงข่าว	ก า ร แ ถ ล ง ข ่ า ว
คดี	ค ด ี
ดีใจ	ด ี ใ จ
โคโลญจน์	โ ค โ ล ญ จ น ์
ดีใจ	ด ี ใ จ
เลี่ยน	เ ล ี ่ ย น
กอง	ก อ ง
ข้าม	ข ้ า ม
ถีบ	ถ ี บ
ปั่น	ป ั ่ น
ทศ	ท ศ
เด็ก	เ ด ็ ก
ข้าม	ข ้ า ม
เยอะ	เ ย อ ะ
ช่อ	ช ่ อ
อ้าย	อ ้ า ย
เพื่อน	เ พ ื ่ อ น
รังไข่	ร ั ง ไ ข ่
ปั๊บ	ป ั ๊ บ
ฝั่ง	ฝ ั ่ ง
แจกจ่าย	แ จ ก จ ่ า ย
เวทย์	เ ว ท ย ์
แม้	แ ม ้
ปิด	ป ิ ด
กอง	ก อ ง
เต้น	เ ต ้ น
ทศ	ท ศ
เมื่อ	เ ม ื ่ อ
ปิด	ป ิ ด
ยืดหยุ่น	ย ื ด ห ย ุ ่ น
เสื้อคลุม	เ ส ื ้ อ ค ล ุ ม
สวน	ส ว น
องก์	อ ง ก ์
ตำหนิ	ต ำ ห น ิ
เปิด	เ ป ิ ด
เด็ก	เ ด ็ ก
พื้นหลัง	พ ื ้ น ห ล ั ง
วรรณ	ว ร ร ณ
เปิด	เ ป ิ ด
อามิส	อ า ม ิ ส
กางเกง	ก า ง เ ก ง
หัวหอม	ห ั ว ห อ ม
กล่องเสียง	ก ล ่ อ ง เ ส ี ย ง
เมื่อ	เ ม ื ่ อ
แนะนำ	แ น ะ น ำ
เมื่อ	เ ม ื ่ อ
เมื่อ	เ ม ื ่ อ
หมอบ	ห ม อ บ
ศาลชั้นต้น	ศ า ล ช ั ้ น ต ้ น
ทศ	ท ศ
การมี	ก า ร ม ี
ยาก	ย า ก
ของว่าง	ข อ ง ว ่ า ง
ปลวก	ป ล ว ก
หล่ม	ห ล ่ ม
ไหล่	ไ ห ล ่
แม้	แ ม ้
ช่อ	ช ่ อ
ชาวเน็ต	ช า ว เ น ็ ต
ปิด	ป ิ ด
ไอศกรีม	ไ อ ศ ก ร ี ม
บอดี้	บ อ ด ี ้
บน	บ น
ชำระ	ช ำ ร ะ
ห้วง	ห ้ ว ง
การจัด	ก า ร จ ั ด
ราชบุรี	ร า ช บ ุ ร ี
บน	บ น
ทิเบต	ท ิ เ บ ต
เมื่อ	เ ม ื ่ อ
แนะนำ	แ น ะ น ำ
ประจำ	ป ร ะ จ ำ
ก้อง	ก ้ อ ง
ชุดชั้นใน	ช ุ ด ช ั ้ น ใ น
กางเกง	ก า ง เ ก ง
หัด	ห ั ด
มกร	ม ก ร
ผู้ค้า	ผ ู ้ ค ้ า
การจัด	ก า ร จ ั ด
ประเทศชาติ	ป ร ะ เ ท ศ ช า ต ิ
ความรุ่งเรือง	ค ว า ม ร ุ ่ ง เ ร ื อ ง
อุรุกวัย	อ ุ ร ุ ก ว ั ย
ภาวนา	ภ า ว น า
บู๊	บ ู ๊
อิสร	อ ิ ส ร
ยาก	ย า ก
นอย	น อ ย
พูด	พ ู ด
มาเล	ม า เ ล
สโมสร	ส โ ม ส ร
บน	บ น
เลขา	เ ล ข า
เมื่อ	เ ม ื ่ อ
ยี่หร่า	ย ี ่ ห ร ่ า
บน	บ น
อิจฉา	อ ิ จ ฉ า
หัก	ห ั ก
ห้วง	ห ้ ว ง
บน	บ น
นักลงทุน	น ั ก ล ง ท ุ น
เด็ก	เ ด ็ ก
สถานที่	ส ถ า น ท ี ่
ทัพเรือ	ท ั พ เ ร ื อ
รัม	ร ั ม
สวน	ส ว น
จาร	จ า ร
เชื่อมั่น	เ ช ื ่ อ ม ั ่ น
เพื่อน	เ พ ื ่ อ น
หยาด	ห ย า ด
เท่าไหร่	เ ท ่ า ไ ห ร ่
คีย์บอร์ด	ค ี ย ์ บ อ ร ์ ด
สโมสร	ส โ ม ส ร
เฮ	เ ฮ
คนงาน	ค น ง า น
ยุติ	ย ุ ต ิ
เมื่อ	เ ม ื ่ อ
ค้าน	ค ้ า น
แม้	แ ม ้
เปิด	เ ป ิ ด
เด็ก	เ ด ็ ก
ปราณ	ป ร า ณ
ความอดทน	ค ว า ม อ ด ท น
เด็ก	เ ด ็ ก
ผ้า	ผ ้ า
เมื่อ	เ ม ื ่ อ
ดาย	ด า ย
แนะนำ	แ น ะ น ำ
กอง	ก อ ง
ความอ้วน	ค ว า ม อ ้ ว น
ชาวไร่	ช า ว ไ ร ่
ค่ะ	ค ่ ะ
ช่องว่าง	ช ่ อ ง ว ่ า ง
นึ่ง	น ึ ่ ง
บน	บ น
เงื่อน	เ ง ื ่ อ น
เมื่อ	เ ม ื ่ อ
บน	บ น
เสี่ยงทาย	เ ส ี ่ ย ง ท า ย
ขนส่ง	ข น ส ่ ง
เท่าไหร่	เ ท ่ า ไ ห ร ่
ปั่น	ป ั ่ น
ปราก	ป ร า ก
ซิงเกิล	ซ ิ ง เ ก ิ ล
เปิด	เ ป ิ ด
นอย	น อ ย
ผ้า	ผ ้ า
ลดราคา	ล ด ร า ค า
ข้าม	ข ้ า ม
รักษา	ร ั ก ษ า
วรรณ	ว ร ร ณ
เมื่อ	เ ม ื ่ อ
ข้าม	ข ้ า ม
ช่อ	ช ่ อ
แนะนำ	แ น ะ น ำ
นอย	น อ ย
เมื่อ	เ ม ื ่ อ
ทศ	ท ศ
โปรโมชั่น	โ ป ร โ ม ช ั ่ น
โปรโมชั่น	โ ป ร โ ม ช ั ่ น
ดาย	ด า ย
ล่อแหลม	ล ่ อ แ ห ล ม
ทศ	ท ศ
สวน	ส ว น
ศาสตร์	ศ า ส ต ร ์
บน	บ น
ทุกที	ท ุ ก ท ี
เสถียรภาพ	เ ส ถ ี ย ร ภ า พ
บน	บ น
ช่อ	ช ่ อ
ปั่น	ป ั ่ น
ขุ่น	ข ุ ่ น
ยาก	ย า ก
ผลาญ	ผ ล า ญ
นอย	น อ ย
ปิด	ป ิ ด
นุ่น	น ุ ่ น
เปิด	เ ป ิ ด
ลูกครึ่ง	ล ู ก ค ร ึ ่ ง
กุล	ก ุ ล
ค่ะ	ค ่ ะ
นอย	น อ ย
ตรุษจีน	ต ร ุ ษ จ ี น
ชานเมือง	ช า น เ ม ื อ ง
ยาก	ย า ก
เยอะ	เ ย อ ะ
ทศ	ท ศ
รักษา	ร ั ก ษ า
วิ่ง	ว ิ ่ ง
ปิด	ป ิ ด
นึ่ง	น ึ ่ ง
ปราก	ป ร า ก
แม้	แ ม ้
อมตะ	อ ม ต ะ
มกร	ม ก ร
ยาฆ่าแมลง	ย า ฆ ่ า แ ม ล ง
ข้าม	ข ้ า ม
ตำหนัก	ต ำ ห น ั ก
อินสตาแกรม	อ ิ น ส ต า แ ก ร ม
คนร้าย	ค น ร ้ า ย
ตัดต่อ	ต ั ด ต ่ อ
เปิด	เ ป ิ ด
เมื่อ	เ ม ื ่ อ
การปั่น	ก า ร ป ั ่ น
นึ่ง	น ึ ่ ง
กุล	ก ุ ล
นอย	น อ ย
ซีพียู	ซ ี พ ี ย ู
มาก	ม า ก
ตลาดหลักทรัพย์	ต ล า ด ห ล ั ก ท ร ั พ ย ์
ข้าม	ข ้ า ม
การโจมตี	ก า ร โ จ ม ต ี
การกรอก	ก า ร ก ร อ ก
คดี	ค ด ี
เนื้องอก	เ น ื ้ อ ง อ ก
วิกิพีเดีย	ว ิ ก ิ พ ี เ ด ี ย
รักษา	ร ั ก ษ า
ขนส่ง	ข น ส ่ ง
คดี	ค ด ี
การโฆษณาชวนเชื่อ	ก า ร โ ฆ ษ ณ า ช ว น เ ช ื ่ อ
พสก	พ ส ก
โถง	โ ถ ง
กอง	ก อ ง
ข้อเท้า	ข ้ อ เ ท ้ า
แรงม้า	แ ร ง ม ้ า
ทำโทษ	ท ำ โ ท ษ
รักษา	ร ั ก ษ า
อายุวัฒนะ	อ า ย ุ ว ั ฒ น ะ
เมื่อ	เ ม ื ่ อ
ข้าวโพด	ข ้ า ว โ พ ด
รุ้ง	ร ุ ้ ง
โองการ	โ อ ง ก า ร
มกร	ม ก ร
ปั่น	ป ั ่ น
บน	บ น
โหล่	โ ห ล ่
โกหก	โ ก ห ก
นึ่ง	น ึ ่ ง
เต้น	เ ต ้ น
สารประกอบ	ส า ร ป ร ะ ก อ บ
มาก	ม า ก
ทศ	ท ศ
สันหลัง	ส ั น ห ล ั ง
เมื่อ	เ ม ื ่ อ
แม้	แ ม ้
ปิด	ป ิ ด
กุล	ก ุ ล
เมื่อ	เ ม ื ่ อ
ใคร่	ใ ค ร ่
ชนิด	ช น ิ ด
เมื่อ	เ ม ื ่ อ
การจัด	ก า ร จ ั ด
มาก	ม า ก
แนะนำ	แ น ะ น ำ
เศรษฐศาสตร์	เ ศ ร ษ ฐ ศ า ส ต ร ์
เมื่อ	เ ม ื ่ อ
รับประทาน	ร ั บ ป ร ะ ท า น
ค่านิยม	ค ่ า น ิ ย ม
ทศ	ท ศ
สะเก็ดเงิน	ส ะ เ ก ็ ด เ ง ิ น
ตุล	ต ุ ล
ยาก	ย า ก
หมวก	ห ม ว ก
ข้าม	ข ้ า ม
ไพบูลย์	ไ พ บ ู ล ย ์
เรียง	เ ร ี ย ง
การจัด	ก า ร จ ั ด
ฮวงจุ้ย	ฮ ว ง จ ุ ้ ย
กิจการ	ก ิ จ ก า ร
มุ้ง	ม ุ ้ ง
เฟือย	เ ฟ ื อ ย
สิงห์บุรี	ส ิ ง ห ์ บ ุ ร ี
ยุติ	ย ุ ต ิ
พูด	พ ู ด
พจน์	พ จ น ์
เศรษฐศาสตร์	เ ศ ร ษ ฐ ศ า ส ต ร ์
คำใต้	ค ำ ใ ต ้
แนะนำ	แ น ะ น ำ
ประมง	ป ร ะ ม ง
ช่องว่าง	ช ่ อ ง ว ่ า ง
ทศ	ท ศ
เด็ก	เ ด ็ ก
แม้	แ ม ้
แนะนำ	แ น ะ น ำ
เฮ	เ ฮ
เจ้าชู้	เ จ ้ า ช ู ้
บน	บ น
โรตี	โ ร ต ี
มาก	ม า ก
ปักกิ่ง	ป ั ก ก ิ ่ ง
รักบี้	ร ั ก บ ี ้
ปัสสาวะ	ป ั ส ส า ว ะ
ส้มตำ	ส ้ ม ต ำ
เมื่อ	เ ม ื ่ อ
แม้	แ ม ้
การจัด	ก า ร จ ั ด
มกร	ม ก ร
แคนาดา	แ ค น า ด า
ทศ	ท ศ
บน	บ น
แนะนำ	แ น ะ น ำ
กอง	ก อ ง
หัด	ห ั ด
มาก	ม า ก
นอย	น อ ย
สงบ	ส ง บ
เมื่อ	เ ม ื ่ อ
ไล่ออก	ไ ล ่ อ อ ก
เลขานุการ	เ ล ข า น ุ ก า ร
เปิด	เ ป ิ ด
เมื่อ	เ ม ื ่ อ
มกร	ม ก ร
อัยการ	อ ั ย ก า ร
การเผา	ก า ร เ ผ า
จาร	จ า ร
อ้าง	อ ้ า ง
ศาสตร์	ศ า ส ต ร ์
บน	บ น
แรงม้า	แ ร ง ม ้ า
ไอร์แลนด์	ไ อ ร ์ แ ล น ด ์
ทิ้ง	ท ิ ้ ง
ฝั่ง	ฝ ั ่ ง
แนะนำ	แ น ะ น ำ
นอย	น อ ย
แม้	แ ม ้
อิสร	อ ิ ส ร
บรรยากาศ	บ ร ร ย า ก า ศ
ค้าประเวณี	ค ้ า ป ร ะ เ ว ณ ี
สงบ	ส ง บ
สวน	ส ว น
ทึบ	ท ึ บ
ชิงช้า	ช ิ ง ช ้ า
เปิด	เ ป ิ ด
ผ้า	ผ ้ า
มาเล	ม า เ ล
เฉลิมฉลอง	เ ฉ ล ิ ม ฉ ล อ ง
ข้าม	ข ้ า ม
เฮ	เ ฮ
แม้	แ ม ้
นักกอล์ฟ	น ั ก ก อ ล ์ ฟ
วิ่ง	ว ิ ่ ง
มาก	ม า ก
ยาก	ย า ก
ข้าม	ข ้ า ม
นอย	น อ ย
บน	บ น
การอนุญาต	ก า ร อ น ุ ญ า ต
นึ่ง	น ึ ่ ง
เด็ก	เ ด ็ ก
ข้าม	ข ้ า ม
มาก	ม า ก
มาเล	ม า เ ล
รักษา	ร ั ก ษ า
มาก	ม า ก
การจัด	ก า ร จ ั ด
เกลือ	เ ก ล ื อ
เดือย	เ ด ื อ ย
รถแข่ง	ร ถ แ ข ่ ง
บน	บ น
พสก	พ ส ก
ประจำ	ป ร ะ จ ำ
ข้าม	ข ้ า ม
นอย	น อ ย
นอย	น อ ย
แกนนำ	แ ก น น ำ
ปิด	ป ิ ด
เลื่อมใส	เ ล ื ่ อ ม ใ ส
บน	บ น
ยาก	ย า ก
กุล	ก ุ ล
มาก	ม า ก
ค่ะ	ค ่ ะ
ผ้า	ผ ้ า
รักษา	ร ั ก ษ า
ลานจอดรถ	ล า น จ อ ด ร ถ
เศรษฐศาสตร์	เ ศ ร ษ ฐ ศ า ส ต ร ์
เกลือ	เ ก ล ื อ
นอย	น อ ย
มาก	ม า ก
การชัก	ก า ร ช ั ก
ทางด่วน	ท า ง ด ่ ว น
เมื่อ	เ ม ื ่ อ
นอย	น อ ย
เชิดชู	เ ช ิ ด ช ู
มาก	ม า ก
คูน	ค ู น
ฝั่ง	ฝ ั ่ ง
หรีด	ห ร ี ด
แนะนำ	แ น ะ น ำ
เส้นเลือดดำ	เ ส ้ น เ ล ื อ ด ด ำ
การโจมตี	ก า ร โ จ ม ต ี
ร้อนใน	ร ้ อ น ใ น
บรรยากาศ	บ ร ร ย า ก า ศ
พีซี	พ ี ซ ี
ตัวแปร	ต ั ว แ ป ร
คดี	ค ด ี
กรัม	ก ร ั ม
ล้น	ล ้ น
ไหล่	ไ ห ล ่
แม้	แ ม ้
หมวก	ห ม ว ก
บน	บ น
นอย	น อ ย
แย่ง	แ ย ่ ง
เรือข้ามฟาก	เ ร ื อ ข ้ า ม ฟ า ก
การนอนหลับ	ก า ร น อ น ห ล ั บ
อิจฉา	อ ิ จ ฉ า
นักการเมือง	น ั ก ก า ร เ ม ื อ ง
ลิ่มเลือด	ล ิ ่ ม เ ล ื อ ด
เมื่อ	เ ม ื ่ อ
แนะนำ	แ น ะ น ำ
บรรยากาศ	บ ร ร ย า ก า ศ
เมื่อ	เ ม ื ่ อ
ประจำ	ป ร ะ จ ำ
กิจการ	ก ิ จ ก า ร
วรรณ	ว ร ร ณ
เยอะ	เ ย อ ะ
ทศ	ท ศ
เชื่อใจ	เ ช ื ่ อ ใ จ
พูด	พ ู ด
ประสิทธิผล	ป ร ะ ส ิ ท ธ ิ ผ ล
ทศ	ท ศ
บน	บ น
แม้	แ ม ้
ข้าม	ข ้ า ม
บน	บ น
แนะนำ	แ น ะ น ำ
รักษา	ร ั ก ษ า
เมื่อ	เ ม ื ่ อ
แตงกวา	แ ต ง ก ว า
ลดราคา	ล ด ร า ค า
นึ่ง	น ึ ่ ง
ศาสตร์	ศ า ส ต ร ์
มาก	ม า ก
มั่นใจ	ม ั ่ น ใ จ
เปิด	เ ป ิ ด
งัด	ง ั ด
ทะเลจีนใต้	ท ะ เ ล จ ี น ใ ต ้
พูด	พ ู ด
รักษา	ร ั ก ษ า
สมุห	ส ม ุ ห
ปิด	ป ิ ด
เฉลย	เ ฉ ล ย
กลัด	ก ล ั ด
พูด	พ ู ด
กินข้าว	ก ิ น ข ้ า ว
รวน	ร ว น
ประทับใจ	ป ร ะ ท ั บ ใ จ
อ้าง	อ ้ า ง
เทือก	เ ท ื อ ก
เมื่อ	เ ม ื ่ อ
อารยะ	อ า ร ย ะ
มาก	ม า ก
อัมพร	อ ั ม พ ร
เมื่อ	เ ม ื ่ อ
นึ่ง	น ึ ่ ง
มาก	ม า ก
คดี	ค ด ี
ทุกที	ท ุ ก ท ี
วิสามัญ	ว ิ ส า ม ั ญ
ห่วงใย	ห ่ ว ง ใ ย
เมื่อ	เ ม ื ่ อ
ป้ายรถเมล์	ป ้ า ย ร ถ เ ม ล ์
ใจร้อน	ใ จ ร ้ อ น
กุล	ก ุ ล
อนุสรณ์สถาน	อ น ุ ส ร ณ ์ ส ถ า น
ปิด	ป ิ ด
กอง	ก อ ง
นึ่ง	น ึ ่ ง
ไพฑูรย์	ไ พ ฑ ู ร ย ์
เดนเวอร์	เ ด น เ ว อ ร ์
ซอก	ซ อ ก
มาก	ม า ก
เลขา	เ ล ข า
สโลวาเกีย	ส โ ล ว า เ ก ี ย
ทิ้ง	ท ิ ้ ง
บน	บ น
ความอาฆาต	ค ว า ม อ า ฆ า ต
รักษา	ร ั ก ษ า
ทศ	ท ศ
เพลี้ย	เ พ ล ี ้ ย
ถาด	ถ า ด
รสชาด	ร ส ช า ด
บน	บ น
เท่าไหร่	เ ท ่ า ไ ห ร ่
มุ้ง	ม ุ ้ ง
ตัดต่อ	ต ั ด ต ่ อ
เด็ก	เ ด ็ ก
ร้านอาหาร	ร ้ า น อ า ห า ร
ตะโก	ต ะ โ ก
ตุล	ต ุ ล
มาก	ม า ก
ยืดหยุ่น	ย ื ด ห ย ุ ่ น
บน	บ น
มาก	ม า ก
เมื่อ	เ ม ื ่ อ
มาก	ม า ก
บน	บ น
เมื่อ	เ ม ื ่ อ
ความเจริญ	ค ว า ม เ จ ร ิ ญ
ศาสตร์	ศ า ส ต ร ์
เมื่อ	เ ม ื ่ อ
เปย์	เ ป ย ์
ปิด	ป ิ ด
พิบัติ	พ ิ บ ั ต ิ
ปิด	ป ิ ด
มหาธาตุ	ม ห า ธ า ต ุ
เยอะ	เ ย อ ะ
การเลิก	ก า ร เ ล ิ ก
เต็มใจ	เ ต ็ ม ใ จ
การจัด	ก า ร จ ั ด
โถง	โ ถ ง
เมื่อ	เ ม ื ่ อ
สงบ	ส ง บ
ชนิด	ช น ิ ด
ประจำ	ป ร ะ จ ำ
ตู่	ต ู ่
นอย	น อ ย
มาก	ม า ก
เพื่อน	เ พ ื ่ อ น
กลาโหม	ก ล า โ ห ม
เท่าไหร่	เ ท ่ า ไ ห ร ่
ประจำ	ป ร ะ จ ำ
สุขลักษณะ	ส ุ ข ล ั ก ษ ณ ะ
คล้ำ	ค ล ้ ำ
มาเล	ม า เ ล
ทุกที	ท ุ ก ท ี
เรียง	เ ร ี ย ง
ไอร์แลนด์	ไ อ ร ์ แ ล น ด ์
นอย	น อ ย
ปิด	ป ิ ด
มาก	ม า ก
เปิด	เ ป ิ ด
ปราก	ป ร า ก
เยอะ	เ ย อ ะ
ความหวาน	ค ว า ม ห ว า น
นึ่ง	น ึ ่ ง
ของกิน	ข อ ง ก ิ น
มาก	ม า ก
มั่นใจ	ม ั ่ น ใ จ
มะกรูด	ม ะ ก ร ู ด
นอย	น อ ย
พื้นบ้าน	พ ื ้ น บ ้ า น
ศาสตร์	ศ า ส ต ร ์
ยาก	ย า ก
ของขลัง	ข อ ง ข ล ั ง
ตุล	ต ุ ล
ตื่นนอน	ต ื ่ น น อ น
การกรอก	ก า ร ก ร อ ก
ข้อเท้า	ข ้ อ เ ท ้ า
คดี	ค ด ี
ทั้งวัน	ท ั ้ ง ว ั น
เยอะ	เ ย อ ะ
กิจการ	ก ิ จ ก า ร
ร็อก	ร ็ อ ก
เมื่อ	เ ม ื ่ อ
เซิร์ฟเวอร์	เ ซ ิ ร ์ ฟ เ ว อ ร ์
เทรนเนอร์	เ ท ร น เ น อ ร ์
ตัดต่อ	ต ั ด ต ่ อ
ปิด	ป ิ ด
จาร	จ า ร
ชิงช้า	ช ิ ง ช ้ า
ข้าม	ข ้ า ม
ชนิด	ช น ิ ด
พลบ	พ ล บ
สันนิษฐาน	ส ั น น ิ ษ ฐ า น
มุ้ง	ม ุ ้ ง
ห้วง	ห ้ ว ง
ประหาร	ป ร ะ ห า ร
ความชอบธรรม	ค ว า ม ช อ บ ธ ร ร ม
ชำระ	ช ำ ร ะ
มาก	ม า ก
เลขานุการ	เ ล ข า น ุ ก า ร
ไหล่	ไ ห ล ่
มาก	ม า ก
เปิด	เ ป ิ ด
ปฏิวัติ	ป ฏ ิ ว ั ต ิ
บน	บ น
โปรโมชั่น	โ ป ร โ ม ช ั ่ น
มั่นใจ	ม ั ่ น ใ จ
ศาสตร์	ศ า ส ต ร ์
บน	บ น
ชำระ	ช ำ ร ะ
กอง	ก อ ง
เคลือบ	เ ค ล ื อ บ
นอกสมรส	น อ ก ส ม ร ส
ยาก	ย า ก
เฉด	เ ฉ ด
สร้อยคอ	ส ร ้ อ ย ค อ
หวั่น	ห ว ั ่ น
บน	บ น
ตุล	ต ุ ล
รักษาการ	ร ั ก ษ า ก า ร
โปรโมชั่น	โ ป ร โ ม ช ั ่ น
วรรณ	ว ร ร ณ
นึ่ง	น ึ ่ ง
ค้อน	ค ้ อ น
ลูกพี่ลูกน้อง	ล ู ก พ ี ่ ล ู ก น ้ อ ง
เถียง	เ ถ ี ย ง
แม้	แ ม ้
พ่อมด	พ ่ อ ม ด
มะรุม	ม ะ ร ุ ม
เปิด	เ ป ิ ด
สังขาร	ส ั ง ข า ร
เมื่อ	เ ม ื ่ อ
รักษา	ร ั ก ษ า
บน	บ น
เปิด	เ ป ิ ด
อิจฉา	อ ิ จ ฉ า
ลมหายใจ	ล ม ห า ย ใ จ
พูด	พ ู ด
คละ	ค ล ะ
เมื่อ	เ ม ื ่ อ
การจัด	ก า ร จ ั ด
ยโสธร	ย โ ส ธ ร
มาก	ม า ก
ราชกุมารี	ร า ช ก ุ ม า ร ี
ช่อ	ช ่ อ
ช่วยตัวเอง	ช ่ ว ย ต ั ว เ อ ง
ไหล่	ไ ห ล ่
นึ่ง	น ึ ่ ง
เปิด	เ ป ิ ด
ประทับใจ	ป ร ะ ท ั บ ใ จ
ค่ะ	ค ่ ะ
อ้าง	อ ้ า ง
โปรโมชั่น	โ ป ร โ ม ช ั ่ น
รักษา	ร ั ก ษ า
ทุกที	ท ุ ก ท ี
อิสร	อ ิ ส ร
ประท้วง	ป ร ะ ท ้ ว ง
ยาก	ย า ก
บน	บ น
บน	บ น
นอย	น อ ย
ยืดหยุ่น	ย ื ด ห ย ุ ่ น
แม้	แ ม ้
การมี	ก า ร ม ี
เปิด	เ ป ิ ด
ผ้า	ผ ้ า
วรรณ	ว ร ร ณ
จาร	จ า ร
โปรโมชั่น	โ ป ร โ ม ช ั ่ น
พูด	พ ู ด
มั่นใจ	ม ั ่ น ใ จ
ปิด	ป ิ ด
พุทรา	พ ุ ท ร า
ฆาตกร	ฆ า ต ก ร
ประจำ	ป ร ะ จ ำ
ทาย	ท า ย
คอลัมน์	ค อ ล ั ม น ์
กุล	ก ุ ล
บน	บ น
ทศ	ท ศ
เสฉวน	เ ส ฉ ว น
สะใภ้	ส ะ ใ ภ ้
เนื้อคู่	เ น ื ้ อ ค ู ่
เพื่อน	เ พ ื ่ อ น
ข้าม	ข ้ า ม
เทนนิส	เ ท น น ิ ส
มาก	ม า ก
เมื่อ	เ ม ื ่ อ
ปิด	ป ิ ด
ผู้สนับสนุน	ผ ู ้ ส น ั บ ส น ุ น
เมื่อ	เ ม ื ่ อ
บน	บ น
ทางซ้าย	ท า ง ซ ้ า ย
ประติมากรรม	ป ร ะ ต ิ ม า ก ร ร ม
เท่าไหร่	เ ท ่ า ไ ห ร ่
มาก	ม า ก
อารย	อ า ร ย
สังสรรค์	ส ั ง ส ร ร ค ์
ปราก	ป ร า ก
แนะนำ	แ น ะ น ำ
เฮ	เ ฮ
มั่นใจ	ม ั ่ น ใ จ
สะพรั่ง	ส ะ พ ร ั ่ ง
ทาย	ท า ย
ไก่	ไ ก ่
มาก	ม า ก
คาวบอย	ค า ว บ อ ย
ช่องว่าง	ช ่ อ ง ว ่ า ง
บน	บ น
บน	บ น
รอยร้าว	ร อ ย ร ้ า ว
นีออน	น ี อ อ น
คอเต่า	ค อ เ ต ่ า
รักษา	ร ั ก ษ า
วลัย	ว ล ั ย
เปิด	เ ป ิ ด
อ้าง	อ ้ า ง
ข้าวสาลี	ข ้ า ว ส า ล ี
โค้ท	โ ค ้ ท
มาก	ม า ก
บำเพ็ญ	บ ำ เ พ ็ ญ
ปิด	ป ิ ด
ฝ้าย	ฝ ้ า ย
ยาก	ย า ก
ร้านอาหาร	ร ้ า น อ า ห า ร
นึ่ง	น ึ ่ ง
ร้านอาหาร	ร ้ า น อ า ห า ร
กรัม	ก ร ั ม
แนะนำ	แ น ะ น ำ
นอย	น อ ย
วินาศ	ว ิ น า ศ
ฆ่าตัวตาย	ฆ ่ า ต ั ว ต า ย
ทศ	ท ศ
บน	บ น
โคโลญจ์	โ ค โ ล ญ จ ์
รักษา	ร ั ก ษ า
ผู้ค้า	ผ ู ้ ค ้ า
ทิ้ง	ท ิ ้ ง
บน	บ น
อัยการ	อ ั ย ก า ร
เครื่องพิมพ์	เ ค ร ื ่ อ ง พ ิ ม พ ์
ร้านอาหาร	ร ้ า น อ า ห า ร
ยาก	ย า ก
สีห์	ส ี ห ์
โบก	โ บ ก
ความเจริญ	ค ว า ม เ จ ร ิ ญ
คลังสินค้า	ค ล ั ง ส ิ น ค ้ า
แม้	แ ม ้
การจัด	ก า ร จ ั ด
รักษา	ร ั ก ษ า
คดี	ค ด ี
บน	บ น
ปิด	ป ิ ด
คดี	ค ด ี
นอย	น อ ย
ราตรี	ร า ต ร ี
เยอะ	เ ย อ ะ
อาสน์	อ า ส น ์
มั่นใจ	ม ั ่ น ใ จ
เมื่อ	เ ม ื ่ อ
เน่า	เ น ่ า
กระพริบ	ก ร ะ พ ร ิ บ
ไก่ทอด	ไ ก ่ ท อ ด
กลิ่น	ก ล ิ ่ น
ส้มตำ	ส ้ ม ต ำ
หลุดพ้น	ห ล ุ ด พ ้ น
ขนส่ง	ข น ส ่ ง
มาก	ม า ก
เกลือ	เ ก ล ื อ
แมง	แ ม ง
ดินเหนียว	ด ิ น เ ห น ี ย ว
ยาก	ย า ก
เฉลิมฉลอง	เ ฉ ล ิ ม ฉ ล อ ง
อิ่มตัว	อ ิ ่ ม ต ั ว
แนะนำ	แ น ะ น ำ
มกร	ม ก ร
สงครามโลกครั้งที่หนึ่ง	ส ง ค ร า ม โ ล ก ค ร ั ้ ง ท ี ่ ห น ึ ่ ง
บน	บ น
เยอะ	เ ย อ ะ
เปิด	เ ป ิ ด
เปิด	เ ป ิ ด
ยิว	ย ิ ว
กางเกง	ก า ง เ ก ง
พระองค์	พ ร ะ อ ง ค ์
มาเฟีย	ม า เ ฟ ี ย
บน	บ น
ปิด	ป ิ ด
สุขลักษณะ	ส ุ ข ล ั ก ษ ณ ะ
กอง	ก อ ง
ช่อ	ช ่ อ
เคี้ยว	เ ค ี ้ ย ว
สวนน้ำ	ส ว น น ้ ำ
ยาก	ย า ก
ห้วง	ห ้ ว ง
เมื่อ	เ ม ื ่ อ
มั่นใจ	ม ั ่ น ใ จ
ประมง	ป ร ะ ม ง
ลมหายใจ	ล ม ห า ย ใ จ
สกลนคร	ส ก ล น ค ร
น้ำจืด	น ้ ำ จ ื ด
ร้อยเอ็ด	ร ้ อ ย เ อ ็ ด
สวน	ส ว น
นึ่ง	น ึ ่ ง
เปิด	เ ป ิ ด
พูด	พ ู ด
ฝั่ง	ฝ ั ่ ง
ระวาง	ร ะ ว า ง
ยาก	ย า ก
ศาสตร์	ศ า ส ต ร ์
คนขับ	ค น ข ั บ
การทาน	ก า ร ท า น
การจัด	ก า ร จ ั ด
มกร	ม ก ร
นอย	น อ ย
หืด	ห ื ด
รับประทาน	ร ั บ ป ร ะ ท า น
แนะนำ	แ น ะ น ำ
เยอะ	เ ย อ ะ
ทศ	ท ศ
การจัด	ก า ร จ ั ด
โทรเลข	โ ท ร เ ล ข
เด็ก	เ ด ็ ก
ทศ	ท ศ
เมื่อ	เ ม ื ่ อ
เฮ	เ ฮ
จิตแพทย์	จ ิ ต แ พ ท ย ์
นึ่ง	น ึ ่ ง
ศิริ	ศ ิ ร ิ
แนะนำ	แ น ะ น ำ
บน	บ น
ฝั่ง	ฝ ั ่ ง
ทิ้ง	ท ิ ้ ง
บน	บ น
อินเทรนด์	อ ิ น เ ท ร น ด ์
สำราญ	ส ำ ร า ญ
ไหล่	ไ ห ล ่
รัม	ร ั ม
หัด	ห ั ด
ดีใจ	ด ี ใ จ
เมื่อ	เ ม ื ่ อ
ยาก	ย า ก
ปล้น	ป ล ้ น
ตุล	ต ุ ล
การอุ้ม	ก า ร อ ุ ้ ม
จาร	จ า ร
พูด	พ ู ด
ค่ะ	ค ่ ะ
จาร	จ า ร
สวน	ส ว น
ช่อ	ช ่ อ
กตัญญู	ก ต ั ญ ญ ู
ชนิด	ช น ิ ด
ทักษิณ	ท ั ก ษ ิ ณ
นึ่ง	น ึ ่ ง
สถานที่	ส ถ า น ท ี ่
มีเพศสัมพันธ์	ม ี เ พ ศ ส ั ม พ ั น ธ ์
เปิด	เ ป ิ ด
วูบ	ว ู บ
ยาก	ย า ก
ทศ	ท ศ
นอย	น อ ย
คนเดียว	ค น เ ด ี ย ว
ขนส่ง	ข น ส ่ ง
นึ่ง	น ึ ่ ง
สิงห์บุรี	ส ิ ง ห ์ บ ุ ร ี
ทุเรียน	ท ุ เ ร ี ย น
อายัด	อ า ย ั ด
มาก	ม า ก
เลื่อย	เ ล ื ่ อ ย
เท่ห์	เ ท ่ ห ์
ข้าม	ข ้ า ม
สตรอว์เบอร์รี่	ส ต ร อ ว ์ เ บ อ ร ์ ร ี ่
ล้น	ล ้ น
เมื่อ	เ ม ื ่ อ
พู่	พ ู ่
เฮ	เ ฮ
ปิด	ป ิ ด
ยาก	ย า ก
การจัด	ก า ร จ ั ด
นอย	น อ ย
ทศ	ท ศ
กุล	ก ุ ล
อวยพร	อ ว ย พ ร
แนะนำ	แ น ะ น ำ
รักษา	ร ั ก ษ า
ติมอร์	ต ิ ม อ ร ์
เฮ	เ ฮ
แย่ง	แ ย ่ ง
ยาก	ย า ก
เยอะ	เ ย อ ะ
มาก	ม า ก
ข้ามชาติ	ข ้ า ม ช า ต ิ
เสียเปรียบ	เ ส ี ย เ ป ร ี ย บ
โม่	โ ม ่
เมื่อ	เ ม ื ่ อ
ผ้า	ผ ้ า
บน	บ น
กอง	ก อ ง
ปราก	ป ร า ก
เชื่อมั่น	เ ช ื ่ อ ม ั ่ น
เซ็กซี่	เ ซ ็ ก ซ ี ่
ผลาญ	ผ ล า ญ
มาก	ม า ก
จาร	จ า ร
นอย	น อ ย
โน่น	โ น ่ น
ข้ออักเสบ	ข ้ อ อ ั ก เ ส บ
มาก	ม า ก
เซ็ง	เ ซ ็ ง
สถานที่	ส ถ า น ท ี ่
น่าเบื่อ	น ่ า เ บ ื ่ อ
ทุกที	ท ุ ก ท ี
บน	บ น
พุง	พ ุ ง
ดวล	ด ว ล
มกร	ม ก ร
การจัด	ก า ร จ ั ด
ไฟหน้า	ไ ฟ ห น ้ า
ทรงผม	ท ร ง ผ ม
กิจการ	ก ิ จ ก า ร
แนะนำ	แ น ะ น ำ
ทูล	ท ู ล
เมื่อ	เ ม ื ่ อ
บน	บ น
มาก	ม า ก
ข้าม	ข ้ า ม
นอย	น อ ย
การจัด	ก า ร จ ั ด
สถานที่	ส ถ า น ท ี ่
ตุล	ต ุ ล
เฮ	เ ฮ
โพรง	โ พ ร ง
คล้ำ	ค ล ้ ำ
โกหก	โ ก ห ก
ทิด	ท ิ ด
ช่อ	ช ่ อ
วรรณ	ว ร ร ณ
เรียง	เ ร ี ย ง
แนะนำ	แ น ะ น ำ
วอลเลย์บอล	ว อ ล เ ล ย ์ บ อ ล
จิ๋ว	จ ิ ๋ ว
ชนมพรรษา	ช น ม พ ร ร ษ า
ตลาดน้ำ	ต ล า ด น ้ ำ
จินดา	จ ิ น ด า
รถไฟใต้ดิน	ร ถ ไ ฟ ใ ต ้ ด ิ น
กุล	ก ุ ล
ฝ้าย	ฝ ้ า ย
ทศ	ท ศ
นอย	น อ ย
คั่ง	ค ั ่ ง
นูน	น ู น
ชนิด	ช น ิ ด
สิ้นสุด	ส ิ ้ น ส ุ ด
เงื่อน	เ ง ื ่ อ น
โปรดเกล้าฯ	โ ป ร ด เ ก ล ้ า ฯ
การถ่ายภาพ	ก า ร ถ ่ า ย ภ า พ
ข้าม	ข ้ า ม
นายจ้าง	น า ย จ ้ า ง
ทศ	ท ศ
โค่น	โ ค ่ น
ยุติ	ย ุ ต ิ
ปิด	ป ิ ด
การจัด	ก า ร จ ั ด
สถานที่	ส ถ า น ท ี ่
บน	บ น
เนื้อร้อง	เ น ื ้ อ ร ้ อ ง
อ้าง	อ ้ า ง
กลีบ	ก ล ี บ
รัม	ร ั ม
มะขาม	ม ะ ข า ม
ประจำ	ป ร ะ จ ำ
นอย	น อ ย
ติชม	ต ิ ช ม
แนะนำ	แ น ะ น ำ
ไก่	ไ ก ่
แม่พิมพ์	แ ม ่ พ ิ ม พ ์
เงื่อน	เ ง ื ่ อ น
ชนิด	ช น ิ ด
เงื่อน	เ ง ื ่ อ น
เงื่อน	เ ง ื ่ อ น
ขนส่ง	ข น ส ่ ง
เฉลิมฉลอง	เ ฉ ล ิ ม ฉ ล อ ง
เพื่อน	เ พ ื ่ อ น
เฮ	เ ฮ
เปิด	เ ป ิ ด
เพื่อน	เ พ ื ่ อ น
ยาก	ย า ก
เปิด	เ ป ิ ด
มะตูม	ม ะ ต ู ม
พูด	พ ู ด
ช่อ	ช ่ อ
โดยสาร	โ ด ย ส า ร
สันติภาพ	ส ั น ต ิ ภ า พ
เถร	เ ถ ร
ความกระตือรือร้น	ค ว า ม ก ร ะ ต ื อ ร ื อ ร ้ น
นึ่ง	น ึ ่ ง
รวน	ร ว น
โรงไฟฟ้า	โ ร ง ไ ฟ ฟ ้ า
นัดหมาย	น ั ด ห ม า ย
ทศ	ท ศ
แม้	แ ม ้
บั่นทอน	บ ั ่ น ท อ น
เฮ	เ ฮ
เด็ก	เ ด ็ ก
นอย	น อ ย
ทำซ้ำ	ท ำ ซ ้ ำ
การจัด	ก า ร จ ั ด
การจัด	ก า ร จ ั ด
รักษา	ร ั ก ษ า
ลงชื่อ	ล ง ช ื ่ อ
สหภาพยุโรป	ส ห ภ า พ ย ุ โ ร ป
ช่อ	ช ่ อ
บน	บ น
เดลี	เ ด ล ี
มกร	ม ก ร
รักษา	ร ั ก ษ า
จาร	จ า ร
เซ็ง	เ ซ ็ ง
ค่ะ	ค ่ ะ
ไอซ์แลนด์	ไ อ ซ ์ แ ล น ด ์
แม้	แ ม ้
เยอะ	เ ย อ ะ
ลูกเสือ	ล ู ก เ ส ื อ
พระองค์	พ ร ะ อ ง ค ์
ชนิด	ช น ิ ด
การอำนวย	ก า ร อ ำ น ว ย
เด็ก	เ ด ็ ก
นักกอล์ฟ	น ั ก ก อ ล ์ ฟ
โสม	โ ส ม
มั่นใจ	ม ั ่ น ใ จ
ปิด	ป ิ ด
บน	บ น
ผ้า	ผ ้ า
ติชม	ต ิ ช ม
บน	บ น
ไก่	ไ ก ่
วิกิพีเดีย	ว ิ ก ิ พ ี เ ด ี ย
สืบทอด	ส ื บ ท อ ด
นึ่ง	น ึ ่ ง
ฟู	ฟ ู
มาก	ม า ก
เด็ก	เ ด ็ ก
รัศมี	ร ั ศ ม ี
นอย	น อ ย
การนั่ง	ก า ร น ั ่ ง
วรรณ	ว ร ร ณ
บน	บ น
ยาก	ย า ก
ร้านอาหาร	ร ้ า น อ า ห า ร
เปิด	เ ป ิ ด
เป็นห่วง	เ ป ็ น ห ่ ว ง
ทศ	ท ศ
แม้	แ ม ้
เยอะ	เ ย อ ะ
ปราก	ป ร า ก
ข้าม	ข ้ า ม
พูด	พ ู ด
เยอะ	เ ย อ ะ
อิสร	อ ิ ส ร
บรรยากาศ	บ ร ร ย า ก า ศ
กุล	ก ุ ล
จงรัก	จ ง ร ั ก
ลามา	ล า ม า
ไฮโซ	ไ ฮ โ ซ
บรรยากาศ	บ ร ร ย า ก า ศ
อัญมณี	อ ั ญ ม ณ ี
โกดัง	โ ก ด ั ง
ประทับใจ	ป ร ะ ท ั บ ใ จ
เปิด	เ ป ิ ด
เปิด	เ ป ิ ด
โจน	โ จ น
ไหล่	ไ ห ล ่
เปิด	เ ป ิ ด
มาก	ม า ก
เยีย	เ ย ี ย
เภสัชกร	เ ภ ส ั ช ก ร
วิวาท	ว ิ ว า ท
ยาก	ย า ก
กอง	ก อ ง
ข้าม	ข ้ า ม
ผ้า	ผ ้ า
เด็ก	เ ด ็ ก
บน	บ น
เมื่อ	เ ม ื ่ อ
ทุกที	ท ุ ก ท ี
บน	บ น
การกรอก	ก า ร ก ร อ ก
โกดัง	โ ก ด ั ง
มกร	ม ก ร
การจัด	ก า ร จ ั ด
นิพนธ์	น ิ พ น ธ ์
ประจำ	ป ร ะ จ ำ
เมื่อ	เ ม ื ่ อ
เลขา	เ ล ข า
ทั้งวัน	ท ั ้ ง ว ั น
บน	บ น
ลิบ	ล ิ บ
ระบบนิเวศ	ร ะ บ บ น ิ เ ว ศ
หัก	ห ั ก
มาก	ม า ก
ขบวนการ	ข บ ว น ก า ร
ฆาตกร	ฆ า ต ก ร
ศาสตร์	ศ า ส ต ร ์
บน	บ น
นอย	น อ ย
ประจำ	ป ร ะ จ ำ
เพื่อน	เ พ ื ่ อ น
ปิด	ป ิ ด
หัก	ห ั ก
เมื่อ	เ ม ื ่ อ
นักพากย์	น ั ก พ า ก ย ์
ข้าม	ข ้ า ม
นึ่ง	น ึ ่ ง
ค้อน	ค ้ อ น
บน	บ น
เกลี้ยง	เ ก ล ี ้ ย ง
ผาย	ผ า ย
ยาก	ย า ก
ข้าม	ข ้ า ม
ทุกที	ท ุ ก ท ี
ลมหายใจ	ล ม ห า ย ใ จ
สุม	ส ุ ม
หมวก	ห ม ว ก
ปิด	ป ิ ด
โดยสาร	โ ด ย ส า ร
ยืดหยุ่น	ย ื ด ห ย ุ ่ น
แม้	แ ม ้
ความลึก	ค ว า ม ล ึ ก
เมื่อ	เ ม ื ่ อ
เพื่อน	เ พ ื ่ อ น
บัวหลวง	บ ั ว ห ล ว ง
การจัด	ก า ร จ ั ด
กระวนกระวาย	ก ร ะ ว น ก ร ะ ว า ย
ตะขอ	ต ะ ข อ
ค่ะ	ค ่ ะ
อิจฉา	อ ิ จ ฉ า
บอดี้	บ อ ด ี ้
พนา	พ น า
โบ้	โ บ ้
เงื่อน	เ ง ื ่ อ น
กอง	ก อ ง
มาเล	ม า เ ล
ซามูไร	ซ า ม ู ไ ร
ทศ	ท ศ
สัมปทาน	ส ั ม ป ท า น
ปราก	ป ร า ก
ค่ะ	ค ่ ะ
รักษา	ร ั ก ษ า
หมวกนิรภัย	ห ม ว ก น ิ ร ภ ั ย
ปักกิ่ง	ป ั ก ก ิ ่ ง
ขั้วโลก	ข ั ้ ว โ ล ก
ปฏิวัติ	ป ฏ ิ ว ั ต ิ
ศาสตร์	ศ า ส ต ร ์
มาก	ม า ก
แนะนำ	แ น ะ น ำ
ยาก	ย า ก
เบ็ด	เ บ ็ ด
มกร	ม ก ร
ปราก	ป ร า ก
ย่าม	ย ่ า ม
สงบ	ส ง บ
ยาก	ย า ก
ร้านอาหาร	ร ้ า น อ า ห า ร
ปิด	ป ิ ด
สวน	ส ว น
บรรยากาศ	บ ร ร ย า ก า ศ
มั่นใจ	ม ั ่ น ใ จ
คล้ำ	ค ล ้ ำ
ราชพฤกษ์	ร า ช พ ฤ ก ษ ์
รักษา	ร ั ก ษ า
ค่ะ	ค ่ ะ
แองโกลา	แ อ ง โ ก ล า
อวกาศ	อ ว ก า ศ
การจัด	ก า ร จ ั ด
ทักษิณ	ท ั ก ษ ิ ณ
ราตรี	ร า ต ร ี
ป่าไม้	ป ่ า ไ ม ้
มาก	ม า ก
โดยสาร	โ ด ย ส า ร
สุขสันต์	ส ุ ข ส ั น ต ์
ประจำ	ป ร ะ จ ำ
มาก	ม า ก
ปราก	ป ร า ก
ใส่ไฟ	ใ ส ่ ไ ฟ
ทัพเรือ	ท ั พ เ ร ื อ
รัม	ร ั ม
ไข้หวัดใหญ่	ไ ข ้ ห ว ั ด ใ ห ญ ่
ฝั่ง	ฝ ั ่ ง
เพื่อน	เ พ ื ่ อ น
ทศ	ท ศ
ทศ	ท ศ
ผู้สนับสนุน	ผ ู ้ ส น ั บ ส น ุ น
อุ่นใจ	อ ุ ่ น ใ จ
ยาก	ย า ก
รักษา	ร ั ก ษ า
คลังสินค้า	ค ล ั ง ส ิ น ค ้ า
ล็อบสเตอร์	ล ็ อ บ ส เ ต อ ร ์
สถานที่	ส ถ า น ท ี ่
การจัด	ก า ร จ ั ด
พาสปอร์ต	พ า ส ป อ ร ์ ต
พสกนิกร	พ ส ก น ิ ก ร
ประจำ	ป ร ะ จ ำ
ทาย	ท า ย
แนะนำ	แ น ะ น ำ
วรรณ	ว ร ร ณ
อัญมณี	อ ั ญ ม ณ ี
โมเลกุล	โ ม เ ล ก ุ ล
ปลีก	ป ล ี ก
กอง	ก อ ง
ปิด	ป ิ ด
ดื้อ	ด ื ้ อ
เมื่อ	เ ม ื ่ อ
บน	บ น
ทศ	ท ศ
นึ่ง	น ึ ่ ง
บน	บ น
ทาย	ท า ย
เลขา	เ ล ข า
โทรสาร	โ ท ร ส า ร
รถยก	ร ถ ย ก
ข้าม	ข ้ า ม
พลุ	พ ล ุ
มุข	ม ุ ข
อ้าง	อ ้ า ง
รถดับเพลิง	ร ถ ด ั บ เ พ ล ิ ง
เยอะ	เ ย อ ะ
กุล	ก ุ ล
๒๐	๒ ๐
ยาก	ย า ก
ภาพประกอบ	ภ า พ ป ร ะ ก อ บ
หัวหอก	ห ั ว ห อ ก
ปิด	ป ิ ด
ทศ	ท ศ
อัตราส่วน	อ ั ต ร า ส ่ ว น
แนะนำ	แ น ะ น ำ
บน	บ น
สมมติ	ส ม ม ต ิ
เซ็กซี่	เ ซ ็ ก ซ ี ่
เต่ง	เ ต ่ ง
กุฏิ	ก ุ ฏ ิ
ข้าม	ข ้ า ม
บำเพ็ญ	บ ำ เ พ ็ ญ
ชุดชั้นใน	ช ุ ด ช ั ้ น ใ น
ค้าน	ค ้ า น
การมี	ก า ร ม ี
หมวก	ห ม ว ก
เทห์	เ ท ห ์
ฮังการี	ฮ ั ง ก า ร ี
แสงอาทิตย์	แ ส ง อ า ท ิ ต ย ์
มาก	ม า ก
ผู้สนับสนุน	ผ ู ้ ส น ั บ ส น ุ น
ผ้า	ผ ้ า
มั่นใจ	ม ั ่ น ใ จ
ปลีก	ป ล ี ก
ผ้า	ผ ้ า
ยาก	ย า ก
เปิด	เ ป ิ ด
เมื่อ	เ ม ื ่ อ
เด็ก	เ ด ็ ก
ทศ	ท ศ
นอย	น อ ย
พูด	พ ู ด
หมวก	ห ม ว ก
นึ่ง	น ึ ่ ง
อัลลอฮ์	อ ั ล ล อ ฮ ์
ต้มตุ๋น	ต ้ ม ต ุ ๋ น
หายใจเข้า	ห า ย ใ จ เ ข ้ า
ปิด	ป ิ ด
สวน	ส ว น
ศาสตร์	ศ า ส ต ร ์
ประดู่	ป ร ะ ด ู ่
แม้	แ ม ้
วรรณ	ว ร ร ณ
ชนิด	ช น ิ ด
แม้	แ ม ้
บรรยากาศ	บ ร ร ย า ก า ศ
จาร	จ า ร
ค่ะ	ค ่ ะ
ทศ	ท ศ
ยาก	ย า ก
มาก	ม า ก
เนื้องอก	เ น ื ้ อ ง อ ก
เปิด	เ ป ิ ด
นอย	น อ ย
ผับ	ผ ั บ
แม้	แ ม ้
รัม	ร ั ม
แม้	แ ม ้
ประติมากรรม	ป ร ะ ต ิ ม า ก ร ร ม
นอย	น อ ย
ทศ	ท ศ
มลภาวะ	ม ล ภ า ว ะ
สงบ	ส ง บ
ครั้งนั้น	ค ร ั ้ ง น ั ้ น
นอย	น อ ย
การมี	ก า ร ม ี
ผู้ใหญ่บ้าน	ผ ู ้ ใ ห ญ ่ บ ้ า น
ข้าม	ข ้ า ม
หนอนหนังสือ	ห น อ น ห น ั ง ส ื อ
กฐิน	ก ฐ ิ น
ยาก	ย า ก
คำนำ	ค ำ น ำ
ลมพิษ	ล ม พ ิ ษ
สวน	ส ว น
สงบ	ส ง บ
กุล	ก ุ ล
นึ่ง	น ึ ่ ง
เปิด	เ ป ิ ด
เมื่อ	เ ม ื ่ อ
นึ่ง	น ึ ่ ง
วรรณ	ว ร ร ณ
ร้านอาหาร	ร ้ า น อ า ห า ร
นึ่ง	น ึ ่ ง
ศาสตร์	ศ า ส ต ร ์
ร้านอาหาร	ร ้ า น อ า ห า ร
สถานที่	ส ถ า น ท ี ่
สแควร์	ส แ ค ว ร ์
ปั่น	ป ั ่ น
ยาก	ย า ก
เชิด	เ ช ิ ด
แรงม้า	แ ร ง ม ้ า
เฮ	เ ฮ
ทาย	ท า ย
นอย	น อ ย
มาก	ม า ก
ข้าม	ข ้ า ม
เสื้อเชิ้ต	เ ส ื ้ อ เ ช ิ ้ ต
ชำระ	ช ำ ร ะ
บน	บ น
อิสราเอล	อ ิ ส ร า เ อ ล
มาก	ม า ก
อารย	อ า ร ย
ช่อ	ช ่ อ
นึ่ง	น ึ ่ ง
รักษา	ร ั ก ษ า
นอย	น อ ย
จาร	จ า ร
ภัยแล้ง	ภ ั ย แ ล ้ ง
อิสร	อ ิ ส ร
เพื่อน	เ พ ื ่ อ น
เท่าไหร่	เ ท ่ า ไ ห ร ่
สวน	ส ว น
ศิริ	ศ ิ ร ิ
อิจฉา	อ ิ จ ฉ า
สถานที่	ส ถ า น ท ี ่
พูด	พ ู ด
ข้าม	ข ้ า ม
ทศ	ท ศ
ค่ะ	ค ่ ะ
สาหร่าย	ส า ห ร ่ า ย
ประทับใจ	ป ร ะ ท ั บ ใ จ
หูก	ห ู ก
เพ้อ	เ พ ้ อ
เลขา	เ ล ข า
เปิด	เ ป ิ ด
เจาะ	เ จ า ะ
เจาะ	เ จ า ะ
การจัด	ก า ร จ ั ด
ค่าแรง	ค ่ า แ ร ง
มกร	ม ก ร
ปิด	ป ิ ด
รัม	ร ั ม
ผิง	ผ ิ ง
เมื่อ	เ ม ื ่ อ
ฟู	ฟ ู
อาวุธนิวเคลียร์	อ า ว ุ ธ น ิ ว เ ค ล ี ย ร ์
ข้าม	ข ้ า ม
เด็ก	เ ด ็ ก
นอย	น อ ย
วิสามัญ	ว ิ ส า ม ั ญ
เปิด	เ ป ิ ด
ปั่น	ป ั ่ น
ลำคอ	ล ำ ค อ
สุจริต	ส ุ จ ร ิ ต
รับประทาน	ร ั บ ป ร ะ ท า น
สโมสร	ส โ ม ส ร
เลยไป	เ ล ย ไ ป
ค่ะ	ค ่ ะ
มะกรูด	ม ะ ก ร ู ด
ตึ๊ง	ต ึ ๊ ง
ทศ	ท ศ
รักษา	ร ั ก ษ า
เถียง	เ ถ ี ย ง
รองเท้าแตะ	ร อ ง เ ท ้ า แ ต ะ
เปิด	เ ป ิ ด
ประสิทธิ์	ป ร ะ ส ิ ท ธ ิ ์
เมื่อ	เ ม ื ่ อ
ยาก	ย า ก
นึ่ง	น ึ ่ ง
ประชาธิปัตย์	ป ร ะ ช า ธ ิ ป ั ต ย ์
รัม	ร ั ม
สวน	ส ว น
ฅ	ฅ
นึ่ง	น ึ ่ ง
ยาก	ย า ก
การอุ้ม	ก า ร อ ุ ้ ม
ช่อ	ช ่ อ
เต็มใจ	เ ต ็ ม ใ จ
คัมภีร์	ค ั ม ภ ี ร ์
การจัด	ก า ร จ ั ด
ทาย	ท า ย
ชาเขียว	ช า เ ข ี ย ว
การสัญญา	ก า ร ส ั ญ ญ า
กิจการ	ก ิ จ ก า ร
กริ่ง	ก ร ิ ่ ง
มาก	ม า ก
เยอะ	เ ย อ ะ
เมื่อ	เ ม ื ่ อ
จาร	จ า ร
วรรณ	ว ร ร ณ
จาร	จ า ร
โดยสาร	โ ด ย ส า ร
การฆ่าตัวตาย	ก า ร ฆ ่ า ต ั ว ต า ย
ดาม	ด า ม
ดีใจ	ด ี ใ จ
แนะนำ	แ น ะ น ำ
ทิ้ง	ท ิ ้ ง
เซ็กซี่	เ ซ ็ ก ซ ี ่
เปิด	เ ป ิ ด
นึ่ง	น ึ ่ ง
ศาสตร์	ศ า ส ต ร ์
นอย	น อ ย
ทั้งวัน	ท ั ้ ง ว ั น
การจัด	ก า ร จ ั ด
ลดราคา	ล ด ร า ค า
การมี	ก า ร ม ี
มาก	ม า ก
เมื่อ	เ ม ื ่ อ
กินข้าว	ก ิ น ข ้ า ว
นอย	น อ ย
นึ่ง	น ึ ่ ง
สถานที่	ส ถ า น ท ี ่
นึ่ง	น ึ ่ ง
เนตร	เ น ต ร
กระดูกเชิงกราน	ก ร ะ ด ู ก เ ช ิ ง ก ร า น
กระหาย	ก ร ะ ห า ย
จาร	จ า ร
มิลลิลิตร	ม ิ ล ล ิ ล ิ ต ร
เคลื่อนที่	เ ค ล ื ่ อ น ท ี ่
พลัด	พ ล ั ด
รถแข่ง	ร ถ แ ข ่ ง
เปิด	เ ป ิ ด
แนะนำ	แ น ะ น ำ
