批判理論	批 判 理 論
念珠菌症	念 珠 菌 症
嘰嘰歪歪	嘰 嘰 歪 歪
睇脉	睇 脉
支庶	支 庶
纳粹主义	纳 粹 主 义
發汗	發 汗
鰟	鰟
熟行	熟 行
扢	扢
美容	美 容
气肿	气 肿
權變	權 變
甚至于	甚 至 于
曦和	曦 和
痙攣	痙 攣
结清	结 清
越航	越 航
鼻飼	鼻 飼
司馬斤	司 馬 斤
烤肉串	烤 肉 串
發射臺	發 射 臺
錦雞	錦 雞
看輕人	看 輕 人
偃月刀	偃 月 刀
馬騮	馬 騮
戲玉	戲 玉
眼寃	眼 寃
腳球	腳 球
诱敌深入	诱 敌 深 入
廁缸	廁 缸
够呛	够 呛
富含	富 含
晚高峰	晚 高 峰
大酒店	大 酒 店
尼科西亚	尼 科 西 亚
車速	車 速
母艦	母 艦
辛苦你了	辛 苦 你 了
粘着剂	粘 着 剂
贴金	贴 金
發狼戾	發 狼 戾
目瞨	目 瞨
知法犯法	知 法 犯 法
下週	下 週
本征值	本 征 值
不孕症	不 孕 症
門簾	門 簾
丧乱	丧 乱
止饥	止 饥
廣告牌	廣 告 牌
法學碩士	法 學 碩 士
黑户口	黑 户 口
直窦	直 窦
每隔	每 隔
落叶归根	落 叶 归 根
土产	土 产
乍浦	乍 浦
巧奪天工	巧 奪 天 工
低級脂肪酸	低 級 脂 肪 酸
印度話	印 度 話
电光石火	电 光 石 火
磁力共振	磁 力 共 振
这辄	这 辄
㜫	㜫
膨風	膨 風
草昧	草 昧
娘仔茧	娘 仔 茧
狡鬼	狡 鬼
断刑	断 刑
曬	曬
弼馬温	弼 馬 温
𬑓	𬑓
百無聊賴	百 無 聊 賴
假设	假 设
沧县	沧 县
南方人	南 方 人
㟙	㟙
知书达礼	知 书 达 礼
初生之犢	初 生 之 犢
馬厩	馬 厩
癌細胞	癌 細 胞
事后诸葛亮	事 后 诸 葛 亮
浪白澳	浪 白 澳
𩨑	𩨑
西方中心主義	西 方 中 心 主 義
百业	百 业
检视	检 视
诱杀	诱 杀
𠢤	𠢤
激光打印机	激 光 打 印 机
致癌物	致 癌 物
壞勢	壞 勢
藏布	藏 布
艺文志	艺 文 志
𰥨	𰥨
由利本庄	由 利 本 庄
智慧型	智 慧 型
C調	C 調
攻擊者	攻 擊 者
北綫	北 綫
肒	肒
阵容	阵 容
菊頭蝠	菊 頭 蝠
爱心座位	爱 心 座 位
新春	新 春
背根	背 根
接地線	接 地 線
陵墓	陵 墓
妨事	妨 事
皱起眉头	皱 起 眉 头
烫	烫
室撲	室 撲
时间差	时 间 差
涼浸浸	涼 浸 浸
重擊	重 擊
飠	飠
通解	通 解
悸动	悸 动
饥不择食	饥 不 择 食
风蚊	风 蚊
大片陸地	大 片 陸 地
奖杯	奖 杯
巴尔扎克	巴 尔 扎 克
缴场	缴 场
腎衰竭	腎 衰 竭
关内	关 内
穿模	穿 模
蔽天	蔽 天
銀河落九天	銀 河 落 九 天
座子	座 子
打骂	打 骂
江米酒	江 米 酒
無止境	無 止 境
金帳汗國	金 帳 汗 國
諾里奇	諾 里 奇
邮船	邮 船
骨灰级	骨 灰 级
人人自危	人 人 自 危
象教	象 教
剿匪	剿 匪
力排衆議	力 排 衆 議
上計	上 計
镊子把儿	镊 子 把 儿
单耳刀	单 耳 刀
问讯	问 讯
烏影	烏 影
雕敝	雕 敝
纽丝纶	纽 丝 纶
男优	男 优
鵝春石	鵝 春 石
指檢	指 檢
粙屑	粙 屑
日中心裡	日 中 心 裡
剫	剫
損折	損 折
行事曆	行 事 曆
蕭蕭	蕭 蕭
娱乐城	娱 乐 城
威迫利誘	威 迫 利 誘
酯化反应	酯 化 反 应
花靈花體	花 靈 花 體
三錄儀	三 錄 儀
一無所長	一 無 所 長
狐裘	狐 裘
㔜	㔜
克孜勒蘇	克 孜 勒 蘇
安民告示	安 民 告 示
大款	大 款
一次函數	一 次 函 數
後遺症	後 遺 症
尖嘴钳	尖 嘴 钳
穗城	穗 城
马奶酒	马 奶 酒
帕拉马里博	帕 拉 马 里 博
粜	粜
裁断	裁 断
脊蛙	脊 蛙
太阳节	太 阳 节
楊樹窪	楊 樹 窪
腐生葡萄球菌	腐 生 葡 萄 球 菌
運轉手	運 轉 手
求簽	求 簽
马耳他语	马 耳 他 语
径情直遂	径 情 直 遂
哈米吉多頓	哈 米 吉 多 頓
旨趣	旨 趣
諮詢師	諮 詢 師
貁	貁
入藥	入 藥
噪音污染	噪 音 污 染
野史	野 史
按鬧分配	按 鬧 分 配
流水不腐，戶樞不蠧	流 水 不 腐 ， 戶 樞 不 蠧
牧师	牧 师
牛奶蛇	牛 奶 蛇
郵便箱	郵 便 箱
崢	崢
折凳	折 凳
土卫五	土 卫 五
敬告	敬 告
紧凑	紧 凑
居間	居 間
縫縫兒	縫 縫 兒
葉里温	葉 里 温
𤆜	𤆜
蠖	蠖
东南亚	东 南 亚
恶感	恶 感
長骨	長 骨
亞瑟王	亞 瑟 王
东北虎	东 北 虎
向量空间	向 量 空 间
硝酸	硝 酸
鉆子	鉆 子
咸溼鬼	咸 溼 鬼
缟素	缟 素
松糕	松 糕
編務	編 務
𪎈	𪎈
物產	物 產
獨有	獨 有
倒時差	倒 時 差
帝國	帝 國
药企	药 企
當雄	當 雄
𫠦	𫠦
鷠	鷠
陪審團	陪 審 團
讘	讘
暖水壶	暖 水 壶
擦抹	擦 抹
懲一儆百	懲 一 儆 百
艑	艑
頂高	頂 高
犂明	犂 明
伴唱	伴 唱
公称	公 称
性交体位	性 交 体 位
牛油	牛 油
与那国岛	与 那 国 岛
咯咯雞	咯 咯 雞
傅立葉	傅 立 葉
肉酸	肉 酸
同姒仔	同 姒 仔
頩	頩
儻	儻
法事	法 事
䬅	䬅
或是	或 是
竖折弯钩	竖 折 弯 钩
纨	纨
拼输赢	拼 输 赢
零線	零 線
非人化	非 人 化
嫸	嫸
步行	步 行
詤	詤
附子	附 子
纽约客	纽 约 客
慶輝	慶 輝
矇	矇
涂沟仔糜	涂 沟 仔 糜
挪威海	挪 威 海
表面子	表 面 子
時人	時 人
掩体	掩 体
火旁	火 旁
草粿	草 粿
住居	住 居
单三三	单 三 三
蝦片	蝦 片
华南虎	华 南 虎
高麗薓	高 麗 薓
日元	日 元
时限	时 限
茵陈	茵 陈
𫍽	𫍽
屢	屢
𬬿	𬬿
冰絃	冰 絃
备耕	备 耕
食住	食 住
飞蛾	飞 蛾
醬豆腐	醬 豆 腐
馬陵山	馬 陵 山
旋轉肌群	旋 轉 肌 群
粧容	粧 容
㔊	㔊
以身試法	以 身 試 法
女祭司	女 祭 司
席捲	席 捲
个人照	个 人 照
樹葬	樹 葬
裙甩褲甩	裙 甩 褲 甩
阿茂整饼——冇嗰样，整嗰样	阿 茂 整 饼 — — 冇 嗰 样 ， 整 嗰 样
破四舊	破 四 舊
簷老鼠兒	簷 老 鼠 兒
獸醫學	獸 醫 學
北嶺	北 嶺
豬跤	豬 跤
问礼	问 礼
𰜳	𰜳
汛期	汛 期
行角子	行 角 子
乖剌	乖 剌
品红色	品 红 色
防滑	防 滑
亃	亃
名不副實	名 不 副 實
漏電	漏 電
逗逼	逗 逼
花纹	花 纹
裤兜	裤 兜
不妨	不 妨
细茶	细 茶
相模原	相 模 原
這兜	這 兜
腰椎穿刺	腰 椎 穿 刺
牙簽	牙 簽
壓下	壓 下
慢性阻塞性肺病	慢 性 阻 塞 性 肺 病
歹徛	歹 徛
做空	做 空
悽惶	悽 惶
關切	關 切
线装书	线 装 书
鷹手營子	鷹 手 營 子
高光	高 光
岍	岍
勇于	勇 于
魖	魖
剧名	剧 名
中史	中 史
壀	壀
死機	死 機
懙	懙
戛纳	戛 纳
格鲁吉亚人	格 鲁 吉 亚 人
句法学	句 法 学
转移酶	转 移 酶
汙泥濁水	汙 泥 濁 水
遊鄉	遊 鄉
梁家河	梁 家 河
新闻社	新 闻 社
用處	用 處
沙质	沙 质
抹面	抹 面
菌褶	菌 褶
撮口呼	撮 口 呼
即食面	即 食 面
𱊡	𱊡
教習	教 習
真理報	真 理 報
㞶	㞶
佛家	佛 家
甬剧	甬 剧
煉丹術	煉 丹 術
莎雞	莎 雞
挹注	挹 注
阴悄悄	阴 悄 悄
煲飯	煲 飯
枵人	枵 人
卖国贼	卖 国 贼
年夜卅边	年 夜 卅 边
𬴅𬴅	𬴅 𬴅
攑	攑
曹白魚	曹 白 魚
望遠鏡	望 遠 鏡
路易斯維爾	路 易 斯 維 爾
麻醉師	麻 醉 師
下宮	下 宮
草头	草 头
东航	东 航
龙王垭	龙 王 垭
太上感應篇	太 上 感 應 篇
肐	肐
依俙	依 俙
斗鸡	斗 鸡
㙷	㙷
怪病	怪 病
灵景	灵 景
东北抗联	东 北 抗 联
绝户	绝 户
股癣	股 癣
撞祸	撞 祸
书册	书 册
拿坡里	拿 坡 里
切图马尔	切 图 马 尔
遠祖	遠 祖
筨𥳔	筨 𥳔
未遂	未 遂
卖出	卖 出
囝儿	囝 儿
挂住	挂 住
癇	癇
贅生物	贅 生 物
鸚歌	鸚 歌
所有制	所 有 制
谤	谤
核工程	核 工 程
症	症
长碛	长 碛
英制	英 制
跑動	跑 動
赤帜	赤 帜
甑	甑
柳枝癀	柳 枝 癀
䫞	䫞
高壓	高 壓
冷語	冷 語
雁鹅	雁 鹅
𢄫	𢄫
讲不听	讲 不 听
水果湖	水 果 湖
竹东	竹 东
橙色革命	橙 色 革 命
肺切除术	肺 切 除 术
老日	老 日
南共联盟	南 共 联 盟
雞隻	雞 隻
鐵甲車	鐵 甲 車
共青城	共 青 城
苗瑶语系	苗 瑶 语 系
三角恋	三 角 恋
劉店	劉 店
火镰	火 镰
澏	澏
暗間兒	暗 間 兒
编录	编 录
美国独立战争	美 国 独 立 战 争
机器匠	机 器 匠
眼光光	眼 光 光
眞空	眞 空
替角兒	替 角 兒
老舊	老 舊
记音	记 音
不依	不 依
一於	一 於
神学生	神 学 生
豆腐	豆 腐
𠔁	𠔁
袜套	袜 套
傻瓜机	傻 瓜 机
有氣無力	有 氣 無 力
馆山	馆 山
賽果	賽 果
饭山	饭 山
趁勢	趁 勢
唐猊铠甲	唐 猊 铠 甲
二級醇	二 級 醇
巴林	巴 林
父愛主義	父 愛 主 義
印刷体	印 刷 体
透地雨	透 地 雨
车本儿	车 本 儿
䚌	䚌
飛速	飛 速
集體回憶	集 體 回 憶
衝擊波	衝 擊 波
目珠花	目 珠 花
集大成	集 大 成
䳍	䳍
闪音	闪 音
𨊰	𨊰
发火癀	发 火 癀
未足轻重	未 足 轻 重
嵲	嵲
生酮作用	生 酮 作 用
唔该	唔 该
斑鳩琴	斑 鳩 琴
产区	产 区
基督敎	基 督 敎
卖弄	卖 弄
翼翼	翼 翼
不知有汉，何论魏晋	不 知 有 汉 ， 何 论 魏 晋
辦學	辦 學
蚲	蚲
驢騾	驢 騾
末子	末 子
陳米	陳 米
身家性命	身 家 性 命
乌麻油	乌 麻 油
个资	个 资
邙	邙
老气横秋	老 气 横 秋
杯仔麵	杯 仔 麵
镛	镛
砂矿	砂 矿
背鰭	背 鰭
臮	臮
眼不见为净	眼 不 见 为 净
杀伤性	杀 伤 性
宜君	宜 君
萬馬奔騰	萬 馬 奔 騰
苹婆	苹 婆
花王	花 王
丧家	丧 家
強權政治	強 權 政 治
飢腸轆轆	飢 腸 轆 轆
绉绸	绉 绸
韋式	韋 式
澱	澱
杜拉铝	杜 拉 铝
有邊讀邊	有 邊 讀 邊
臀肌	臀 肌
名镇	名 镇
橡果	橡 果
昳丽	昳 丽
芭芭雅嘎	芭 芭 雅 嘎
哔叽	哔 叽
嗪	嗪
煙屁股	煙 屁 股
瑞金	瑞 金
掌頭仔	掌 頭 仔
万恶淫为首	万 恶 淫 为 首
接种	接 种
殡车	殡 车
袂見笑	袂 見 笑
用来	用 来
白鵝	白 鵝
压载	压 载
客观	客 观
下跤手	下 跤 手
朗如	朗 如
軍情	軍 情
鵾雞絃	鵾 雞 絃
遺禍	遺 禍
褲子腳管	褲 子 腳 管
花街	花 街
泰王國	泰 王 國
超越次数	超 越 次 数
孟什維克	孟 什 維 克
爭鬥者	爭 鬥 者
湓	湓
别传	别 传
翕盅	翕 盅
川西	川 西
月初	月 初
萍乡	萍 乡
綠內障	綠 內 障
鼻準	鼻 準
勳章	勳 章
現車	現 車
五筆字型	五 筆 字 型
紐阿連	紐 阿 連
烏暗	烏 暗
作画	作 画
桑珠孜	桑 珠 孜
前凉	前 凉
上衣	上 衣
挖牆腳	挖 牆 腳
𥲥	𥲥
禅学	禅 学
甩尾	甩 尾
投资性	投 资 性
開考	開 考
解毒药	解 毒 药
大楷	大 楷
彩飾	彩 飾
齶	齶
暋	暋
意頭	意 頭
連生貴子	連 生 貴 子
决择	决 择
出仕	出 仕
贷出	贷 出
香氣子	香 氣 子
奥斯曼帝国	奥 斯 曼 帝 国
暴死	暴 死
䛏	䛏
肱桡肌	肱 桡 肌
竹林	竹 林
宾白	宾 白
吃槍藥	吃 槍 藥
遺	遺
体味	体 味
氠	氠
開赴	開 赴
蕃熟	蕃 熟
惠风	惠 风
社会效益	社 会 效 益
布拉戈维申斯克	布 拉 戈 维 申 斯 克
叔仔	叔 仔
經營	經 營
輪船	輪 船
眼力	眼 力
梅菜扣肉	梅 菜 扣 肉
糖皮质激素	糖 皮 质 激 素
先秦	先 秦
滙豐	滙 豐
分会	分 会
非主流	非 主 流
杏	杏
肾病症候群	肾 病 症 候 群
恢復力	恢 復 力
威南	威 南
酓	酓
武昌鱼	武 昌 鱼
拉哥斯	拉 哥 斯
不伦	不 伦
繡球	繡 球
柘榮	柘 榮
日哄	日 哄
真奈	真 奈
封建主义	封 建 主 义
嘸然	嘸 然
膀兒	膀 兒
薩拉米	薩 拉 米
蹦极	蹦 极
桂圆儿	桂 圆 儿
叶书	叶 书
肌體	肌 體
肾子	肾 子
㹓	㹓
法学家	法 学 家
法线	法 线
痊	痊
蘇梅	蘇 梅
焦渴	焦 渴
來由	來 由
達磨	達 磨
补物	补 物
絲質	絲 質
耶律	耶 律
鳩山	鳩 山
烂人	烂 人
㚓	㚓
蟲竇	蟲 竇
数柜	数 柜
彑	彑
北京话	北 京 话
有向圖	有 向 圖
髮型屋	髮 型 屋
今兒	今 兒
桌头磅	桌 头 磅
吐納	吐 納
鉅款	鉅 款
多難興邦	多 難 興 邦
對門	對 門
拍相滥	拍 相 滥
回顧展	回 顧 展
莫过于	莫 过 于
乱讲	乱 讲
青铜器	青 铜 器
丝绞边	丝 绞 边
部隊鍋	部 隊 鍋
盧	盧
俸金	俸 金
併存	併 存
汉越词	汉 越 词
新儂官	新 儂 官
花燭	花 燭
瓜地马拉	瓜 地 马 拉
歹市	歹 市
过犹不及	过 犹 不 及
課試	課 試
美中不足	美 中 不 足
轄制	轄 制
鵴	鵴
語用	語 用
口水仗	口 水 仗
甘冈	甘 冈
省略号	省 略 号
糧秣	糧 秣
熒煌	熒 煌
良言	良 言
鷮	鷮
公例	公 例
晛	晛
𨙸	𨙸
佃農	佃 農
不虞	不 虞
镕冶	镕 冶
早期教育	早 期 教 育
葱头	葱 头
柿仔	柿 仔
同花顺	同 花 顺
企起身	企 起 身
风波	风 波
林海	林 海
板烟	板 烟
鹌鹑儿	鹌 鹑 儿
工鈿	工 鈿
颎	颎
山雞舞鏡	山 雞 舞 鏡
赤柬	赤 柬
板䒿油	板 䒿 油
热加工	热 加 工
伏军	伏 军
馬爾地夫	馬 爾 地 夫
軍訓	軍 訓
不轨	不 轨
一家大細	一 家 大 細
刮鬍刀	刮 鬍 刀
搖手	搖 手
老疙瘩	老 疙 瘩
地冕	地 冕
趵趵	趵 趵
千奇百怪	千 奇 百 怪
蕩喙	蕩 喙
倜	倜
恁样	恁 样
齊心	齊 心
妞	妞
電報	電 報
晏晝	晏 晝
外坡	外 坡
小鱼	小 鱼
國安部	國 安 部
头饰	头 饰
惠阳	惠 阳
不甘落后	不 甘 落 后
东找西寻	东 找 西 寻
百分	百 分
管家基因	管 家 基 因
豚兒	豚 兒
胖纸	胖 纸
息仔	息 仔
成方	成 方
寧安	寧 安
反芻	反 芻
三韩	三 韩
左云	左 云
管綫	管 綫
圆梦	圆 梦
平角	平 角
早烧	早 烧
林牛	林 牛
如左	如 左
子嫂	子 嫂
袂拚得	袂 拚 得
𥦗	𥦗
凹凸有致	凹 凸 有 致
𫝛时	𫝛 时
病态肥胖	病 态 肥 胖
脰骨	脰 骨
鸡脾	鸡 脾
落羣	落 羣
寇仇	寇 仇
𱌬	𱌬
阴司	阴 司
辦事處	辦 事 處
上墳	上 墳
镈	镈
亚于	亚 于
冷知識	冷 知 識
無人飛機	無 人 飛 機
白棉紙	白 棉 紙
肥大細胞	肥 大 細 胞
保有期	保 有 期
茴子白	茴 子 白
电吉他手	电 吉 他 手
驚鴻	驚 鴻
入见	入 见
油锯	油 锯
試一試	試 一 試
直头	直 头
伊爾庫茨克	伊 爾 庫 茨 克
刀刀兒	刀 刀 兒
老鼠仔	老 鼠 仔
山東	山 東
词汇	词 汇
眼皮跳	眼 皮 跳
谦冲自牧	谦 冲 自 牧
盲道	盲 道
钻山打洞	钻 山 打 洞
壽媽	壽 媽
繳鬼	繳 鬼
㓾頭	㓾 頭
圣坛	圣 坛
助选	助 选
冬虫草	冬 虫 草
枓拱	枓 拱
驼背子	驼 背 子
䶵	䶵
喉滇	喉 滇
綠帽	綠 帽
南诏	南 诏
蓊欝	蓊 欝
花陰	花 陰
高不辏，低不就	高 不 辏 ， 低 不 就
拜神明	拜 神 明
低頭族	低 頭 族
卖功	卖 功
彭家坡	彭 家 坡
勞工市場	勞 工 市 場
胡䩮	胡 䩮
細流	細 流
薄礼	薄 礼
實名制	實 名 制
攀談	攀 談
纓子	纓 子
𬺑	𬺑
黑素細胞	黑 素 細 胞
种地	种 地
面紗	面 紗
齦音	齦 音
天不假年	天 不 假 年
產業	產 業
西日耳曼语支	西 日 耳 曼 语 支
隔籬屋	隔 籬 屋
后海湾	后 海 湾
无遗	无 遗
深市	深 市
制錢	制 錢
捨勿得	捨 勿 得
烏陰寒	烏 陰 寒
溫控	溫 控
筆記本電腦	筆 記 本 電 腦
風燈	風 燈
操劳	操 劳
连字号	连 字 号
共谈	共 谈
推荐书	推 荐 书
巾幗英雄	巾 幗 英 雄
你是谁	你 是 谁
赫鲁晓夫	赫 鲁 晓 夫
智术	智 术
公服	公 服
贫民	贫 民
橖	橖
一步登天	一 步 登 天
看懂	看 懂
因应	因 应
向望	向 望
重制	重 制
赭红尾鸲	赭 红 尾 鸲
凳子	凳 子
扌	扌
见步行步	见 步 行 步
装饰性	装 饰 性
無表情	無 表 情
蒜頭	蒜 頭
質權	質 權
下港	下 港
警備員	警 備 員
和闐	和 闐
數字管	數 字 管
丙酸	丙 酸
热带	热 带
基线	基 线
鐫	鐫
卜口	卜 口
归入	归 入
範勢	範 勢
吊線	吊 線
過山風	過 山 風
浸禮宗	浸 禮 宗
长滩岛	长 滩 岛
内属	内 属
御苑	御 苑
𫎪	𫎪
急救包	急 救 包
啮齿	啮 齿
國別	國 別
寡佔	寡 佔
上灯	上 灯
捕風捉影	捕 風 捉 影
見閻王	見 閻 王
诗经	诗 经
小金庫	小 金 庫
過年飯	過 年 飯
奥林匹克烷	奥 林 匹 克 烷
誤機	誤 機
合众国	合 众 国
絕對零度	絕 對 零 度
子宫环	子 宫 环
訓育	訓 育
稿紙	稿 紙
驚駭	驚 駭
不丹王國	不 丹 王 國
包剪揼	包 剪 揼
捻发音	捻 发 音
卖名	卖 名
丁丁糖	丁 丁 糖
乌头	乌 头
鴨雄	鴨 雄
椅木	椅 木
伯勞仔	伯 勞 仔
葉落歸根	葉 落 歸 根
筆端	筆 端
两面人	两 面 人
跷脚	跷 脚
無所不為	無 所 不 為
怒氣填胸	怒 氣 填 胸
书卷	书 卷
一丝一毫	一 丝 一 毫
隱形	隱 形
聽人	聽 人
午牌	午 牌
串通一气	串 通 一 气
筹办	筹 办
亚原子粒子	亚 原 子 粒 子
石綿	石 綿
非對映	非 對 映
不可知论	不 可 知 论
不可救药	不 可 救 药
𠃒	𠃒
托木爾峰	托 木 爾 峰
䰓	䰓
筆譯	筆 譯
阿特拉斯	阿 特 拉 斯
殼核	殼 核
黑心金光菊	黑 心 金 光 菊
鳳台	鳳 台
二世祖	二 世 祖
自创	自 创
芦苇	芦 苇
用言	用 言
脌	脌
倍道	倍 道
僞陽性	僞 陽 性
抡刀	抡 刀
皮鼓	皮 鼓
紐絲綸	紐 絲 綸
㮠	㮠
四条	四 条
伪基站	伪 基 站
敬酒唔飲飲罰酒	敬 酒 唔 飲 飲 罰 酒
相經	相 經
餐点	餐 点
油罐	油 罐
說不出話來	說 不 出 話 來
人情味兒	人 情 味 兒
脊樑	脊 樑
挑揀	挑 揀
铜币	铜 币
褒语	褒 语
女僕	女 僕
傣族	傣 族
親核體	親 核 體
鼠目寸光	鼠 目 寸 光
信以爲真	信 以 爲 真
涼意	涼 意
腊克	腊 克
紫羅蘭	紫 羅 蘭
東江	東 江
負面	負 面
足以	足 以
雞粉	雞 粉
廣域市	廣 域 市
信託	信 託
烘箱	烘 箱
水门	水 门
壙戇	壙 戇
真宗	真 宗
種種	種 種
弘仁	弘 仁
物质文明	物 质 文 明
能階	能 階
擼妝	擼 妝
红毛话	红 毛 话
通過	通 過
杰克苏	杰 克 苏
𰛽	𰛽
丙夜	丙 夜
桔仔	桔 仔
隱失波	隱 失 波
截断	截 断
中資	中 資
年數	年 數
喜新厌旧	喜 新 厌 旧
泥菩萨过江	泥 菩 萨 过 江
事頭婆	事 頭 婆
高级	高 级
易於	易 於
春濃	春 濃
涂粉	涂 粉
阎王爷	阎 王 爷
山鸡舞镜	山 鸡 舞 镜
鍋蓋頭	鍋 蓋 頭
線麵	線 麵
胫前肌	胫 前 肌
买椟还珠	买 椟 还 珠
活态	活 态
黄鹂	黄 鹂
素顏	素 顏
加数	加 数
机械工人	机 械 工 人
姑息治療	姑 息 治 療
總是	總 是
廣字頭	廣 字 頭
噝尿	噝 尿
阿儂	阿 儂
才调秀出	才 调 秀 出
缴费	缴 费
唐老鸭	唐 老 鸭
膈離間	膈 離 間
打圆场	打 圆 场
涡街	涡 街
勞工	勞 工
屈原廟	屈 原 廟
標籤化	標 籤 化
化学计量数	化 学 计 量 数
半奖	半 奖
说明会	说 明 会
碗筷	碗 筷
软钱	软 钱
巴枯宁主义	巴 枯 宁 主 义
落泊	落 泊
羞	羞
箔	箔
录影机	录 影 机
𥷑篥	𥷑 篥
安提瓜島	安 提 瓜 島
手不释卷	手 不 释 卷
普遍	普 遍
窘境	窘 境
满嘴	满 嘴
盤辮子	盤 辮 子
烏賊	烏 賊
特种邮票	特 种 邮 票
使勁	使 勁
慢且	慢 且
呻	呻
该位	该 位
𬙋	𬙋
幼齿	幼 齿
报摊	报 摊
蠢气	蠢 气
事略	事 略
雙棒兒	雙 棒 兒
持久性	持 久 性
的起心肝	的 起 心 肝
加冠礼	加 冠 礼
过去时态	过 去 时 态
酒石酸鉀鈉	酒 石 酸 鉀 鈉
擺動	擺 動
何至	何 至
葉護	葉 護
阿弥陀佛	阿 弥 陀 佛
藦	藦
鷄胚	鷄 胚
檢錄	檢 錄
关进	关 进
亲生	亲 生
恩贾梅纳	恩 贾 梅 纳
兇焰	兇 焰
房室間隔缺損	房 室 間 隔 缺 損
达赖喇嘛	达 赖 喇 嘛
牛蝨	牛 蝨
沈默寡言	沈 默 寡 言
遠征	遠 征
嫉妬	嫉 妬
婏	婏
捧	捧
長空	長 空
㾓痀	㾓 痀
剽悍	剽 悍
莶椒仔	莶 椒 仔
而後	而 後
焏	焏
三钟经	三 钟 经
乳源	乳 源
移送法办	移 送 法 办
胖瘦	胖 瘦
浴衣	浴 衣
下旬	下 旬
控制	控 制
主题公园	主 题 公 园
缺位	缺 位
糊里糊涂	糊 里 糊 涂
對面	對 面
顳	顳
墙根	墙 根
頂骨	頂 骨
对象化	对 象 化
甌江	甌 江
大肚黄	大 肚 黄
小圣堂	小 圣 堂
綢繆	綢 繆
從頭到尾	從 頭 到 尾
鲗鱼涌	鲗 鱼 涌
侧身	侧 身
侟	侟
古诺斯语	古 诺 斯 语
內湖	內 湖
契诃夫	契 诃 夫
降將	降 將
鑽石王老五	鑽 石 王 老 五
暢想曲	暢 想 曲
濫官汙吏	濫 官 汙 吏
螗	螗
現票子	現 票 子
澕	澕
多项式	多 项 式
汇款	汇 款
疑案	疑 案
共青团	共 青 团
爒	爒
瞪视	瞪 视
簡省	簡 省
对马	对 马
爛塗	爛 塗
愐	愐
纯客县	纯 客 县
地窨	地 窨
恥骨聯合	恥 骨 聯 合
契	契
模棱	模 棱
汙穢	汙 穢
森罗万象	森 罗 万 象
蚀重	蚀 重
恋栈	恋 栈
开恩	开 恩
會陰深橫肌	會 陰 深 橫 肌
見風轉舵	見 風 轉 舵
滀	滀
定系	定 系
泸	泸
𨭉	𨭉
咔	咔
基馬爾	基 馬 爾
盧溝橋事變	盧 溝 橋 事 變
天寒地凍	天 寒 地 凍
敌手	敌 手
悉尼歌剧院	悉 尼 歌 剧 院
海外	海 外
台大	台 大
米有	米 有
人生如梦	人 生 如 梦
樱井	樱 井
有轨电车	有 轨 电 车
单调	单 调
舊曆	舊 曆
腰	腰
弓繳	弓 繳
鯟	鯟
作乐	作 乐
灵山	灵 山
虎岫	虎 岫
高炉	高 炉
查问	查 问
晨明	晨 明
打手枪	打 手 枪
豐臺	豐 臺
秘步	秘 步
天光日	天 光 日
来电	来 电
知识论	知 识 论
中國崩潰論	中 國 崩 潰 論
掁眼	掁 眼
萬事通	萬 事 通
軚盘	軚 盘
长臂猿	长 臂 猿
單褲	單 褲
飞转	飞 转
代課老師	代 課 老 師
后枕	后 枕
八宝饭	八 宝 饭
賺食	賺 食
唐虞	唐 虞
非礼	非 礼
防澇	防 澇
僮族	僮 族
巫毒鼓	巫 毒 鼓
中部德语	中 部 德 语
瑙魯語	瑙 魯 語
遠遠	遠 遠
漱口水	漱 口 水
伊洛伊洛	伊 洛 伊 洛
帘栊	帘 栊
产能	产 能
徜徉	徜 徉
大背頭	大 背 頭
马西马西	马 西 马 西
斯瓦希里语	斯 瓦 希 里 语
献丑	献 丑
農樂	農 樂
䵥	䵥
透平	透 平
婕	婕
珍多冰	珍 多 冰
𠛅刀	𠛅 刀
歡快	歡 快
鹿豹座	鹿 豹 座
上馆子	上 馆 子
婅	婅
sió-bē	s i ó - b ē
四角楼	四 角 楼
十字街口	十 字 街 口
蓋世太保	蓋 世 太 保
苏州码子	苏 州 码 子
温書	温 書
劳教	劳 教
贊比亞	贊 比 亞
溏心	溏 心
過烊	過 烊
水流屍	水 流 屍
毒蛇	毒 蛇
點點點	點 點 點
及時行樂	及 時 行 樂
蠞	蠞
肚饑	肚 饑
福利彩票	福 利 彩 票
靠邊站	靠 邊 站
凯文	凯 文
圍威喂	圍 威 喂
進補	進 補
盒钥	盒 钥
途程	途 程
蛋清	蛋 清
屎缸虫	屎 缸 虫
虽败犹荣	虽 败 犹 荣
墙报	墙 报
超膠子	超 膠 子
𰀅	𰀅
異丁酸	異 丁 酸
傲气	傲 气
跡地	跡 地
肾功能衰竭	肾 功 能 衰 竭
水瓜	水 瓜
熱	熱
䦟	䦟
灵通	灵 通
隔籬鄰舍	隔 籬 鄰 舍
𪜦	𪜦
那时候	那 时 候
喔麥尬	喔 麥 尬
角平分綫	角 平 分 綫
安堵	安 堵
挺张	挺 张
利令智昏	利 令 智 昏
公益團體	公 益 團 體
来得赴	来 得 赴
轧棉机	轧 棉 机
鋼盔魚	鋼 盔 魚
衛斯理宗	衛 斯 理 宗
定中门	定 中 门
相拚	相 拚
𤼯	𤼯
麻木	麻 木
岭岗	岭 岗
强扭的瓜不甜	强 扭 的 瓜 不 甜
𡲩	𡲩
傳神	傳 神
逆乱	逆 乱
疑心病	疑 心 病
洋地黄	洋 地 黄
腳法	腳 法
橋躉	橋 躉
服务处	服 务 处
血腥	血 腥
安乃近	安 乃 近
冲凉房	冲 凉 房
领取	领 取
屯	屯
違令	違 令
音速	音 速
亚运会	亚 运 会
天文物理學	天 文 物 理 學
無韻詩	無 韻 詩
東歐平原	東 歐 平 原
闇雞	闇 雞
走學	走 學
牆錶	牆 錶
重申	重 申
安裝	安 裝
照原	照 原
迎敌	迎 敌
澳洲坚果	澳 洲 坚 果
举动	举 动
头皮发麻	头 皮 发 麻
黃油	黃 油
九九六	九 九 六
圣战者	圣 战 者
國界	國 界
小题大做	小 题 大 做
油粿	油 粿
黑烟	黑 烟
免疫抑制劑	免 疫 抑 制 劑
檻門	檻 門
水發	水 發
模糊音	模 糊 音
郵購	郵 購
輕狂	輕 狂
訓點	訓 點
䏏	䏏
如履平地	如 履 平 地
種族滅絕	種 族 滅 絕
勸說	勸 說
男盜女娼	男 盜 女 娼
卡朋特	卡 朋 特
摩鍊	摩 鍊
孔夫子	孔 夫 子
司马晋	司 马 晋
称霸	称 霸
桌面	桌 面
圣经带	圣 经 带
干簧管	干 簧 管
导热	导 热
日晒雨淋	日 晒 雨 淋
空間科學	空 間 科 學
鐵甏	鐵 甏
豎心邊	豎 心 邊
演化生物学	演 化 生 物 学
经济体制	经 济 体 制
抗炎药	抗 炎 药
陾	陾
釪	釪
鹵簿	鹵 簿
主队	主 队
陈家冲	陈 家 冲
傻呵呵	傻 呵 呵
鰐魚	鰐 魚
耳挖勺	耳 挖 勺
機器曲	機 器 曲
杂食动物	杂 食 动 物
默證	默 證
焉知	焉 知
皮損	皮 損
三角铁	三 角 铁
且權	且 權
无赐鸡	无 赐 鸡
無人駕駛飛機	無 人 駕 駛 飛 機
专有名词	专 有 名 词
白鹭鸶	白 鹭 鸶
活跃分子	活 跃 分 子
不发达国家	不 发 达 国 家
屁股眼儿	屁 股 眼 儿
䆀剃头	䆀 剃 头
返哺	返 哺
麀鹿	麀 鹿
专美	专 美
实鼻	实 鼻
无机物	无 机 物
晉南	晉 南
金蕉	金 蕉
質因數	質 因 數
幸事	幸 事
炒贵刁	炒 贵 刁
鳸	鳸
文凭试	文 凭 试
詩梳風	詩 梳 風
聯合收割機	聯 合 收 割 機
交叉点	交 叉 点
顶棚	顶 棚
板头	板 头
颈阔肌	颈 阔 肌
水煮肉	水 煮 肉
男壘	男 壘
堤防	堤 防
映画	映 画
檡	檡
電話號碼	電 話 號 碼
药材	药 材
妈祖庙	妈 祖 庙
䮏	䮏
弹丸	弹 丸
柱心边	柱 心 边
胡骑	胡 骑
麦芽膏	麦 芽 膏
根腳	根 腳
憲兵隊	憲 兵 隊
𠁕	𠁕
藤椅	藤 椅
公厠	公 厠
操你妈	操 你 妈
小阴沙	小 阴 沙
露齿而笑	露 齿 而 笑
万事如意	万 事 如 意
颈强直	颈 强 直
装扮	装 扮
章京	章 京
周旋	周 旋
坂户	坂 户
頁勒蓋兒	頁 勒 蓋 兒
穆圣	穆 圣
龙家沟	龙 家 沟
哨片	哨 片
整死	整 死
圣克里斯多福与尼维斯	圣 克 里 斯 多 福 与 尼 维 斯
租金	租 金
車仔麵	車 仔 麵
羊城	羊 城
藹然可親	藹 然 可 親
咪摸	咪 摸
姨丈	姨 丈
㔼	㔼
抽头	抽 头
滿姑媽	滿 姑 媽
下重	下 重
柏崎	柏 崎
轱辘子	轱 辘 子
巨大無比	巨 大 無 比
漏單	漏 單
哀毀瘠立	哀 毀 瘠 立
放蛇	放 蛇
吝	吝
大葱头	大 葱 头
山高皇帝遠	山 高 皇 帝 遠
憧憬	憧 憬
新人房	新 人 房
離支	離 支
后首来	后 首 来
生存率	生 存 率
妒忌	妒 忌
参赛者	参 赛 者
弯	弯
渗透	渗 透
撙	撙
落寞	落 寞
羊肠小径	羊 肠 小 径
穀粒	穀 粒
俗称	俗 称
官守	官 守
臯	臯
活該	活 該
代幣券	代 幣 券
陰私	陰 私
試工	試 工
椰子水	椰 子 水
環己二烯	環 己 二 烯
同母異父	同 母 異 父
羥化	羥 化
本草綱目	本 草 綱 目
獨食	獨 食
記蟀	記 蟀
一分	一 分
若翰	若 翰
賓夕法尼亞	賓 夕 法 尼 亞
縑帛	縑 帛
離異	離 異
侃侃而谈	侃 侃 而 谈
碢	碢
光輝燦爛	光 輝 燦 爛
岵	岵
拒毒	拒 毒
旭	旭
磕碰	磕 碰
賣身契	賣 身 契
幕府	幕 府
小題大作	小 題 大 作
蕔	蕔
锁匙佬	锁 匙 佬
蕶	蕶
安艺高田	安 艺 高 田
黑命贵	黑 命 贵
元芳，你怎麼看	元 芳 ， 你 怎 麼 看
颔颈仔	颔 颈 仔
𬲩	𬲩
独鲁万	独 鲁 万
约安	约 安
青虫	青 虫
凸函数	凸 函 数
大骨節病	大 骨 節 病
捣毁	捣 毁
𣝗	𣝗
十位	十 位
杜賓	杜 賓
比爾博	比 爾 博
旅签	旅 签
使氣	使 氣
盃	盃
纽耳	纽 耳
冻肉	冻 肉
來去	來 去
景帝	景 帝
核检	核 检
後真相	後 真 相
精靈	精 靈
保衞者	保 衞 者
生殺予奪	生 殺 予 奪
花盤	花 盤
鴪	鴪
禿瘡	禿 瘡
食俗	食 俗
㲋	㲋
遷葬	遷 葬
筆受	筆 受
凝固	凝 固
旁皇	旁 皇
𬒔	𬒔
唞	唞
官腔	官 腔
利落	利 落
天使用戶	天 使 用 戶
重磅新闻	重 磅 新 闻
脐带绕颈	脐 带 绕 颈
海森堡不确定性原理	海 森 堡 不 确 定 性 原 理
山口	山 口
自立為王	自 立 為 王
年青	年 青
連江	連 江
西岭	西 岭
迎面	迎 面
掛砲	掛 砲
猪兜	猪 兜
頭虱	頭 虱
鹽霜	鹽 霜
課長	課 長
外快	外 快
測速計	測 速 計
偏方	偏 方
瘉	瘉
粵省	粵 省
小山	小 山
财产性	财 产 性
伊斯兰祈祷团	伊 斯 兰 祈 祷 团
花鰱魚	花 鰱 魚
錢崗一	錢 崗 一
白刃	白 刃
實綫	實 綫
主動性	主 動 性
艸	艸
禪	禪
牛羚	牛 羚
想盡	想 盡
卡片	卡 片
養蛇食雞	養 蛇 食 雞
及格	及 格
沉澱	沉 澱
詩史試時市事	詩 史 試 時 市 事
奶羊	奶 羊
韻事	韻 事
胡搅蛮缠	胡 搅 蛮 缠
避税天堂	避 税 天 堂
一通百通	一 通 百 通
火腿	火 腿
小數	小 數
自娛	自 娛
甘納許	甘 納 許
组队	组 队
膽礬	膽 礬
騪	騪
首次公開發行	首 次 公 開 發 行
担纲	担 纲
市级	市 级
现人	现 人
義理巧克力	義 理 巧 克 力
殿后	殿 后
失惊	失 惊
鱉裙	鱉 裙
茅仔草	茅 仔 草
適齡	適 齡
鹣	鹣
飲宴	飲 宴
熱搜	熱 搜
维基化	维 基 化
加课	加 课
否德	否 德
黃皮果	黃 皮 果
瘋狗浪	瘋 狗 浪
摩星	摩 星
刀箭	刀 箭
拍饶	拍 饶
西布倫	西 布 倫
土脈	土 脈
护肤	护 肤
扁平足	扁 平 足
達里雅布依	達 里 雅 布 依
追本溯源	追 本 溯 源
筛子	筛 子
性别歧视	性 别 歧 视
上床	上 床
同声传译	同 声 传 译
亏待	亏 待
尿片子	尿 片 子
冒头	冒 头
署长	署 长
二氧芑	二 氧 芑
虛發	虛 發
假说	假 说
鈔	鈔
不明飛行物體	不 明 飛 行 物 體
成圣	成 圣
当其时	当 其 时
摩卡色	摩 卡 色
计划赶不上变化	计 划 赶 不 上 变 化
棋手	棋 手
出聲兒	出 聲 兒
抽心介	抽 心 介
千拄千	千 拄 千
元妃	元 妃
公花	公 花
工料	工 料
科西嘉	科 西 嘉
準確度	準 確 度
純度	純 度
猴	猴
葛饰	葛 饰
洲际弹道导弹	洲 际 弹 道 导 弹
岁声	岁 声
空間群	空 間 群
得承	得 承
中南财经政法大学南湖	中 南 财 经 政 法 大 学 南 湖
打马胶	打 马 胶
荷属东印度	荷 属 东 印 度
覺悟性	覺 悟 性
纳卯	纳 卯
簡易	簡 易
獵犬座	獵 犬 座
襪統	襪 統
进口	进 口
和平主义	和 平 主 义
左輪手槍	左 輪 手 槍
衆院	衆 院
无可比拟	无 可 比 拟
閩南人	閩 南 人
世業	世 業
藥茶鍋	藥 茶 鍋
僰文	僰 文
黑糖	黑 糖
危言	危 言
石锅	石 锅
三十二	三 十 二
打呼	打 呼
實習醫生	實 習 醫 生
矢志	矢 志
畀心机	畀 心 机
鏢局	鏢 局
匙羹	匙 羹
勐腊	勐 腊
上津	上 津
朋寮	朋 寮
烟士	烟 士
贝桑松	贝 桑 松
柏林墙	柏 林 墙
說起	說 起
緻密	緻 密
墨线	墨 线
天上人間	天 上 人 間
羥苯甲酯	羥 苯 甲 酯
称谓	称 谓
鹅仔菜	鹅 仔 菜
馬齒豆	馬 齒 豆
温泉	温 泉
𤞏	𤞏
海邊仔	海 邊 仔
花蛤	花 蛤
足額	足 額
結冤仇	結 冤 仇
钟落潭	钟 落 潭
短统袜	短 统 袜
觌	觌
一見傾心	一 見 傾 心
吗啡	吗 啡
破獍	破 獍
裙腳仔	裙 腳 仔
乐于	乐 于
涀	涀
洗衣房	洗 衣 房
酒店業	酒 店 業
拟定	拟 定
薰絲	薰 絲
封齋	封 齋
四拇指头	四 拇 指 头
肚里惹	肚 里 惹
烧伤	烧 伤
塍蛤仔躘	塍 蛤 仔 躘
天哪	天 哪
桃園結義	桃 園 結 義
滿城風雨	滿 城 風 雨
滔天	滔 天
鳊	鳊
獻花	獻 花
界音符号	界 音 符 号
冤家	冤 家
待詔鋪子	待 詔 鋪 子
蝲䗁絲網	蝲 䗁 絲 網
長襪	長 襪
尋呼機	尋 呼 機
歸葬	歸 葬
名著	名 著
鉅著	鉅 著
包乾制	包 乾 制
守株待兔	守 株 待 兔
雄馬	雄 馬
柴米油鹽醬醋茶	柴 米 油 鹽 醬 醋 茶
𤊶翻企	𤊶 翻 企
黥首	黥 首
口水战	口 水 战
伯樂樹	伯 樂 樹
以小见大	以 小 见 大
瀕危	瀕 危
陬月	陬 月
作业治疗	作 业 治 疗
極子	極 子
归途	归 途
國道	國 道
大吡叻	大 吡 叻
监利	监 利
次子	次 子
國土安全	國 土 安 全
祁連	祁 連
號咷	號 咷
嚀個	嚀 個
驚弓之鳥	驚 弓 之 鳥
阿啾箭	阿 啾 箭
航空信	航 空 信
莊子	莊 子
大赦	大 赦
恭谒	恭 谒
辦公檯	辦 公 檯
纯合子	纯 合 子
嶨	嶨
立意	立 意
霽	霽
適格	適 格
上半晌兒	上 半 晌 兒
贵贱	贵 贱
备餐	备 餐
葱花	葱 花
虛榮心	虛 榮 心
拔罐儿	拔 罐 儿
中餐厅	中 餐 厅
沙沒沙空	沙 沒 沙 空
长凳	长 凳
辅佐	辅 佐
涂水	涂 水
𠀋	𠀋
扭	扭
一总	一 总
对对糊	对 对 糊
月薪	月 薪
憯懍	憯 懍
後金	後 金
圆周率	圆 周 率
咯咯笑	咯 咯 笑
扛抬	扛 抬
乌梢蛇	乌 梢 蛇
按說	按 說
手面工课	手 面 工 课
春宫儿	春 宫 儿
老姥娘	老 姥 娘
黃澄澄	黃 澄 澄
额门	额 门
師母	師 母
花徑	花 徑
四重奏	四 重 奏
慘景	慘 景
掌牛	掌 牛
腦溢血	腦 溢 血
獨腳戲	獨 腳 戲
漁佬	漁 佬
衣衫藍褸	衣 衫 藍 褸
癔症	癔 症
变聋	变 聋
踆烏	踆 烏
回音	回 音
牛頭	牛 頭
北極點	北 極 點
卒业生	卒 业 生
彭州	彭 州
叆叇	叆 叇
邮递	邮 递
身心障碍	身 心 障 碍
甲沟炎	甲 沟 炎
跤頭趺	跤 頭 趺
报失	报 失
起重器	起 重 器
青睞	青 睞
定海	定 海
贵	贵
本兒	本 兒
果不其然	果 不 其 然
南朝鲜	南 朝 鲜
十五個吊桶打水——七上八下	十 五 個 吊 桶 打 水 — — 七 上 八 下
理由兒	理 由 兒
無所不能	無 所 不 能
鼻涕蟲	鼻 涕 蟲
福禄	福 禄
突厥语系	突 厥 语 系
点声	点 声
细肠	细 肠
勾引	勾 引
缝仔	缝 仔
穿鑿	穿 鑿
怀冤抱屈	怀 冤 抱 屈
正经八百	正 经 八 百
扫帚	扫 帚
岚城	岚 城
穀米	穀 米
奥兰多	奥 兰 多
声纳	声 纳
畢宿	畢 宿
鉤骨	鉤 骨
至親	至 親
喪病	喪 病
礼物	礼 物
睪丸	睪 丸
喫菸	喫 菸
防僞	防 僞
险固	险 固
賞心悅目	賞 心 悅 目
疫症	疫 症
心适	心 适
蕚	蕚
據指	據 指
鴨嫲	鴨 嫲
貴姓	貴 姓
學歷工廠	學 歷 工 廠
鱯	鱯
混淪	混 淪
房圈	房 圈
搝索仔	搝 索 仔
欢聚一堂	欢 聚 一 堂
線苕	線 苕
牆紙	牆 紙
打圈圈	打 圈 圈
规身躯	规 身 躯
㠴	㠴
蒙特卡洛	蒙 特 卡 洛
一等奖	一 等 奖
吃酒	吃 酒
一氧化物	一 氧 化 物
冷却	冷 却
熟視無睹	熟 視 無 睹
挫動	挫 動
教範	教 範
𩩍條骨	𩩍 條 骨
猶子	猶 子
顶门心	顶 门 心
青龙	青 龙
感嘆號	感 嘆 號
胖大海	胖 大 海
薦臻	薦 臻
巖邑	巖 邑
地綫	地 綫
銲接	銲 接
腕管綜合症	腕 管 綜 合 症
延长号	延 长 号
家庭主婦	家 庭 主 婦
鴨母蹄	鴨 母 蹄
扬蝶铰仔	扬 蝶 铰 仔
喫饭	喫 饭
合軀	合 軀
陰門	陰 門
衫短裤阔人矮鼻直	衫 短 裤 阔 人 矮 鼻 直
饿死	饿 死
劉備借荊州——一借冇回頭	劉 備 借 荊 州 — — 一 借 冇 回 頭
呁	呁
白粥	白 粥
戛納	戛 納
澁	澁
侞	侞
焦洗	焦 洗
布依语	布 依 语
结城	结 城
細腰貓	細 腰 貓
碜	碜
侵害	侵 害
楼下	楼 下
敢咧	敢 咧
朗肚褲	朗 肚 褲
彩色平光隐形眼镜	彩 色 平 光 隐 形 眼 镜
培補	培 補
篆字	篆 字
地中海贫血	地 中 海 贫 血
哈佛逗號	哈 佛 逗 號
明体	明 体
惺鬆	惺 鬆
異性	異 性
巴比妥	巴 比 妥
恬不知耻	恬 不 知 耻
奠仪	奠 仪
鐵鍬	鐵 鍬
意爱	意 爱
頭面	頭 面
癭	癭
曠工	曠 工
時機	時 機
大衆傳播媒介	大 衆 傳 播 媒 介
喉返神經	喉 返 神 經
衛冕	衛 冕
特特裡	特 特 裡
截然不同	截 然 不 同
穆棱	穆 棱
听狱	听 狱
人声鼎沸	人 声 鼎 沸
鎩羽	鎩 羽
雪堆	雪 堆
红豆雪	红 豆 雪
𪚎	𪚎
chai-iáⁿ	c h a i - i á ⁿ
千禧	千 禧
一时三刻	一 时 三 刻
抱厦	抱 厦
倒帶	倒 帶
險急	險 急
美聲	美 聲
涉事	涉 事
進犯	進 犯
大内宣	大 内 宣
迷糊	迷 糊
鍤刀	鍤 刀
辎重	辎 重
𰓄	𰓄
茶館	茶 館
錯峰	錯 峰
𫟿	𫟿
囑	囑
白色人種	白 色 人 種
荡覆	荡 覆
查埔朋友	查 埔 朋 友
磅仔秤	磅 仔 秤
夜不歸宿	夜 不 歸 宿
跌落地揦返拃沙	跌 落 地 揦 返 拃 沙
門子	門 子
博深	博 深
对虾	对 虾
忲	忲
敎師節	敎 師 節
呈阅	呈 阅
甘油磷脂	甘 油 磷 脂
梎	梎
黨衛隊	黨 衛 隊
哥德堡	哥 德 堡
斐波那契螺旋線	斐 波 那 契 螺 旋 線
膨脹主義	膨 脹 主 義
诸城	诸 城
婺剧	婺 剧
光壓	光 壓
現在時	現 在 時
克星	克 星
後月日	後 月 日
大码	大 码
乘虛而入	乘 虛 而 入
鋼綫	鋼 綫
𬮪	𬮪
数码相机	数 码 相 机
夜更	夜 更
恭迎	恭 迎
補偏救弊	補 偏 救 弊
必應	必 應
射綫	射 綫
邢川	邢 川
绷紧	绷 紧
苗人	苗 人
豆壳	豆 壳
听障	听 障
前镇	前 镇
離綫	離 綫
分散式阻断服务攻击	分 散 式 阻 断 服 务 攻 击
滿浦	滿 浦
患儿	患 儿
纾解	纾 解
带动	带 动
美聲唱法	美 聲 唱 法
查渎	查 渎
誆牽	誆 牽
市場部	市 場 部
辭書	辭 書
飛鳶	飛 鳶
恍忽	恍 忽
双双	双 双
恋殖	恋 殖
入室盜竊	入 室 盜 竊
瑙	瑙
意第绪语	意 第 绪 语
𱋾	𱋾
荷蘭門	荷 蘭 門
斗碗儿	斗 碗 儿
掴	掴
马加丹	马 加 丹
解析函數	解 析 函 數
妈麻马骂	妈 麻 马 骂
落臺	落 臺
𧻲	𧻲
附會	附 會
涐	涐
碘	碘
常見問題	常 見 問 題
混沌	混 沌
庄頭	庄 頭
小偷兒	小 偷 兒
亞太	亞 太
尿兜	尿 兜
空頭支票	空 頭 支 票
老奶奶	老 奶 奶
訶護	訶 護
志丹	志 丹
阿驿	阿 驿
风龟	风 龟
抽样	抽 样
莊仔	莊 仔
花飾	花 飾
掖種	掖 種
刨花	刨 花
癊	癊
诸葛	诸 葛
威尔克斯-巴里	威 尔 克 斯 - 巴 里
乌牌擦	乌 牌 擦
哌啶	哌 啶
颠茄酊	颠 茄 酊
咘	咘
賢人	賢 人
古體	古 體
作园的	作 园 的
流行语	流 行 语
乳蛋糕	乳 蛋 糕
艰钜	艰 钜
工潮	工 潮
毛絲鼠	毛 絲 鼠
蒼鬱	蒼 鬱
台燈	台 燈
矢	矢
宮廷	宮 廷
好字運	好 字 運
药茶	药 茶
黏膜层	黏 膜 层
报话员	报 话 员
放虹	放 虹
內在美	內 在 美
䞔	䞔
翭	翭
布茲卡茲	布 茲 卡 茲
耺	耺
菟丝	菟 丝
南腔北調	南 腔 北 調
祖傳	祖 傳
皇家同花顺	皇 家 同 花 顺
毛员鼓	毛 员 鼓
扬子	扬 子
有心人	有 心 人
抱撮	抱 撮
里吗儿的	里 吗 儿 的
㗂	㗂
基质	基 质
吹拂	吹 拂
密克罗尼西亚	密 克 罗 尼 西 亚
祧	祧
凉爽	凉 爽
玛丽亚	玛 丽 亚
一吐爲快	一 吐 爲 快
偷看	偷 看
催	催
𠇻	𠇻
陪床	陪 床
计数机	计 数 机
齿岸	齿 岸
卑贱	卑 贱
渾樸	渾 樸
入座	入 座
燭仔	燭 仔
哭哭	哭 哭
右心衰	右 心 衰
值当	值 当
吂曾	吂 曾
濟濟一堂	濟 濟 一 堂
沒心沒肺	沒 心 沒 肺
好心	好 心
吠陀梵语	吠 陀 梵 语
咳嗽	咳 嗽
湿气	湿 气
尻脊𩩍	尻 脊 𩩍
哥爾夫球	哥 爾 夫 球
佼	佼
声空	声 空
衣食	衣 食
相仝	相 仝
否决	否 决
採光	採 光
馬布	馬 布
童颜鹤发	童 颜 鹤 发
以利沙	以 利 沙
不痛不痒	不 痛 不 痒
閾	閾
夃	夃
活現	活 現
人臉彩繪	人 臉 彩 繪
軍團	軍 團
藏污納垢	藏 污 納 垢
啫喱	啫 喱
剩饭	剩 饭
大綱	大 綱
东岳庙	东 岳 庙
杳無人煙	杳 無 人 煙
出题	出 题
接生婆	接 生 婆
入面	入 面
中產階級	中 產 階 級
異心	異 心
麕	麕
僵	僵
榔坪	榔 坪
駐錫	駐 錫
松花皮蛋	松 花 皮 蛋
斧头边	斧 头 边
通婚	通 婚
餐椅	餐 椅
鰦	鰦
变计	变 计
悲泣	悲 泣
树身	树 身
烏程	烏 程
第一次	第 一 次
鱼肚白	鱼 肚 白
白种人	白 种 人
電椅	電 椅
保身	保 身
拜受	拜 受
氧化态	氧 化 态
緙絲	緙 絲
鍈	鍈
但必過	但 必 過
手黏	手 黏
忘我	忘 我
沖帳	沖 帳
攝氏度	攝 氏 度
躲懒	躲 懒
夏季	夏 季
瘦	瘦
独处	独 处
打脈	打 脈
邊緣系統	邊 緣 系 統
葉利欽	葉 利 欽
布达佩斯	布 达 佩 斯
歷史意義	歷 史 意 義
中立主义	中 立 主 义
家里的	家 里 的
剧本杀	剧 本 杀
貝南	貝 南
家裏的	家 裏 的
停泊島	停 泊 島
三陪	三 陪
直角引號	直 角 引 號
藏歌	藏 歌
撞鬼	撞 鬼
鼓楼	鼓 楼
獻開	獻 開
飞语	飞 语
宝船	宝 船
開場白	開 場 白
拈花惹草	拈 花 惹 草
調遣	調 遣
假山	假 山
传疑	传 疑
好樣的	好 樣 的
地磁場	地 磁 場
丏	丏
收埋	收 埋
潖	潖
御酒	御 酒
般若心经	般 若 心 经
碘仿	碘 仿
水痘	水 痘
經辦	經 辦
傻話	傻 話
山岗子	山 岗 子
歸天	歸 天
千不该，万不该	千 不 该 ， 万 不 该
甲酰胺	甲 酰 胺
南侗	南 侗
鲨鱼牙	鲨 鱼 牙
够额	够 额
牽手的	牽 手 的
富縣	富 縣
不识庐山真面目	不 识 庐 山 真 面 目
胡饼	胡 饼
密电	密 电
季世	季 世
踩街	踩 街
哈博罗内	哈 博 罗 内
馑	馑
此類	此 類
䌾	䌾
快件	快 件
川黑	川 黑
去顫	去 顫
锅碗瓢盆	锅 碗 瓢 盆
唸書	唸 書
时季	时 季
芝脚糖	芝 脚 糖
后盾	后 盾
黑钨矿	黑 钨 矿
视图	视 图
鱼脍	鱼 脍
卝	卝
黃綠醫生	黃 綠 醫 生
富山	富 山
廿三	廿 三
喊叫	喊 叫
英仙座	英 仙 座
赴时	赴 时
鎮	鎮
決一死戰	決 一 死 戰
額爾齊斯	額 爾 齊 斯
镏	镏
茶话会	茶 话 会
将心比心	将 心 比 心
宽恕	宽 恕
可樂定	可 樂 定
䝤	䝤
期满	期 满
整裝	整 裝
养鸟	养 鸟
寶天曼	寶 天 曼
濺尿	濺 尿
鳥牙	鳥 牙
共情	共 情
布陣	布 陣
隔舱	隔 舱
魔芋	魔 芋
食管炎	食 管 炎
马大哈	马 大 哈
沃门	沃 门
南京大屠殺	南 京 大 屠 殺
无共款	无 共 款
氯化镁	氯 化 镁
榮華富貴	榮 華 富 貴
雜色狼	雜 色 狼
南湖山庄	南 湖 山 庄
調羹	調 羹
蟯	蟯
詩賦	詩 賦
凭凭	凭 凭
盡頭	盡 頭
口部	口 部
速錄機	速 錄 機
茅利塔尼亞	茅 利 塔 尼 亞
換行	換 行
炮仔芯	炮 仔 芯
煙囪	煙 囪
稳重	稳 重
指環	指 環
導水管周圍灰質	導 水 管 周 圍 灰 質
大军	大 军
贪字得个贫	贪 字 得 个 贫
àm-tǹg	à m - t ǹ g
喙尽臭	喙 尽 臭
鲈鲙	鲈 鲙
吊烏	吊 烏
㢉	㢉
宏旨	宏 旨
衞生丸子	衞 生 丸 子
润泽	润 泽
薯泥	薯 泥
荡失	荡 失
排箇	排 箇
鯢	鯢
闪击	闪 击
三十六計	三 十 六 計
𫂃	𫂃
乃朝后头	乃 朝 后 头
蚊怕贴	蚊 怕 贴
孝靈皇帝	孝 靈 皇 帝
外调	外 调
㦱	㦱
二水	二 水
联俄	联 俄
黄釉	黄 釉
土鲁斯	土 鲁 斯
拍青仔	拍 青 仔
讲美	讲 美
當作	當 作
錢荒	錢 荒
换言之	换 言 之
𰵲	𰵲
囚徒	囚 徒
惡報	惡 報
馬球	馬 球
雲呢拿	雲 呢 拿
高跟兒鞋	高 跟 兒 鞋
𧾁外头	𧾁 外 头
孜	孜
扶手电梯	扶 手 电 梯
雄雞	雄 雞
朶	朶
旁旁	旁 旁
黄金时间	黄 金 时 间
斗趣儿	斗 趣 儿
㻬	㻬
松露巧克力	松 露 巧 克 力
NP难	N P 难
罌	罌
背脊骨	背 脊 骨
英巴格	英 巴 格
记录片	记 录 片
𩎁	𩎁
特别市	特 别 市
畲話	畲 話
榮枯	榮 枯
大事化小，小事化无	大 事 化 小 ， 小 事 化 无
蟬蚱	蟬 蚱
心路	心 路
雙寨	雙 寨
輔酶Ⅱ	輔 酶 Ⅱ
下葬	下 葬
卡那卡那富人	卡 那 卡 那 富 人
貓面	貓 面
游击	游 击
内积	内 积
流氓软件	流 氓 软 件
人类条件	人 类 条 件
咯血	咯 血
树人	树 人
艾特	艾 特
朣	朣
万用	万 用
㜹	㜹
云州	云 州
空气清新剂	空 气 清 新 剂
結語	結 語
澳门特别行政区	澳 门 特 别 行 政 区
歐姆古溫	歐 姆 古 溫
擽	擽
乐歌	乐 歌
爛仔	爛 仔
访华	访 华
巴巴儿地	巴 巴 儿 地
毛蝇	毛 蝇
治經	治 經
䳘	䳘
雞下拈	雞 下 拈
姊妹市	姊 妹 市
波多黎各自由邦	波 多 黎 各 自 由 邦
胡椒粉	胡 椒 粉
買一送一	買 一 送 一
昆明山海棠片	昆 明 山 海 棠 片
處	處
南风天	南 风 天
延后	延 后
纵子	纵 子
侮辱	侮 辱
遻	遻
土壤肥度	土 壤 肥 度
桥梓	桥 梓
充电线	充 电 线
紙紮	紙 紮
怒目	怒 目
观光业	观 光 业
山胡椒	山 胡 椒
秘魯	秘 魯
乙女游戲	乙 女 游 戲
急烧仔	急 烧 仔
青年语法学派	青 年 语 法 学 派
地质学家	地 质 学 家
骨炭	骨 炭
躏	躏
窜乱	窜 乱
绝灭	绝 灭
並用	並 用
看護婦	看 護 婦
事務員	事 務 員
支氣管氣喘	支 氣 管 氣 喘
𰵣	𰵣
頻顣	頻 顣
脑桥	脑 桥
蚣	蚣
燃气涡轮发动机	燃 气 涡 轮 发 动 机
黃河三角洲	黃 河 三 角 洲
小把爷	小 把 爷
正港	正 港
闭锁综合征	闭 锁 综 合 征
圆轱辘	圆 轱 辘
頂對	頂 對
凡立丁	凡 立 丁
金紙	金 紙
後婚兒	後 婚 兒
装饰品	装 饰 品
㩆	㩆
唱机	唱 机
中心體	中 心 體
饭团	饭 团
出頭天	出 頭 天
矬	矬
生杀予夺	生 杀 予 夺
泳帽	泳 帽
重心	重 心
解答	解 答
同一性	同 一 性
噴氣	噴 氣
指法	指 法
𧈀	𧈀
表面皿	表 面 皿
𰾽	𰾽
服務生	服 務 生
性別認知障礙	性 別 認 知 障 礙
逆向工程者	逆 向 工 程 者
遌	遌
下三爛	下 三 爛
欹空翹	欹 空 翹
伊伊稣斯	伊 伊 稣 斯
歷述	歷 述
发际线	发 际 线
爆滿	爆 滿
梊	梊
刚果（布）	刚 果 （ 布 ）
臭奶献味	臭 奶 献 味
南豆腐	南 豆 腐
騎樓	騎 樓
磁盤	磁 盤
薩拉姆	薩 拉 姆
正山小種	正 山 小 種
使妈	使 妈
哀启	哀 启
点头	点 头
浃渫	浃 渫
也是醉了	也 是 醉 了
花笼	花 笼
酒席	酒 席
歡容	歡 容
遮阳伞	遮 阳 伞
癸酸	癸 酸
叙事学	叙 事 学
左西替利嗪	左 西 替 利 嗪
飄泊	飄 泊
纵然	纵 然
黑夜	黑 夜
春秋三傳	春 秋 三 傳
頾	頾
八九不离十	八 九 不 离 十
见风转舵	见 风 转 舵
江汉	江 汉
民力	民 力
台湾黄杨	台 湾 黄 杨
刺杀	刺 杀
佛偈	佛 偈
远眺	远 眺
钩破	钩 破
洪宪	洪 宪
煙子	煙 子
滿地可	滿 地 可
駐馬店	駐 馬 店
出訪	出 訪
脚印子	脚 印 子
詩經	詩 經
貂	貂
鈦白	鈦 白
大魚大肉	大 魚 大 肉
坩埚	坩 埚
军公教	军 公 教
無足重輕	無 足 重 輕
津巴布韋	津 巴 布 韋
茶箩	茶 箩
锁定	锁 定
恩田	恩 田
讲穿	讲 穿
鄭場	鄭 場
專櫃	專 櫃
伪科学	伪 科 学
混账	混 账
手眼	手 眼
正体	正 体
永壽	永 壽
橫街窄巷	橫 街 窄 巷
倾颓	倾 颓
银鳕	银 鳕
倚马可待	倚 马 可 待
蝲蝲蛄	蝲 蝲 蛄
尖音符	尖 音 符
盖层纪	盖 层 纪
次于	次 于
窗仔簾	窗 仔 簾
松果体	松 果 体
唐州	唐 州
前邊	前 邊
踩道	踩 道
比鄰	比 鄰
洗臉	洗 臉
良种	良 种
爽適	爽 適
上半天	上 半 天
醣質新生	醣 質 新 生
羅家	羅 家
韶州	韶 州
淌游	淌 游
闭门	闭 门
山	山
清明節	清 明 節
允当	允 当
确认过眼神	确 认 过 眼 神
馬恩島	馬 恩 島
贪得无厌	贪 得 无 厌
相抱	相 抱
隐私政策	隐 私 政 策
逗点	逗 点
食下昼	食 下 昼
松蕊	松 蕊
賊市	賊 市
泡泡浴	泡 泡 浴
橡奶糖	橡 奶 糖
師尊	師 尊
熱那亞	熱 那 亞
缺员	缺 员
喪假	喪 假
書業	書 業
水鄉	水 鄉
紅菜湯	紅 菜 湯
猪手	猪 手
天門冬胺酸	天 門 冬 胺 酸
㙳坷	㙳 坷
多動	多 動
顧家店	顧 家 店
麥芽膏	麥 芽 膏
嶻	嶻
阿默斯福特	阿 默 斯 福 特
伏隔核	伏 隔 核
郫	郫
上偻	上 偻
撒謊	撒 謊
中椵	中 椵
崁	崁
窯洞	窯 洞
增強	增 強
事態	事 態
腋臭	腋 臭
扼喉抚背	扼 喉 抚 背
阿谄	阿 谄
裏家	裏 家
一度	一 度
曣	曣
聯棚	聯 棚
安保	安 保
鸭脚	鸭 脚
據實	據 實
駕船的	駕 船 的
館際	館 際
分句	分 句
床褥	床 褥
冰櫃	冰 櫃
鞋揙	鞋 揙
不留余地	不 留 余 地
座间	座 间
五陵	五 陵
嘔歌	嘔 歌
香会	香 会
上海言話	上 海 言 話
師法	師 法
偉光正	偉 光 正
铸件	铸 件
涆	涆
小資	小 資
旮	旮
白頭山	白 頭 山
尔后	尔 后
微氣候	微 氣 候
国统区	国 统 区
南侧	南 侧
大雄	大 雄
髀仔	髀 仔
臺詞	臺 詞
神彩	神 彩
现行	现 行
水产养殖	水 产 养 殖
拉把	拉 把
不到长城非好汉	不 到 长 城 非 好 汉
感謝	感 謝
不一样	不 一 样
牙針	牙 針
蘇梗	蘇 梗
洋務	洋 務
紙草	紙 草
中宣部	中 宣 部
不世	不 世
風水先	風 水 先
𬬵色	𬬵 色
停放架	停 放 架
唯心主义	唯 心 主 义
驅遣	驅 遣
駭人	駭 人
氫氧化鎂	氫 氧 化 鎂
紧缺	紧 缺
骨朵兒	骨 朵 兒
搖晃	搖 晃
我侬	我 侬
軍事家	軍 事 家
乌来	乌 来
喬苦	喬 苦
字母系統	字 母 系 統
间接经验	间 接 经 验
獎池	獎 池
男表	男 表
峱	峱
木克	木 克
浍	浍
起皺	起 皺
糍饭团	糍 饭 团
漆油	漆 油
幹撬	幹 撬
柴沟堡	柴 沟 堡
以上	以 上
紅磡	紅 磡
巴布亞	巴 布 亞
滿場	滿 場
兜率天	兜 率 天
水量	水 量
番爿	番 爿
蠟筆	蠟 筆
二甲基亚砜	二 甲 基 亚 砜
進場	進 場
后爿	后 爿
绫	绫
搜括	搜 括
民主集中制	民 主 集 中 制
乌鲁姆鲁	乌 鲁 姆 鲁
荒腔走板	荒 腔 走 板
改判	改 判
清热	清 热
脊柱側彎	脊 柱 側 彎
死病	死 病
后任	后 任
生死不明	生 死 不 明
㓼	㓼
娃媽	娃 媽
革命軍	革 命 軍
瑪麗伯勒	瑪 麗 伯 勒
横街窄巷	横 街 窄 巷
瀮	瀮
風範	風 範
工作台	工 作 台
未知數	未 知 數
苑善拿打	苑 善 拿 打
张身势	张 身 势
糢	糢
金舖	金 舖
規避	規 避
诗体学	诗 体 学
超卖	超 卖
自宫	自 宫
趁興	趁 興
閉路電視	閉 路 電 視
㛠	㛠
滿天星	滿 天 星
定计	定 计
股东	股 东
攪擾	攪 擾
尪	尪
摆平	摆 平
凱里	凱 里
齦顎音	齦 顎 音
下昼	下 昼
颗粒无收	颗 粒 无 收
不拘	不 拘
浮面	浮 面
大我	大 我
闯世界	闯 世 界
自己送上门	自 己 送 上 门
獏	獏
歇脚	歇 脚
社群	社 群
直銷	直 銷
扇叶	扇 叶
系都	系 都
收市	收 市
边患	边 患
𨋢口	𨋢 口
㞜	㞜
財團	財 團
耳柴	耳 柴
期中	期 中
真岡	真 岡
薰囝盒	薰 囝 盒
死人面	死 人 面
硬顎音	硬 顎 音
百业萧条	百 业 萧 条
大數定律	大 數 定 律
村驴	村 驴
猫婆	猫 婆
呈贡	呈 贡
不得其门而入	不 得 其 门 而 入
可蘭經	可 蘭 經
里势	里 势
散场	散 场
教職	教 職
日正当中	日 正 当 中
负评	负 评
反间计	反 间 计
日珠	日 珠
语气词	语 气 词
神經末梢	神 經 末 梢
諸娘囝	諸 娘 囝
鱼肚	鱼 肚
採信	採 信
楼底下	楼 底 下
伴奂	伴 奂
美妙	美 妙
裕廊東	裕 廊 東
均一	均 一
頭痛額熱	頭 痛 額 熱
蔽護	蔽 護
多尔衮	多 尔 衮
爛賭二	爛 賭 二
粱	粱
尼日尔	尼 日 尔
坐貨	坐 貨
偷畔	偷 畔
烟尾巴儿	烟 尾 巴 儿
二吊	二 吊
交貨	交 貨
肉食动物	肉 食 动 物
车载斗量	车 载 斗 量
南传佛教	南 传 佛 教
马润	马 润
图尔克斯坦	图 尔 克 斯 坦
籴	籴
吴越	吴 越
彪发	彪 发
接戰	接 戰
细圆	细 圆
雖遲但到	雖 遲 但 到
複鹽	複 鹽
農忙	農 忙
騭	騭
坚尼地城	坚 尼 地 城
西敏	西 敏
大道	大 道
显扬	显 扬
生命教練	生 命 教 練
冰燈	冰 燈
被单	被 单
咽鼓管	咽 鼓 管
晶状体	晶 状 体
銽	銽
喷	喷
酒測	酒 測
不管不顧	不 管 不 顧
馬拉盞	馬 拉 盞
橘	橘
賞光	賞 光
么沟	么 沟
鲥	鲥
雄黄酒	雄 黄 酒
醇類	醇 類
它们	它 们
备选	备 选
匆忙	匆 忙
蠋	蠋
決絕	決 絕
难民营	难 民 营
颔颈骨	颔 颈 骨
刀俎余生	刀 俎 余 生
额度	额 度
獅	獅
趿心	趿 心
痕量	痕 量
蛋疼	蛋 疼
反之亦然	反 之 亦 然
高楠	高 楠
浮腫	浮 腫
砻谷	砻 谷
前庭蜗神经	前 庭 蜗 神 经
國際日界線	國 際 日 界 線
安来	安 来
巨核細胞	巨 核 細 胞
画作	画 作
苛頭	苛 頭
藍客	藍 客
折旧	折 旧
阳婆	阳 婆
誅求	誅 求
輪替	輪 替
楚瑪爾河	楚 瑪 爾 河
手冊	手 冊
搶註	搶 註
麻煩	麻 煩
不列颠诸岛	不 列 颠 诸 岛
攻击	攻 击
㑤	㑤
屠房	屠 房
上供	上 供
神嬰	神 嬰
刺胞動物	刺 胞 動 物
飞散	飞 散
絲綫	絲 綫
肺氣腫	肺 氣 腫
劊	劊
板金	板 金
日頭絲	日 頭 絲
ftx	f t x
邊卡	邊 卡
珧柱	珧 柱
𱇪子	𱇪 子
老鼠仔冤	老 鼠 仔 冤
貭	貭
可不	可 不
小舅子	小 舅 子
慾念	慾 念
緲子	緲 子
黄金洞	黄 金 洞
非類	非 類
肥宅快乐饼	肥 宅 快 乐 饼
BB機	B B 機
圖靈焦油坑	圖 靈 焦 油 坑
梨花	梨 花
社會服務	社 會 服 務
多动	多 动
隑士林	隑 士 林
做鬼臉	做 鬼 臉
蚢	蚢
交歡	交 歡
華中科技大學	華 中 科 技 大 學
福地	福 地
薦褥	薦 褥
稨	稨
攃冰	攃 冰
麵包籃	麵 包 籃
核磁共振成像	核 磁 共 振 成 像
爆發	爆 發
悔過	悔 過
𪺹	𪺹
共妻	共 妻
蕞爾	蕞 爾
引颈	引 颈
水过鸭背	水 过 鸭 背
折舊	折 舊
藝品	藝 品
巧计	巧 计
莱苑	莱 苑
空城	空 城
悬念	悬 念
薩克森	薩 克 森
碗碟	碗 碟
叔胺	叔 胺
少見多怪	少 見 多 怪
兇狂	兇 狂
滴定	滴 定
马岛獴	马 岛 獴
时间胶囊	时 间 胶 囊
虮	虮
条直	条 直
孔湾	孔 湾
大英国协	大 英 国 协
不泯	不 泯
包揽词讼	包 揽 词 讼
山東半島	山 東 半 島
阳桃	阳 桃
品字插座	品 字 插 座
心電感應	心 電 感 應
背債	背 債
䶟	䶟
無底無代	無 底 無 代
藝壇	藝 壇
學科群	學 科 群
谱系	谱 系
安置費	安 置 費
絲仔襪	絲 仔 襪
荀卿	荀 卿
基辛格	基 辛 格
种族归纳	种 族 归 纳
閒時	閒 時
唱将	唱 将
都兰	都 兰
歳	歳
送审	送 审
底围	底 围
唭	唭
弘農王	弘 農 王
鬐	鬐
迎春	迎 春
刚正好	刚 正 好
坐标	坐 标
坆	坆
市长	市 长
何苦	何 苦
度針	度 針
不以为耻	不 以 为 耻
酣	酣
丰中	丰 中
心上人	心 上 人
粪扫衫	粪 扫 衫
检点	检 点
高著	高 著
輕淡	輕 淡
储存	储 存
发癫仔	发 癫 仔
征文	征 文
来苏儿	来 苏 儿
遊車河	遊 車 河
鸭角	鸭 角
加话	加 话
童話化	童 話 化
油條	油 條
肛門外括約肌	肛 門 外 括 約 肌
上唇	上 唇
嗟乎	嗟 乎
仰視	仰 視
堁	堁
岁荒	岁 荒
𫘩	𫘩
出衆	出 衆
坎卢普斯	坎 卢 普 斯
乌托邦社会主义	乌 托 邦 社 会 主 义
钲鼓	钲 鼓
淇澳岛	淇 澳 岛
缝纫	缝 纫
百页	百 页
凄楚	凄 楚
呂氏春秋	呂 氏 春 秋
驻留	驻 留
名正言順	名 正 言 順
利利索索	利 利 索 索
古惑仔	古 惑 仔
上蠟	上 蠟
饱餐一顿	饱 餐 一 顿
出版物	出 版 物
食软饭	食 软 饭
奧爾科特	奧 爾 科 特
涵盖	涵 盖
烘炉子	烘 炉 子
赧	赧
罚站	罚 站
下決心	下 決 心
劇方	劇 方
施恩	施 恩
帆柱	帆 柱
被俘	被 俘
老調重彈	老 調 重 彈
暮色	暮 色
喉結	喉 結
諰	諰
间隔	间 隔
体貌	体 貌
暖氣片	暖 氣 片
炊床	炊 床
传令	传 令
夜游子	夜 游 子
苏杭铺	苏 杭 铺
警卫	警 卫
霜櫃	霜 櫃
黛綠	黛 綠
纳霍德卡	纳 霍 德 卡
蓝莹莹	蓝 莹 莹
总谱	总 谱
乌米糜	乌 米 糜
车厘茄	车 厘 茄
崢嶸	崢 嶸
沨	沨
试用期	试 用 期
要隘	要 隘
核蛋白	核 蛋 白
郑卫之音	郑 卫 之 音
平跤底	平 跤 底
位次	位 次
满招损，谦受益	满 招 损 ， 谦 受 益
祥林嫂	祥 林 嫂
𦌽	𦌽
日间	日 间
世錦賽	世 錦 賽
穿著	穿 著
畫鼓	畫 鼓
调兵遣将	调 兵 遣 将
膀儿	膀 儿
制图学	制 图 学
高溫瑜伽	高 溫 瑜 伽
唔可以	唔 可 以
犹豫不决	犹 豫 不 决
潮曲	潮 曲
按察	按 察
见得	见 得
和尚衫	和 尚 衫
母乳喂養	母 乳 喂 養
跨文化交際	跨 文 化 交 際
莫逆之交	莫 逆 之 交
哈得孙湾	哈 得 孙 湾
蝦膎	蝦 膎
木耳菜	木 耳 菜
树桥	树 桥
摆擂	摆 擂
碧玺	碧 玺
顯目	顯 目
沾手	沾 手
綠樹成蔭	綠 樹 成 蔭
路牌	路 牌
摩洛哥	摩 洛 哥
煽暴	煽 暴
包乘	包 乘
饱学之士	饱 学 之 士
䳉	䳉
匕鑽	匕 鑽
真核细胞	真 核 细 胞
桰	桰
椅頭仔	椅 頭 仔
一家老小	一 家 老 小
嗚呼	嗚 呼
黑板揩	黑 板 揩
屋裏	屋 裏
班洪	班 洪
陸沉	陸 沉
火萤	火 萤
銀河聯邦	銀 河 聯 邦
細工	細 工
镖	镖
外国代理人	外 国 代 理 人
市儈	市 儈
布萊恩	布 萊 恩
盥洗室	盥 洗 室
發大水	發 大 水
浴疗	浴 疗
煮水	煮 水
𠀤	𠀤
馍馍	馍 馍
竹荪	竹 荪
匍伏	匍 伏
抛物面	抛 物 面
仁至義盡	仁 至 義 盡
格列吡嗪	格 列 吡 嗪
馃箅	馃 箅
骨格	骨 格
老嬤嬤	老 嬤 嬤
诘责	诘 责
沙果	沙 果
安步当车	安 步 当 车
采	采
阿婆主	阿 婆 主
䰜	䰜
使不得	使 不 得
硬怼	硬 怼
疑虑	疑 虑
榠樝	榠 樝
打瞌𥅻	打 瞌 𥅻
爥	爥
高洁	高 洁
大晟	大 晟
逃奔	逃 奔
混堂	混 堂
靜脈	靜 脈
和約	和 約
燚	燚
网纱袋	网 纱 袋
𠈶	𠈶
侯营	侯 营
帶感	帶 感
这来	这 来
合唱	合 唱
茅箭	茅 箭
营利	营 利
愿者上钩	愿 者 上 钩
生物治療	生 物 治 療
食奶	食 奶
慰諭	慰 諭
火風	火 風
通融	通 融
死忌	死 忌
改土歸流	改 土 歸 流
寝食不安	寝 食 不 安
马太福音	马 太 福 音
䲛	䲛
蝴蝶子	蝴 蝶 子
總後方	總 後 方
掉以輕心	掉 以 輕 心
有始無終	有 始 無 終
蹀血	蹀 血
物理變化	物 理 變 化
圖書館	圖 書 館
同温層	同 温 層
馬克思主義	馬 克 思 主 義
沖澡	沖 澡
轧轹	轧 轹
羅布淖爾	羅 布 淖 爾
道爾頓	道 爾 頓
住手	住 手
深澤	深 澤
鱷魚	鱷 魚
卟啉	卟 啉
华格纳	华 格 纳
么人	么 人
豐功偉業	豐 功 偉 業
祖庙	祖 庙
黃土	黃 土
塗污	塗 污
乖乖儿	乖 乖 儿
搪	搪
人情味儿	人 情 味 儿
旅	旅
戰戰兢兢	戰 戰 兢 兢
結拜弟兄	結 拜 弟 兄
條子	條 子
抚躬自问	抚 躬 自 问
去勢	去 勢
因得	因 得
內插	內 插
若無其事	若 無 其 事
㵐	㵐
故业	故 业
讀書識字	讀 書 識 字
排毒	排 毒
若望默示录	若 望 默 示 录
安县	安 县
卯眼	卯 眼
粒细胞	粒 细 胞
腳墊	腳 墊
礼经	礼 经
多虧	多 虧
九重天	九 重 天
打耳光	打 耳 光
餵料	餵 料
膘肥	膘 肥
公判	公 判
逝世	逝 世
搭針	搭 針
䰽	䰽
新新人类	新 新 人 类
俄白联盟	俄 白 联 盟
戀牀	戀 牀
四跤鱼	四 跤 鱼
䍑	䍑
敢做敢當	敢 做 敢 當
臥病在床	臥 病 在 床
亽	亽
护肤霜	护 肤 霜
颗粒	颗 粒
涼瓜	涼 瓜
开胶	开 胶
𪎣	𪎣
腳板子	腳 板 子
偺們	偺 們
閩寧	閩 寧
虗	虗
油票	油 票
大員	大 員
药剂	药 剂
俭省	俭 省
绵纱	绵 纱
領會	領 會
差額選舉	差 額 選 舉
擇食	擇 食
后汉	后 汉
野日頭吃家日頭	野 日 頭 吃 家 日 頭
椅憑	椅 憑
時母	時 母
艙口	艙 口
體無完膚	體 無 完 膚
彩色显像管	彩 色 显 像 管
偷欢	偷 欢
搶收	搶 收
腳船	腳 船
漏译	漏 译
為虎作倀	為 虎 作 倀
国民生产总值	国 民 生 产 总 值
生物工程	生 物 工 程
燈塔山	燈 塔 山
食言而肥	食 言 而 肥
娘家人	娘 家 人
费句	费 句
音感	音 感
組會	組 會
事在人為	事 在 人 為
前塵	前 塵
回游	回 游
上龛	上 龛
一夥	一 夥
珗	珗
傸	傸
细胞周期	细 胞 周 期
钩子	钩 子
沙場	沙 場
爲重	爲 重
女女	女 女
信物	信 物
卒讀	卒 讀
不饱和脂肪酸	不 饱 和 脂 肪 酸
会所	会 所
存儲器	存 儲 器
生兒	生 兒
潬	潬
權柄	權 柄
詢價	詢 價
见面会	见 面 会
似汰	似 汰
嘰	嘰
榮市	榮 市
窟	窟
新筱津	新 筱 津
替身	替 身
梨园戏	梨 园 戏
反症	反 症
打算	打 算
熏风	熏 风
循環換氣	循 環 換 氣
卵母細胞	卵 母 細 胞
扣肉	扣 肉
勿慮	勿 慮
弄醒	弄 醒
褶皺	褶 皺
殺人游戲	殺 人 游 戲
固執己見	固 執 己 見
電頭毛	電 頭 毛
後邊	後 邊
婊头	婊 头
康复	康 复
间冰期	间 冰 期
猴子	猴 子
泉溝	泉 溝
软硬兼施	软 硬 兼 施
黎黑	黎 黑
遺憾	遺 憾
代名詞	代 名 詞
碰釘子	碰 釘 子
大喊	大 喊
管樂	管 樂
纂	纂
弗拉基米尔	弗 拉 基 米 尔
甲親像	甲 親 像
硅藻土	硅 藻 土
緣投峇	緣 投 峇
巴格其	巴 格 其
前保险杠	前 保 险 杠
首烏	首 烏
獻帝	獻 帝
致敏源	致 敏 源
溫酒	溫 酒
房产	房 产
一字不易	一 字 不 易
強盜	強 盜
上缴	上 缴
日沒	日 沒
翋𦑶	翋 𦑶
圣诞快乐	圣 诞 快 乐
偽鈔	偽 鈔
義旗	義 旗
是搭	是 搭
移住	移 住
九流三教	九 流 三 教
區段	區 段
车辘	车 辘
岁时	岁 时
贵霜	贵 霜
合作无间	合 作 无 间
对冲基金	对 冲 基 金
宫古	宫 古
鹵莽	鹵 莽
鑽木取火	鑽 木 取 火
廣東閑話	廣 東 閑 話
吞拿	吞 拿
午检	午 检
懿行	懿 行
穆黑	穆 黑
心静	心 静
啞佬	啞 佬
併書	併 書
尧天	尧 天
終聲	終 聲
雇傭兵	雇 傭 兵
決口	決 口
大环内酯	大 环 内 酯
表面光	表 面 光
红瑶	红 瑶
实验室	实 验 室
候選人	候 選 人
走撞	走 撞
蚕仔树	蚕 仔 树
诊	诊
生日趴	生 日 趴
一差二悮	一 差 二 悮
外氣	外 氣
来复枪	来 复 枪
𭣇	𭣇
共洩	共 洩
牽拉	牽 拉
歸夢	歸 夢
轰轰烈烈	轰 轰 烈 烈
偷窥狂	偷 窥 狂
過載	過 載
法界	法 界
前地	前 地
困醒	困 醒
铂金	铂 金
璧还	璧 还
麻麻地	麻 麻 地
親爹	親 爹
一角鲸	一 角 鲸
岱王沟	岱 王 沟
求职面试	求 职 面 试
冥衣	冥 衣
语速	语 速
论战	论 战
今日子	今 日 子
长老宗	长 老 宗
早霞	早 霞
配体	配 体
吃风	吃 风
钦定	钦 定
这合儿	这 合 儿
思来想去	思 来 想 去
東宮	東 宮
承攬	承 攬
眼淚	眼 淚
抂	抂
败兴	败 兴
德古西加巴	德 古 西 加 巴
盡義務	盡 義 務
建交	建 交
战争舞	战 争 舞
二婚货	二 婚 货
空鐘	空 鐘
讓道	讓 道
雨傘架	雨 傘 架
貞固	貞 固
落妝	落 妝
茶芥	茶 芥
𱊱	𱊱
獸化	獸 化
碗兒	碗 兒
上镜	上 镜
牛鼻	牛 鼻
下崽	下 崽
鴨春	鴨 春
奻	奻
卯金刀	卯 金 刀
批紙	批 紙
辎	辎
地糊	地 糊
幺子	幺 子
齿龋	齿 龋
欧防风	欧 防 风
竘	竘
释放	释 放
蹁躚	蹁 躚
异丁酸	异 丁 酸
影簿	影 簿
搞頭	搞 頭
厨具	厨 具
白田	白 田
嫻靜	嫻 靜
刘家隔	刘 家 隔
冇癮	冇 癮
做風颱	做 風 颱
歹狗气	歹 狗 气
猪腩肉	猪 腩 肉
梅雨潭	梅 雨 潭
调腔	调 腔
豆腐皮兒	豆 腐 皮 兒
间歇	间 歇
电铃	电 铃
予取予求	予 取 予 求
工作許可	工 作 許 可
新巴	新 巴
描图	描 图
昆士兰果	昆 士 兰 果
啥體	啥 體
时间段	时 间 段
考问	考 问
大展鴻圖	大 展 鴻 圖
㙭	㙭
柦	柦
理货员	理 货 员
托管	托 管
閃鑠	閃 鑠
井岡山	井 岡 山
佇立	佇 立
乳哀	乳 哀
敦煌学家	敦 煌 学 家
打斋	打 斋
千言萬語	千 言 萬 語
紐扣兒	紐 扣 兒
缴跤	缴 跤
簧管	簧 管
汉子	汉 子
摄提	摄 提
法语	法 语
平均律	平 均 律
散會	散 會
武強	武 強
情歌	情 歌
打粗	打 粗
宫廷剧	宫 廷 剧
警車	警 車
黄六医生	黄 六 医 生
巧合	巧 合
陽塘	陽 塘
煙灰兒	煙 灰 兒
康腔	康 腔
母以子貴	母 以 子 貴
森然	森 然
東不拉	東 不 拉
豐樂	豐 樂
环庚烷	环 庚 烷
奏疏	奏 疏
維希	維 希
虎体猿臂	虎 体 猿 臂
销耗	销 耗
酥油茶	酥 油 茶
心潮澎湃	心 潮 澎 湃
布头	布 头
無恥讕言	無 恥 讕 言
甲冑	甲 冑
腎上腺素	腎 上 腺 素
歹毒	歹 毒
眠床头	眠 床 头
箭镞	箭 镞
拍通	拍 通
索多瑪	索 多 瑪
嚼劲	嚼 劲
进城	进 城
辞汇	辞 汇
𬱼	𬱼
悶笛	悶 笛
美術字	美 術 字
花蕊	花 蕊
魚肚白	魚 肚 白
小学	小 学
午魚	午 魚
石岡	石 岡
摩打	摩 打
隶圉	隶 圉
不怎麼	不 怎 麼
巴贝多	巴 贝 多
拜山	拜 山
大元	大 元
集释	集 释
未嘗不可	未 嘗 不 可
無須乎	無 須 乎
瘤子	瘤 子
濱松	濱 松
睃	睃
曲張	曲 張
沙坝	沙 坝
會當	會 當
振盪器	振 盪 器
猛兽	猛 兽
擬人	擬 人
嬃	嬃
蛋黄黄	蛋 黄 黄
原壄	原 壄
碎冰船	碎 冰 船
狭长	狭 长
豬八戒	豬 八 戒
圆熟	圆 熟
因為得	因 為 得
互見	互 見
长江埠	长 江 埠
白芨	白 芨
調酒	調 酒
气象图	气 象 图
单方面	单 方 面
敵國	敵 國
冰镐	冰 镐
摽笑	摽 笑
些須	些 須
東瀛	東 瀛
㑪	㑪
田裡心	田 裡 心
臭屎步	臭 屎 步
蔓草	蔓 草
昏昏欲睡	昏 昏 欲 睡
明朝會	明 朝 會
招手	招 手
圖示	圖 示
封堵	封 堵
茶乌	茶 乌
番蔥	番 蔥
蝌蚪	蝌 蚪
绮丽	绮 丽
寬帶	寬 帶
澆花	澆 花
不搂	不 搂
哑囝	哑 囝
行管令	行 管 令
阿尔泰	阿 尔 泰
阿列夫	阿 列 夫
酒禁	酒 禁
劢	劢
合歡山	合 歡 山
溫度	溫 度
哭訴	哭 訴
不順	不 順
無線電報	無 線 電 報
内幕信息	内 幕 信 息
許旺細胞	許 旺 細 胞
丝棉被	丝 棉 被
動物油	動 物 油
譓	譓
尖頭鰻	尖 頭 鰻
岒	岒
纲纪	纲 纪
囊泡	囊 泡
搜寻	搜 寻
那珂	那 珂
蠶眠	蠶 眠
躐级	躐 级
響忽雷	響 忽 雷
滑翔機	滑 翔 機
嶸	嶸
黨錮	黨 錮
界别	界 别
厄弗所书	厄 弗 所 书
專區	專 區
教權主義	教 權 主 義
环己二烯	环 己 二 烯
你們好	你 們 好
傳統	傳 統
略稱	略 稱
惩	惩
新侬爹	新 侬 爹
繩套	繩 套
国字框	国 字 框
三Q	三 Q
八分仪	八 分 仪
火母	火 母
纤维软骨	纤 维 软 骨
血脑屏障	血 脑 屏 障
增强现实	增 强 现 实
多贺城	多 贺 城
沽空機構	沽 空 機 構
餘溫	餘 溫
心计	心 计
水青冈	水 青 冈
忽悠	忽 悠
本地化	本 地 化
臭獻味	臭 獻 味
提籃	提 籃
咖喱魚蛋	咖 喱 魚 蛋
唯粉	唯 粉
不可抗拒的恩典	不 可 抗 拒 的 恩 典
观音暴	观 音 暴
胧	胧
言之無物	言 之 無 物
豢养	豢 养
闪熠	闪 熠
番鸭角	番 鸭 角
榮華	榮 華
氐惆	氐 惆
滬劇	滬 劇
叫扁	叫 扁
问句	问 句
翳腻	翳 腻
致公黨	致 公 黨
软实力	软 实 力
湧潮	湧 潮
𩗗	𩗗
特倫頓	特 倫 頓
回归热	回 归 热
米粮川	米 粮 川
烂银铠	烂 银 铠
盟軍	盟 軍
薄酥卷饼	薄 酥 卷 饼
襳	襳
四界遨	四 界 遨
接待處	接 待 處
犢子	犢 子
勝選	勝 選
停止	停 止
薩保	薩 保
叢集	叢 集
控制物質	控 制 物 質
牛河	牛 河
擺擂	擺 擂
英属维京群岛	英 属 维 京 群 岛
香港粵語	香 港 粵 語
小儿科	小 儿 科
铁槌	铁 槌
錄音帶	錄 音 帶
菸斗	菸 斗
马沙打冷	马 沙 打 冷
英伦诸岛	英 伦 诸 岛
擠出	擠 出
得隴望蜀	得 隴 望 蜀
打从	打 从
嚮壁虛造	嚮 壁 虛 造
鸭公子	鸭 公 子
保丰	保 丰
四字母詞	四 字 母 詞
覉	覉
虞	虞
人烟凑集	人 烟 凑 集
瘦子	瘦 子
大碼	大 碼
捲菸	捲 菸
短歲壽	短 歲 壽
辣媽	辣 媽
逃亡	逃 亡
蠛	蠛
澈	澈
圣德	圣 德
退伍军人	退 伍 军 人
斯加里野	斯 加 里 野
说理	说 理
食飯桌	食 飯 桌
蠟像館	蠟 像 館
撫松	撫 松
變啥魍	變 啥 魍
楳	楳
商圈	商 圈
以小見大	以 小 見 大
先頭	先 頭
劯	劯
空佬	空 佬
披风	披 风
诞辰	诞 辰
郵遞員	郵 遞 員
客家學	客 家 學
白痴	白 痴
外家亲	外 家 亲
紛擾	紛 擾
鉸刀剪	鉸 刀 剪
漁洋關	漁 洋 關
滿洲象棋	滿 洲 象 棋
师道	师 道
伴奐	伴 奐
脈象	脈 象
大元帥	大 元 帥
凿井	凿 井
晃晃	晃 晃
破格	破 格
狭叶薰衣草	狭 叶 薰 衣 草
註疏家	註 疏 家
垙	垙
國家安全	國 家 安 全
惟獨	惟 獨
雅化	雅 化
代謝物	代 謝 物
洲际	洲 际
跟蹤狂	跟 蹤 狂
細菌學	細 菌 學
洜	洜
小鸡娃	小 鸡 娃
榮民	榮 民
酒驾	酒 驾
碩士生	碩 士 生
雙黃蛋	雙 黃 蛋
裸贷	裸 贷
沉积	沉 积
欺凌	欺 凌
小麥草	小 麥 草
三唔識七	三 唔 識 七
拉力弹簧	拉 力 弹 簧
寊	寊
外部設備	外 部 設 備
名人效應	名 人 效 應
新邵	新 邵
善无	善 无
落订	落 订
千千万万	千 千 万 万
美猪	美 猪
寸耳风	寸 耳 风
浮遊	浮 遊
朝暉	朝 暉
阁子	阁 子
挞伐	挞 伐
膽悸	膽 悸
图画	图 画
磁振子	磁 振 子
莫比乌斯带	莫 比 乌 斯 带
嚮往	嚮 往
看牛伢子	看 牛 伢 子
拍電	拍 電
高位厚祿	高 位 厚 祿
溝渠	溝 渠
军兵	军 兵
查案	查 案
約見	約 見
sit堂	s i t 堂
卢布	卢 布
光学	光 学
歌手	歌 手
延命菊	延 命 菊
謹記	謹 記
硬要	硬 要
小姨妹兒	小 姨 妹 兒
擬測	擬 測
𰧻	𰧻
名誉	名 誉
雙日	雙 日
伸手不见五指	伸 手 不 见 五 指
票房毒药	票 房 毒 药
连盟	连 盟
族人	族 人
贝贝	贝 贝
残帙	残 帙
使用者方块	使 用 者 方 块
便装	便 装
鋼筋	鋼 筋
直昇機	直 昇 機
黄县	黄 县
來死	來 死
红白事	红 白 事
无克遗育	无 克 遗 育
剪蚻	剪 蚻
西烏旗	西 烏 旗
一言九鼎	一 言 九 鼎
糖粉	糖 粉
䳐	䳐
𠃏	𠃏
补骨脂	补 骨 脂
今生	今 生
报账	报 账
首都圈	首 都 圈
入肚	入 肚
繞彎子	繞 彎 子
巴拿芬	巴 拿 芬
柯利根	柯 利 根
松鱼	松 鱼
火鼠	火 鼠
十三張	十 三 張
箏	箏
破口大罵	破 口 大 罵
波棱蓋兒	波 棱 蓋 兒
紅頭嶼	紅 頭 嶼
围袋袋	围 袋 袋
鳗鲡	鳗 鲡
反狗仔	反 狗 仔
雄渾	雄 渾
后天仔	后 天 仔
阿姆河	阿 姆 河
㞩	㞩
古谚	古 谚
遞加	遞 加
𠯦	𠯦
坑沟	坑 沟
儳道	儳 道
退居	退 居
菲列賓	菲 列 賓
少吃多餐	少 吃 多 餐
心脑血管疾病	心 脑 血 管 疾 病
被害	被 害
受伤	受 伤
小三和弦	小 三 和 弦
浿水	浿 水
帶狀皰疹	帶 狀 皰 疹
詥	詥
䒌	䒌
奮威	奮 威
俄羅斯輪盤	俄 羅 斯 輪 盤
垫底费	垫 底 费
覐	覐
龚工	龚 工
月下	月 下
外卡	外 卡
说合人	说 合 人
騷比	騷 比
落叶树	落 叶 树
錵	錵
𫍣	𫍣
類別	類 別
结肠脾曲	结 肠 脾 曲
打交仔	打 交 仔
約伯	約 伯
䆀辦	䆀 辦
多尿症	多 尿 症
丯	丯
攞景	攞 景
总胆管	总 胆 管
從善如流	從 善 如 流
少見	少 見
包辦	包 辦
金刚山	金 刚 山
拆尿尿	拆 尿 尿
魚夫	魚 夫
演示	演 示
野鸭	野 鸭
脈旺	脈 旺
死巷巷儿	死 巷 巷 儿
情义	情 义
褲頭帶	褲 頭 帶
搬起石頭打自己的腳	搬 起 石 頭 打 自 己 的 腳
别来无恙	别 来 无 恙
核潜艇	核 潜 艇
苇	苇
面炙	面 炙
腰尺	腰 尺
手殘	手 殘
鲩	鲩
雲貴高原	雲 貴 高 原
鸀	鸀
乌弋山离	乌 弋 山 离
仆役	仆 役
留种	留 种
工字铁	工 字 铁
𩝐	𩝐
淺海	淺 海
糊突	糊 突
攀親	攀 親
因为得	因 为 得
癜風	癜 風
牧畜	牧 畜
什么鬼	什 么 鬼
㡪	㡪
振動	振 動
豹子	豹 子
花捲	花 捲
先農湯	先 農 湯
纓	纓
倾吐	倾 吐
和齐	和 齐
逆黨	逆 黨
當初	當 初
啰噼	啰 噼
论说	论 说
拍拖	拍 拖
路试	路 试
化膿性鏈球菌	化 膿 性 鏈 球 菌
偏著	偏 著
共點	共 點
阿拉伯国家联盟	阿 拉 伯 国 家 联 盟
小产	小 产
升檔	升 檔
㟱	㟱
怎	怎
济南	济 南
懬	懬
谈恋爱	谈 恋 爱
擅权	擅 权
謲	謲
踱街	踱 街
瀓	瀓
被罪	被 罪
抒怀	抒 怀
䫸	䫸
乌丘	乌 丘
空洞	空 洞
忌相	忌 相
折墮	折 墮
少女風	少 女 風
浄	浄
胡楊	胡 楊
官话化	官 话 化
轻狂	轻 狂
高勾麗	高 勾 麗
鏡泊湖	鏡 泊 湖
打吊针	打 吊 针
濔迤	濔 迤
蜘	蜘
抍	抍
搶佔	搶 佔
小说家	小 说 家
饮茶	饮 茶
宿营地	宿 营 地
通航	通 航
諦	諦
大雨滂沱	大 雨 滂 沱
食福	食 福
山阳	山 阳
椤	椤
引人入胜	引 人 入 胜
火燒坪	火 燒 坪
茶垢	茶 垢
𠒿	𠒿
简语	简 语
班竹	班 竹
升天	升 天
腦膜	腦 膜
卸脸	卸 脸
地圖	地 圖
下巴兒	下 巴 兒
趁食查某	趁 食 查 某
流話子	流 話 子
面麶	面 麶
列祖	列 祖
牵牛花	牵 牛 花
荡然无存	荡 然 无 存
美膩	美 膩
計算機語言	計 算 機 語 言
𥪑	𥪑
家譜	家 譜
乌跤蠓	乌 跤 蠓
闹太套	闹 太 套
法眼	法 眼
纯洁	纯 洁
蚁	蚁
哎喲喂呀	哎 喲 喂 呀
圣保罗	圣 保 罗
胡旋	胡 旋
民间	民 间
狗母蛇	狗 母 蛇
協助自殺	協 助 自 殺
芝邑巴	芝 邑 巴
捕手	捕 手
纯化	纯 化
嚇尿	嚇 尿
分界线	分 界 线
傷人	傷 人
子孫滿堂	子 孫 滿 堂
海東	海 東
珍視	珍 視
暗间	暗 间
山泥倾泻	山 泥 倾 泻
伴彈	伴 彈
邊緣政策	邊 緣 政 策
浮滑	浮 滑
酒類	酒 類
規模經濟	規 模 經 濟
網紗	網 紗
蒲萄	蒲 萄
鴈門關	鴈 門 關
睇視	睇 視
劳动阶级	劳 动 阶 级
莖茶	莖 茶
出千	出 千
边桌	边 桌
走難	走 難
這合兒	這 合 兒
老撾	老 撾
圓舞曲	圓 舞 曲
怨天尤人	怨 天 尤 人
熱播	熱 播
松糕鞋	松 糕 鞋
骂人	骂 人
内分泌科	内 分 泌 科
按部就班	按 部 就 班
㩹	㩹
從來	從 來
波斯尼亚和黑塞哥维那	波 斯 尼 亚 和 黑 塞 哥 维 那
竇匯	竇 匯
砲艦	砲 艦
寫信	寫 信
缎	缎
完成体	完 成 体
倫巴	倫 巴
哏兒	哏 兒
白蟻	白 蟻
雁門關	雁 門 關
健美	健 美
㡸	㡸
鹘嘲	鹘 嘲
党龄	党 龄
愛稱	愛 稱
爺們	爺 們
軟盤	軟 盤
仈字	仈 字
閑聊	閑 聊
關聖帝君	關 聖 帝 君
古蹟	古 蹟
好斗	好 斗
叫雞	叫 雞
塗跤巾	塗 跤 巾
读屎片	读 屎 片
誘致	誘 致
打波	打 波
仓猝	仓 猝
歷溪	歷 溪
細故	細 故
無偌久	無 偌 久
傳染力	傳 染 力
𰁼	𰁼
桐蒿	桐 蒿
楊家坡	楊 家 坡
豐盈	豐 盈
暴力破解	暴 力 破 解
有目无珠	有 目 无 珠
萰	萰
真空包裝	真 空 包 裝
乱离	乱 离
袘	袘
不單	不 單
泥鰍魚	泥 鰍 魚
性少數	性 少 數
干净利落	干 净 利 落
記憶棒	記 憶 棒
先烈	先 烈
法罗群岛	法 罗 群 岛
护罩	护 罩
低鉀血症	低 鉀 血 症
农产	农 产
春景	春 景
小細胞肺癌	小 細 胞 肺 癌
粤剧	粤 剧
墓室	墓 室
乾道	乾 道
核威慑	核 威 慑
䳒	䳒
听得见	听 得 见
傣语	傣 语
蝸角之爭	蝸 角 之 爭
𫧃用	𫧃 用
侠客	侠 客
塗水師	塗 水 師
書函	書 函
散裝	散 裝
沙西米	沙 西 米
新四军	新 四 军
又紅又專	又 紅 又 專
东非	东 非
凝睇	凝 睇
兌換	兌 換
生理學	生 理 學
賀哈	賀 哈
一挥而就	一 挥 而 就
財源滾滾	財 源 滾 滾
反例	反 例
五脚基	五 脚 基
鏇	鏇
萬人	萬 人
毛毛	毛 毛
一下子	一 下 子
譫哆	譫 哆
㢟	㢟
上肢	上 肢
遮仔節	遮 仔 節
囡仔人	囡 仔 人
居安思危	居 安 思 危
大号	大 号
叉兒	叉 兒
群而不黨	群 而 不 黨
犟嘴	犟 嘴
离心率	离 心 率
捙拚	捙 拚
疾病头	疾 病 头
無期徒刑	無 期 徒 刑
飛洋傘	飛 洋 傘
長勢	長 勢
傻笑	傻 笑
強壯	強 壯
三胡	三 胡
𫃵	𫃵
没想到	没 想 到
风灌仔	风 灌 仔
开荤	开 荤
校注	校 注
和尚头	和 尚 头
㟳	㟳
民調	民 調
粲然	粲 然
不進則退	不 進 則 退
两江道	两 江 道
𪎒	𪎒
密钥	密 钥
土门	土 门
略為	略 為
博識	博 識
销声匿迹	销 声 匿 迹
诽	诽
自强不息	自 强 不 息
袂博假博	袂 博 假 博
弹冠相庆	弹 冠 相 庆
時鐘座	時 鐘 座
獸慾	獸 慾
线袜	线 袜
漢語拼音方案	漢 語 拼 音 方 案
生不逢時	生 不 逢 時
傳旨	傳 旨
悶頭	悶 頭
仲阳	仲 阳
石像鬼	石 像 鬼
𠛅风	𠛅 风
愛女	愛 女
倮身	倮 身
氫氧基	氫 氧 基
鯒	鯒
夾公仔機	夾 公 仔 機
缋	缋
闪念	闪 念
唉呀	唉 呀
松果腺	松 果 腺
開議	開 議
滄浪	滄 浪
網劇	網 劇
学力	学 力
大煙鬼	大 煙 鬼
转动惯量	转 动 惯 量
受雇	受 雇
交登记	交 登 记
說白	說 白
律吕谱	律 吕 谱
威令頓	威 令 頓
网眼	网 眼
梦罟	梦 罟
西洋侬	西 洋 侬
流氓	流 氓
大牙板	大 牙 板
割草機	割 草 機
攘夷	攘 夷
夹肌	夹 肌
托福	托 福
大板牙	大 板 牙
残体	残 体
斩新	斩 新
摄像	摄 像
掉隊	掉 隊
蕩覆	蕩 覆
閂鎖	閂 鎖
暗顿	暗 顿
着火	着 火
杭嘉湖平原	杭 嘉 湖 平 原
晶癖	晶 癖
朽腐	朽 腐
阿洛醣	阿 洛 醣
大營	大 營
一时半刻	一 时 半 刻
展柜	展 柜
汙跡	汙 跡
肝膽	肝 膽
安全性行爲	安 全 性 行 爲
奃	奃
㡒	㡒
竞技体操	竞 技 体 操
竹圍	竹 圍
嗌	嗌
白土粉	白 土 粉
葫芦岛	葫 芦 岛
農具	農 具
英伦银行	英 伦 银 行
虛設	虛 設
古典制约	古 典 制 约
撤换	撤 换
希求	希 求
鿫	鿫
基督新教	基 督 新 教
收綫	收 綫
旺銷	旺 銷
学生仔	学 生 仔
五子棋	五 子 棋
老年代步车	老 年 代 步 车
灵机一动	灵 机 一 动
老齡	老 齡
猛火	猛 火
理疗师	理 疗 师
犁耳	犁 耳
五島	五 島
卡伊达组织	卡 伊 达 组 织
諾厄	諾 厄
拿摩溫	拿 摩 溫
摆乌龙	摆 乌 龙
開臊	開 臊
何電	何 電
鏈條	鏈 條
夾仔	夾 仔
書單	書 單
定规	定 规
汙喏	汙 喏
ㄕ	ㄕ
足證	足 證
存死存絕	存 死 存 絕
水貨	水 貨
笙簧	笙 簧
巴哥	巴 哥
长城	长 城
壓制	壓 制
悒鬱	悒 鬱
有錯必糾	有 錯 必 糾
𱈇	𱈇
成群	成 群
䭗	䭗
主見	主 見
叫赵旺	叫 赵 旺
秦篆	秦 篆
文京	文 京
方時雨	方 時 雨
左拐	左 拐
四跤螞	四 跤 螞
嗇鬼	嗇 鬼
纹路	纹 路
有福同享，有禍同當	有 福 同 享 ， 有 禍 同 當
试谈	试 谈
話媒	話 媒
港剧	港 剧
行李箱	行 李 箱
杂交种	杂 交 种
己見	己 見
胶擦	胶 擦
汲古	汲 古
对帐单	对 帐 单
男配	男 配
丑逼	丑 逼
越池	越 池
坒	坒
菜苑	菜 苑
阉官	阉 官
不遂	不 遂
花崗岩	花 崗 岩
療瘉	療 瘉
有朝	有 朝
袂行得	袂 行 得
𤇾	𤇾
説多謝	説 多 謝
史拨尼克	史 拨 尼 克
清音	清 音
大不里士	大 不 里 士
三緘其口	三 緘 其 口
赼且	赼 且
禁忌症	禁 忌 症
攮	攮
閒晃	閒 晃
财东	财 东
神经系统	神 经 系 统
繳間	繳 間
抢饭碗	抢 饭 碗
夾道	夾 道
大蟲	大 蟲
米河	米 河
遲疑不決	遲 疑 不 決
敞篷车	敞 篷 车
結塊	結 塊
封聖	封 聖
閉孔外肌	閉 孔 外 肌
𡿺	𡿺
隐忧	隐 忧
腧穴	腧 穴
防冻	防 冻
相济	相 济
豪紳	豪 紳
仼	仼
𩰏	𩰏
虛構文學	虛 構 文 學
神馳	神 馳
奸猾	奸 猾
转运	转 运
软文	软 文
世纪	世 纪
粏仔	粏 仔
四神丸	四 神 丸
电影片	电 影 片
腳鐐	腳 鐐
框框	框 框
鼻哥窿担遮——避无可避	鼻 哥 窿 担 遮 — — 避 无 可 避
唠叨	唠 叨
泛化	泛 化
民樂	民 樂
頂夸克	頂 夸 克
魑魅	魑 魅
東躲西藏	東 躲 西 藏
二项式系数	二 项 式 系 数
声泪俱下	声 泪 俱 下
漢書	漢 書
蓼	蓼
波利尼西亞	波 利 尼 西 亞
故弄玄虚	故 弄 玄 虚
浴間仔	浴 間 仔
抠门	抠 门
嗜中性白血球	嗜 中 性 白 血 球
瞓街	瞓 街
黄酸	黄 酸
環渤海	環 渤 海
犯贱	犯 贱
兴宁	兴 宁
萎縮	萎 縮
腓尼基	腓 尼 基
六法全书	六 法 全 书
土壤學	土 壤 學
貿易風	貿 易 風
餐馆	餐 馆
聚焦	聚 焦
通财	通 财
义行	义 行
拉阿魯哇人	拉 阿 魯 哇 人
䀉	䀉
東莨菪鹼	東 莨 菪 鹼
知己知彼，百战百胜	知 己 知 彼 ， 百 战 百 胜
大板车	大 板 车
加依提勒克	加 依 提 勒 克
嵳	嵳
文藝家	文 藝 家
焪	焪
委员	委 员
𡷉	𡷉
課代表	課 代 表
荚膜	荚 膜
艺人	艺 人
枲	枲
挑担	挑 担
渴想	渴 想
狮身人面像	狮 身 人 面 像
续借	续 借
儲蓄賬戶	儲 蓄 賬 戶
牛彔	牛 彔
洋芋頭	洋 芋 頭
一只二只	一 只 二 只
满场	满 场
無紀綱	無 紀 綱
褴	褴
主张	主 张
祕本	祕 本
紀年	紀 年
歪瓜劣棗	歪 瓜 劣 棗
家庭主妇	家 庭 主 妇
抺摸	抺 摸
乌特勒支	乌 特 勒 支
姑妈	姑 妈
薰膏	薰 膏
贝斯	贝 斯
馬圈	馬 圈
正气	正 气
超對稱粒子	超 對 稱 粒 子
坟冢	坟 冢
好啉	好 啉
怨言	怨 言
藝業	藝 業
鲎勺	鲎 勺
俯視	俯 視
捱騾仔	捱 騾 仔
封蜡	封 蜡
胘	胘
瘦蜢蜢	瘦 蜢 蜢
比较语言学	比 较 语 言 学
拉瓦勒	拉 瓦 勒
多管闲事	多 管 闲 事
能指	能 指
前腸	前 腸
地方生物誌	地 方 生 物 誌
荒	荒
不动点	不 动 点
找寻	找 寻
排鼓	排 鼓
酒窖	酒 窖
喙唇皮	喙 唇 皮
河魨毒素	河 魨 毒 素
淚骨	淚 骨
阿奇黴素	阿 奇 黴 素
跨平臺	跨 平 臺
黃犬	黃 犬
時代	時 代
腐爛	腐 爛
𫤶	𫤶
火雞	火 雞
京阪	京 阪
盲动	盲 动
烏翼仔	烏 翼 仔
植物乳桿菌	植 物 乳 桿 菌
開熙	開 熙
圖牀	圖 牀
半衰期	半 衰 期
训诫	训 诫
听话	听 话
衞生棉	衞 生 棉
佳肴	佳 肴
𤗈	𤗈
义山	义 山
大有可為	大 有 可 為
雜技	雜 技
采访	采 访
元寶	元 寶
惡霸	惡 霸
烏蘭巴托	烏 蘭 巴 托
手戟仔	手 戟 仔
賽特犬	賽 特 犬
荆州	荆 州
恶实	恶 实
𫜩	𫜩
科氏力	科 氏 力
崑	崑
满腔热情	满 腔 热 情
液化	液 化
藩國	藩 國
撿生	撿 生
精品店	精 品 店
飯田	飯 田
慾火	慾 火
海鲜价	海 鲜 价
没心没肺	没 心 没 肺
爬楼	爬 楼
華南	華 南
駤	駤
蠅	蠅
混合经济	混 合 经 济
縬	縬
豹虎	豹 虎
洋車	洋 車
塞尔维亚人	塞 尔 维 亚 人
医药	医 药
壓軸	壓 軸
故态复萌	故 态 复 萌
止蚀	止 蚀
搬用	搬 用
裤管	裤 管
統稱	統 稱
紅磷	紅 磷
豆腐腦	豆 腐 腦
乖乖兒	乖 乖 兒
落話	落 話
大團結	大 團 結
赬盤	赬 盤
鹽梟	鹽 梟
楜椒	楜 椒
女掌柜的	女 掌 柜 的
遮遮掩掩	遮 遮 掩 掩
嘉靖	嘉 靖
牛鬼蛇神	牛 鬼 蛇 神
高腳蟹	高 腳 蟹
毛果芸香碱	毛 果 芸 香 碱
后晌儿	后 晌 儿
方糖	方 糖
声嘶力竭	声 嘶 力 竭
纠偏	纠 偏
驚人	驚 人
雅號	雅 號
功利化	功 利 化
胡話	胡 話
外接	外 接
掼稻	掼 稻
鎖死	鎖 死
每天	每 天
反流	反 流
顫音	顫 音
罪有應得	罪 有 應 得
掩護	掩 護
裝備	裝 備
贤哲	贤 哲
韩半岛	韩 半 岛
乒乓波	乒 乓 波
𰈍	𰈍
鞋𢵼仔	鞋 𢵼 仔
㩼	㩼
匾額	匾 額
禮拜三	禮 拜 三
厚黑學	厚 黑 學
徐羅伐	徐 羅 伐
白目	白 目
一頭	一 頭
继电器	继 电 器
入关	入 关
新廟	新 廟
行为科学	行 为 科 学
途人	途 人
錢包仔	錢 包 仔
朗道	朗 道
虱嫲	虱 嫲
传唱度	传 唱 度
橙皮	橙 皮
濜	濜
桀喙	桀 喙
懂王	懂 王
氣場	氣 場
玛祖卡	玛 祖 卡
自相矛盾	自 相 矛 盾
石頭花	石 頭 花
鑿鑿	鑿 鑿
來日	來 日
柏林	柏 林
辩护权	辩 护 权
组团	组 团
長除法	長 除 法
忽律	忽 律
發排	發 排
鞅鞅	鞅 鞅
咖啡精	咖 啡 精
移防	移 防
猎头	猎 头
评议	评 议
跳脚	跳 脚
称	称
信杯	信 杯
代作	代 作
映衰	映 衰
眞實	眞 實
水蔬	水 蔬
拨号盘	拨 号 盘
租户	租 户
朝雾	朝 雾
請移玉步	請 移 玉 步
包围	包 围
静脉注射	静 脉 注 射
刊	刊
淋巴細胞	淋 巴 細 胞
榡	榡
漒	漒
令親	令 親
趙錢孫李	趙 錢 孫 李
剁碎	剁 碎
兵戈	兵 戈
私联	私 联
供水	供 水
案板	案 板
滿口	滿 口
育民	育 民
後台老板	後 台 老 板
纹脶	纹 脶
老啮啮	老 啮 啮
借位	借 位
食蟻獸	食 蟻 獸
炭屎	炭 屎
畏聲	畏 聲
红藤	红 藤
電臺	電 臺
立體化	立 體 化
实线	实 线
𰬇	𰬇
琿春	琿 春
踎低	踎 低
加溫	加 溫
直进	直 进
達比加群	達 比 加 群
豺虎	豺 虎
初意	初 意
八帶魚	八 帶 魚
綠色長城	綠 色 長 城
剧组	剧 组
宝塚	宝 塚
波光粼粼	波 光 粼 粼
駕駛艙	駕 駛 艙
寧海	寧 海
黃粱	黃 粱
边样	边 样
𬸅	𬸅
贝书	贝 书
陰暗	陰 暗
擒擒青	擒 擒 青
长春碱	长 春 碱
阴唇	阴 唇
髋关节	髋 关 节
噶伦	噶 伦
郵寄	郵 寄
童顏	童 顏
總	總
蔼然可亲	蔼 然 可 亲
圆桌会议	圆 桌 会 议
尬	尬
酒矸	酒 矸
擺臂	擺 臂
幼稚班	幼 稚 班
增订	增 订
痌	痌
破瓜	破 瓜
槭樹	槭 樹
蘇活	蘇 活
𬭕	𬭕
快勞	快 勞
弟媳	弟 媳
督察	督 察
狼窩	狼 窩
兽人控	兽 人 控
细润	细 润
筍虡	筍 虡
打喷睡	打 喷 睡
植化素	植 化 素
字串	字 串
易卦	易 卦
偪	偪
病起	病 起
水鯤	水 鯤
解小手	解 小 手
瓣	瓣
平文	平 文
獨	獨
同位异音	同 位 异 音
披掛	披 掛
嫣头	嫣 头
好色之徒	好 色 之 徒
估	估
𠄤	𠄤
彈舌音	彈 舌 音
泰順	泰 順
落	落
食品加工机	食 品 加 工 机
慡	慡
寸寸貢	寸 寸 貢
絲織品	絲 織 品
桥脑	桥 脑
媩	媩
文采	文 采
討回公道	討 回 公 道
黄道带	黄 道 带
勃起功能障碍	勃 起 功 能 障 碍
史实性	史 实 性
纽埃	纽 埃
馬螂狂	馬 螂 狂
室内设计	室 内 设 计
舌音	舌 音
磨喙舌	磨 喙 舌
敬业	敬 业
轟擊	轟 擊
考察团	考 察 团
鸧	鸧
察里津	察 里 津
个毛	个 毛
界面	界 面
上下左右	上 下 左 右
讲唱	讲 唱
机械臂	机 械 臂
勤俭建国	勤 俭 建 国
頂晝	頂 晝
奉命	奉 命
點眼	點 眼
兇事	兇 事
汦	汦
烈山	烈 山
果凍兒	果 凍 兒
農時	農 時
歲星	歲 星
水魚	水 魚
巗	巗
雌黃	雌 黃
果子园	果 子 园
旍	旍
嗀	嗀
灯芯	灯 芯
临暗	临 暗
海鲜酱	海 鲜 酱
财务	财 务
阿伏伽德羅常量	阿 伏 伽 德 羅 常 量
觸景生情	觸 景 生 情
機頭	機 頭
勬	勬
面楂仔	面 楂 仔
欝	欝
机宜	机 宜
諞	諞
跛子	跛 子
多义	多 义
好返	好 返
西式	西 式
小三阳	小 三 阳
重脣音	重 脣 音
义校	义 校
女中豪杰	女 中 豪 杰
唬秤頭	唬 秤 頭
日烏	日 烏
𫟼	𫟼
爆疫	爆 疫
晨僵	晨 僵
乌加里特	乌 加 里 特
南汇	南 汇
風邪	風 邪
打破砂鍋問到底	打 破 砂 鍋 問 到 底
遺詔	遺 詔
坤西育	坤 西 育
京斯敦	京 斯 敦
貖	貖
个人号	个 人 号
茶艺	茶 艺
騰	騰
驮肚	驮 肚
風景綫	風 景 綫
舊貨	舊 貨
农谚	农 谚
琐罗亚斯德	琐 罗 亚 斯 德
選課	選 課
斷層掃描	斷 層 掃 描
步履维艰	步 履 维 艰
𠀂	𠀂
字條	字 條
赤腳	赤 腳
听得懂	听 得 懂
人文景观	人 文 景 观
金包銀	金 包 銀
随身碟	随 身 碟
卑謬	卑 謬
珠洲	珠 洲
論人	論 人
菸灰碟	菸 灰 碟
独创性	独 创 性
問答集	問 答 集
杭盖	杭 盖
起步	起 步
瞿	瞿
民心	民 心
無色	無 色
塱	塱
三國志演義	三 國 志 演 義
把口	把 口
空污	空 污
藥罐子	藥 罐 子
吊癀	吊 癀
指責	指 責
tōa-chí	t ō a - c h í
奇點	奇 點
畫皮	畫 皮
導管	導 管
開腔	開 腔
一言兩句	一 言 兩 句
畜牧業	畜 牧 業
廐肥	廐 肥
三十晚间子	三 十 晚 间 子
俏皮话	俏 皮 话
畮	畮
腎結石	腎 結 石
億萬富翁	億 萬 富 翁
閩菜	閩 菜
字里行间	字 里 行 间
有悖于	有 悖 于
䢈	䢈
順適	順 適
反或闸	反 或 闸
印度尼西亞共和國	印 度 尼 西 亞 共 和 國
蛇哥	蛇 哥
口腔潰瘍	口 腔 潰 瘍
裏頭	裏 頭
错漏	错 漏
夫妻肺片	夫 妻 肺 片
刈谷	刈 谷
朝鮮將棋	朝 鮮 將 棋
課金	課 金
首季	首 季
喅	喅
开机	开 机
溫存	溫 存
窘急	窘 急
煮饭的	煮 饭 的
前去年	前 去 年
罌粟籽	罌 粟 籽
黃山	黃 山
點破	點 破
三層	三 層
阿布達比	阿 布 達 比
無市	無 市
褫揭话	褫 揭 话
更始	更 始
汛地	汛 地
髦俊	髦 俊
翦滅	翦 滅
弱化	弱 化
遮係	遮 係
瘲	瘲
大卤面	大 卤 面
識得	識 得
机敏	机 敏
非刑	非 刑
塘	塘
罷是	罷 是
使目箭	使 目 箭
荏𪽴	荏 𪽴
整數分解	整 數 分 解
碰面	碰 面
举兵	举 兵
蒼峪	蒼 峪
舆论界	舆 论 界
治事	治 事
主臥	主 臥
洋鷄	洋 鷄
燈塔	燈 塔
十八年后又是一条好汉	十 八 年 后 又 是 一 条 好 汉
邦聯	邦 聯
肉食動物	肉 食 動 物
紅旗	紅 旗
範圍	範 圍
鉸鏈	鉸 鏈
腰鼓	腰 鼓
骥足	骥 足
会期	会 期
勸農	勸 農
盘点	盘 点
窟弄	窟 弄
跌声	跌 声
䄪	䄪
古晋	古 晋
鬆緊帶	鬆 緊 帶
老牌	老 牌
力學篤行	力 學 篤 行
游园会	游 园 会
革履	革 履
匹诺曹	匹 诺 曹
見稱	見 稱
協議婚姻	協 議 婚 姻
視界	視 界
栊仔内	栊 仔 内
牪	牪
毛腊肉	毛 腊 肉
跤爪	跤 爪
鮡	鮡
拟态	拟 态
蛇紋石	蛇 紋 石
𪚟	𪚟
遙控車	遙 控 車
雄辩	雄 辩
水红色	水 红 色
䰄	䰄
啕	啕
太子党	太 子 党
石斑魚	石 斑 魚
小大姐儿裁械子	小 大 姐 儿 裁 械 子
豆腐莝	豆 腐 莝
垂直平分线	垂 直 平 分 线
雪彈子	雪 彈 子
侯莫陈	侯 莫 陈
長驅直進	長 驅 直 進
胸无点墨	胸 无 点 墨
範家	範 家
丹尼索瓦人	丹 尼 索 瓦 人
北伐	北 伐
营养酵母	营 养 酵 母
人類	人 類
脱險	脱 險
克格勃	克 格 勃
秀才遇到兵——有理說不清	秀 才 遇 到 兵 — — 有 理 說 不 清
畟然	畟 然
竹树	竹 树
鷁首	鷁 首
結球甘藍	結 球 甘 藍
假惺惺	假 惺 惺
有事	有 事
动脉脂肪沉积	动 脉 脂 肪 沉 积
欷噓	欷 噓
屬實	屬 實
毫不	毫 不
复活岛	复 活 岛
保險套	保 險 套
打圞場	打 圞 場
察布	察 布
大日本帝国	大 日 本 帝 国
嚡裡頭	嚡 裡 頭
黄花闺女	黄 花 闺 女
菠萝油	菠 萝 油
固定资金	固 定 资 金
𨧀	𨧀
立等可取	立 等 可 取
㿽	㿽
酬神	酬 神
黄袍加身	黄 袍 加 身
义面	义 面
𨂝	𨂝
高爾基	高 爾 基
細胞因子	細 胞 因 子
韃靼海峽	韃 靼 海 峽
名爵	名 爵
黿魚	黿 魚
睒书	睒 书
糅	糅
魚鈎兒	魚 鈎 兒
怙恶不悛	怙 恶 不 悛
跳台	跳 台
藍	藍
仢	仢
探头	探 头
茸茸	茸 茸
戇工	戇 工
描邊	描 邊
有一搭沒一搭	有 一 搭 沒 一 搭
㟼	㟼
以鄰為壑	以 鄰 為 壑
肥膩	肥 膩
革除	革 除
帶病	帶 病
肚屎	肚 屎
实验	实 验
柑橘属	柑 橘 属
一息	一 息
歷任	歷 任
紙影仔	紙 影 仔
盜馬	盜 馬
匣子槍	匣 子 槍
安寧	安 寧
问卷	问 卷
達尼伊爾	達 尼 伊 爾
大西洋國	大 西 洋 國
福利國家	福 利 國 家
惭色	惭 色
重孙女	重 孙 女
顺口溜	顺 口 溜
隔夜𩠌	隔 夜 𩠌
见真	见 真
儜	儜
书脊	书 脊
五線	五 線
輔翼	輔 翼
喑哑	喑 哑
恩怨	恩 怨
工作人员	工 作 人 员
臊子面	臊 子 面
孕期	孕 期
毒麦	毒 麦
祸起萧墙	祸 起 萧 墙
葏	葏
算學	算 學
海滩	海 滩
㟚	㟚
公共知識分子	公 共 知 識 分 子
前因後果	前 因 後 果
𬾖	𬾖
鼉龍	鼉 龍
真真假假	真 真 假 假
亨八冷	亨 八 冷
舱外活动	舱 外 活 动
浅灰	浅 灰
排笔	排 笔
建陽	建 陽
越菜	越 菜
藍橋	藍 橋
乌蒂仔	乌 蒂 仔
豆類	豆 類
腹股沟管	腹 股 沟 管
土豪劣紳	土 豪 劣 紳
整党	整 党
䯃	䯃
代志	代 志
㽐	㽐
传颂	传 颂
肚臍帶	肚 臍 帶
讓路	讓 路
洋文	洋 文
瘦小	瘦 小
和而不同	和 而 不 同
回放	回 放
长官	长 官
添福添壽	添 福 添 壽
左手风	左 手 风
借條	借 條
请负	请 负
插水	插 水
洪山	洪 山
骨质	骨 质
性生活	性 生 活
保险金	保 险 金
樹熊猴	樹 熊 猴
贼佬	贼 佬
異說	異 說
白帶	白 帶
虎鑼	虎 鑼
足交	足 交
作穡儂	作 穡 儂
底层	底 层
黎庶	黎 庶
赤果果	赤 果 果
普蘭店	普 蘭 店
多愁善感	多 愁 善 感
嘗	嘗
𪎌	𪎌
龍湖	龍 湖
任意性	任 意 性
匆匆	匆 匆
降价	降 价
羞澀	羞 澀
浑仑	浑 仑
檢查員	檢 查 員
轻拿轻放	轻 拿 轻 放
大哥大	大 哥 大
䲼	䲼
腎單位	腎 單 位
绿豆芽	绿 豆 芽
方劑學	方 劑 學
䌶	䌶
駵	駵
划鬼脚	划 鬼 脚
鼎革	鼎 革
商数	商 数
缅甸	缅 甸
三缄其口	三 缄 其 口
乡下仔	乡 下 仔
筆力	筆 力
解乏	解 乏
暑天	暑 天
過床	過 床
白干儿	白 干 儿
板油	板 油
养蛇食鸡	养 蛇 食 鸡
黑朦	黑 朦
阿姆斯特朗	阿 姆 斯 特 朗
通俄	通 俄
膏鐧	膏 鐧
分镇	分 镇
停赛	停 赛
赤潮	赤 潮
体号	体 号
有眼无珠	有 眼 无 珠
躲	躲
京腔兒	京 腔 兒
信息員	信 息 員
鹞子	鹞 子
大盤股	大 盤 股
懷特霍斯	懷 特 霍 斯
帶皮	帶 皮
𠑻	𠑻
整黨	整 黨
足本	足 本
老少	老 少
帕果帕果	帕 果 帕 果
暴庫	暴 庫
十三經	十 三 經
考評局	考 評 局
葛逻禄	葛 逻 禄
撟中哥	撟 中 哥
㢶	㢶
白旄黄钺	白 旄 黄 钺
避馬瘟	避 馬 瘟
𫗞	𫗞
右心房	右 心 房
农历新年	农 历 新 年
白鬼	白 鬼
孝男	孝 男
花旦	花 旦
岩下竇	岩 下 竇
数羊	数 羊
一点血	一 点 血
黄花鱼	黄 花 鱼
伴星	伴 星
當晝頭	當 晝 頭
不打不相识	不 打 不 相 识
一成熟	一 成 熟
腹帶	腹 帶
阿克苏	阿 克 苏
积习	积 习
辦法	辦 法
路头工	路 头 工
為例	為 例
龜鑒	龜 鑒
言簡意賅	言 簡 意 賅
富文字	富 文 字
乾坤一擲	乾 坤 一 擲
高坡	高 坡
副学士	副 学 士
獨裁者	獨 裁 者
攝	攝
芡實	芡 實
褥單	褥 單
左片	左 片
柴可夫	柴 可 夫
热天热色	热 天 热 色
暴斃	暴 斃
𭁇	𭁇
宫词	宫 词
駁面子	駁 面 子
良宵	良 宵
劳累	劳 累
黑钱	黑 钱
摇笱	摇 笱
隶	隶
过盘	过 盘
狈	狈
電柱仔	電 柱 仔
使徒行传	使 徒 行 传
徐汇	徐 汇
正道	正 道
帶	帶
發癡	發 癡
駝	駝
秀才	秀 才
毛語錄	毛 語 錄
懹	懹
河東	河 東
普天同庆	普 天 同 庆
九流	九 流
菌类	菌 类
洗黑钱	洗 黑 钱
萨巴依	萨 巴 依
咖啡冰	咖 啡 冰
風窗	風 窗
生態旅遊	生 態 旅 遊
当夜	当 夜
波士尼亞	波 士 尼 亞
库米什	库 米 什
北	北
惨叫	惨 叫
书皮	书 皮
到	到
其中	其 中
基	基
中出	中 出
合	合
强基	强 基
秦皇岛	秦 皇 岛
不骄不躁	不 骄 不 躁
东	东
协同	协 同
仡	仡
以来	以 来
含糊	含 糊
發	發
错误	错 误
店	店
有时	有 时
所料	所 料
么	么
所见	所 见
海端	海 端
遇见	遇 见
敛财	敛 财
州	州
名	名
企业	企 业
据	据
过	过
教练	教 练
上都	上 都
提	提
评论员	评 论 员
教学	教 学
影院	影 院
记	记
德育	德 育
碰到	碰 到
谐	谐
对	对
分配	分 配
卫星	卫 星
首	首
网络安全	网 络 安 全
余	余
筒	筒
与	与
佼佼者	佼 佼 者
厂商	厂 商
国产	国 产
贰	贰
国际化	国 际 化
带	带
中	中
证实	证 实
甚至	甚 至
遗址	遗 址
巴拉	巴 拉
给予	给 予
男模	男 模
系	系
粮	粮
厂	厂
国政	国 政
评	评
国	国
从	从
辆	辆
案	案
描	描
介紹	介 紹
业	业
形态	形 态
娱	娱
拉伤	拉 伤
愛心	愛 心
事故	事 故
升级	升 级
择	择
鐤	鐤
方向	方 向
认为	认 为
无从	无 从
出台	出 台
銘	銘
档案	档 案
弹	弹
舌	舌
成	成
双	双
就要	就 要
压缩	压 缩
域名	域 名
决策	决 策
什	什
指	指
房间	房 间
看似	看 似
应当	应 当
语	语
私	私
年	年
信口	信 口
操作	操 作
玉	玉
值得	值 得
使用	使 用
管家	管 家
记者	记 者
精选	精 选
创	创
到了	到 了
临淄	临 淄
蜂	蜂
87	8 7
瓜	瓜
陈先	陈 先
推	推
老旧	老 旧
中	中
风习	风 习
市政府	市 政 府
闻名	闻 名
註冊	註 冊
吃	吃
象	象
治国	治 国
度	度
平台	平 台
传送带	传 送 带
家公	家 公
利	利
夯	夯
正宗	正 宗
秀逸	秀 逸
雖	雖
后面	后 面
卸任	卸 任
達	達
无	无
冷笑	冷 笑
构	构
珍惜	珍 惜
东	东
域	域
先生	先 生
薪	薪
拑	拑
天	天
今	今
喇	喇
龙山	龙 山
奏	奏
年	年
宜	宜
法	法
斯人	斯 人
四会	四 会
分類	分 類
可	可
罡	罡
商	商
食	食
三	三
畫	畫
永恆	永 恆
到了	到 了
矫	矫
故事片	故 事 片
傲然	傲 然
敖	敖
须得	须 得
人	人
基础	基 础
中	中
公	公
猪肉	猪 肉
举行	举 行
登	登
注册	注 册
人体	人 体
指导	指 导
即	即
了解	了 解
商业模式	商 业 模 式
博	博
鋼鐵	鋼 鐵
吉	吉
微	微
此	此
聆听	聆 听
天堂	天 堂
心	心
中式	中 式
导	导
種	種
打鱼	打 鱼
适用	适 用
玩家	玩 家
来的	来 的
执导	执 导
提高	提 高
始	始
衢	衢
当天	当 天
高职	高 职
黄	黄
优	优
感谢	感 谢
常	常
五台	五 台
移	移
决	决
斧	斧
能够	能 够
不如	不 如
嗖	嗖
州	州
中	中
奔头	奔 头
消	消
发行	发 行
额	额
心机	心 机
度	度
到处	到 处
党	党
公開	公 開
华美	华 美
費	費
思念	思 念
同	同
业	业
涌	涌
确	确
到	到
大多数	大 多 数
指	指
业务	业 务
研	研
什	什
經	經
挣钱	挣 钱
三聖	三 聖
垮	垮
可	可
改善	改 善
平南	平 南
龙岩	龙 岩
軟	軟
队	队
公教	公 教
等	等
天地	天 地
泻	泻
七十九	七 十 九
建立	建 立
抒	抒
亞	亞
扰	扰
椰	椰
早点	早 点
巢	巢
从	从
岃	岃
满足	满 足
看出	看 出
不下	不 下
件	件
桂阳	桂 阳
北	北
幻	幻
仇	仇
西亚	西 亚
元	元
妹	妹
满	满
内	内
乐透	乐 透
120	1 2 0
线上	线 上
唤	唤
一时	一 时
阔	阔
而是	而 是
槽	槽
经合	经 合
人	人
不解	不 解
利	利
止	止
提	提
招商	招 商
并且	并 且
迄今	迄 今
业	业
继承	继 承
敌方	敌 方
海事	海 事
人士	人 士
况	况
办理	办 理
變身	變 身
泰	泰
地下党	地 下 党
廳	廳
万源	万 源
收集	收 集
夜	夜
翅	翅
急事	急 事
多头	多 头
察哈尔	察 哈 尔
可	可
单	单
林地	林 地
約	約
就诊	就 诊
专业	专 业
合	合
况	况
国	国
君	君
疏	疏
八	八
深	深
艺品	艺 品
兒	兒
終身	終 身
趣	趣
贡献	贡 献
牵扯	牵 扯
中	中
诲	诲
出世	出 世
一生	一 生
单选	单 选
方面	方 面
有价	有 价
践行	践 行
蓄	蓄
情不自禁	情 不 自 禁
会	会
厂	厂
9月	9 月
罗德岛	罗 德 岛
甘薯	甘 薯
什么	什 么
庭院	庭 院
对	对
地铁站	地 铁 站
象	象
里外	里 外
一般	一 般
堥	堥
集	集
多病	多 病
問題	問 題
正	正
番薯	番 薯
乔	乔
苏	苏
生活	生 活
心	心
译	译
包销	包 销
泰	泰
流媒体	流 媒 体
结	结
只是	只 是
经济	经 济
必将	必 将
基	基
徼	徼
閱讀	閱 讀
京	京
阿拉	阿 拉
矣	矣
系	系
展示	展 示
保	保
贴	贴
集	集
嘴	嘴
浑源	浑 源
优美	优 美
暗	暗
亿	亿
业	业
虎林	虎 林
份	份
影子	影 子
拼	拼
长岗	长 岗
贊	贊
币	币
业务	业 务
箭	箭
合	合
从而	从 而
曲	曲
下工	下 工
通州	通 州
慈溪	慈 溪
满	满
反思	反 思
姬	姬
上不去	上 不 去
贸	贸
家	家
金碧辉煌	金 碧 辉 煌
路	路
吓一跳	吓 一 跳
試	試
设置	设 置
三十	三 十
分行	分 行
浮雕	浮 雕
突击	突 击
合同	合 同
細	細
提取	提 取
与	与
大赛	大 赛
人	人
潜	潜
文字	文 字
卓越	卓 越
计	计
突出	突 出
碳	碳
精	精
庄	庄
黄金	黄 金
回歸	回 歸
口述	口 述
管理局	管 理 局
为	为
連通	連 通
精	精
死亡	死 亡
围绕	围 绕
姩	姩
如果	如 果
正在	正 在
正在	正 在
升级	升 级
迁	迁
再度	再 度
大大	大 大
广汉	广 汉
介意	介 意
還是	還 是
竹	竹
所在	所 在
自觉	自 觉
人工	人 工
共同	共 同
残疾人	残 疾 人
巢	巢
无	无
滕州	滕 州
統	統
娱	娱
枪击	枪 击
图形	图 形
登	登
随遇而安	随 遇 而 安
暴力	暴 力
内蒙古	内 蒙 古
经常	经 常
偅	偅
姐	姐
为	为
高端	高 端
坑	坑
温	温
腐烂	腐 烂
椎	椎
形象	形 象
计	计
登	登
恨	恨
人口	人 口
虹	虹
鋼	鋼
佞	佞
候选	候 选
会	会
比特	比 特
出战	出 战
镇	镇
过瘾	过 瘾
人手	人 手
武	武
超声	超 声
做为	做 为
认	认
家电	家 电
驻守	驻 守
少年	少 年
男友	男 友
拉	拉
槽	槽
南	南
年	年
务工	务 工
好不	好 不
展	展
迫	迫
帐号	帐 号
我	我
京	京
让	让
高铁	高 铁
黄金	黄 金
可	可
祖国	祖 国
得时	得 时
集	集
智能化	智 能 化
嶃	嶃
填补	填 补
计	计
中	中
豁	豁
责	责
社	社
根源	根 源
物管	物 管
等	等
倒	倒
尼斯	尼 斯
柴	柴
努力	努 力
着重	着 重
嘉兴	嘉 兴
时	时
连日	连 日
碳	碳
教	教
不过	不 过
对症	对 症
快车	快 车
賣場	賣 場
闹	闹
吉首	吉 首
墓	墓
指数	指 数
寞	寞
瀹	瀹
复返	复 返
安分	安 分
平原	平 原
对	对
起居	起 居
年	年
已	已
时钟	时 钟
什	什
买菜	买 菜
徐州	徐 州
此	此
项目	项 目
本	本
晚报	晚 报
芯	芯
國事訪問	國 事 訪 問
月份	月 份
出来	出 来
吃糖	吃 糖
欺	欺
匈牙利	匈 牙 利
店	店
能源	能 源
军	军
杂	杂
国际	国 际
业经	业 经
柔道	柔 道
温	温
革命	革 命
综	综
旗舰店	旗 舰 店
200米	2 0 0 米
不过	不 过
目	目
能	能
天	天
小刀	小 刀
策	策
方式	方 式
四	四
齐鲁	齐 鲁
怎能	怎 能
對於	對 於
走	走
已	已
兽	兽
至尊	至 尊
会	会
系	系
开	开
吃	吃
烦	烦
首	首
间	间
带	带
年间	年 间
围绕	围 绕
腹	腹
驾驶	驾 驶
创	创
件	件
大马士革	大 马 士 革
下降	下 降
评	评
享	享
羽	羽
筑	筑
立法会	立 法 会
腾飞	腾 飞
愕	愕
业	业
脑	脑
遇	遇
安新	安 新
短	短
加以	加 以
好大	好 大
掉	掉
天才	天 才
岢	岢
自首	自 首
住院	住 院
宜春	宜 春
赔率	赔 率
院士	院 士
中	中
计算机	计 算 机
有趣	有 趣
网游	网 游
球队	球 队
教	教
项目	项 目
有年	有 年
人	人
国际	国 际
走	走
宝马	宝 马
十字	十 字
所属	所 属
娌	娌
双刀	双 刀
非凡	非 凡
語文	語 文
构	构
並	並
澳门	澳 门
教师	教 师
澳	澳
会用	会 用
中	中
改版	改 版
板	板
对	对
确	确
推	推
泉水	泉 水
回到	回 到
管理	管 理
系	系
面积	面 积
面料	面 料
讯	讯
弩	弩
便利	便 利
异	异
责任	责 任
利	利
淇	淇
经	经
讀者	讀 者
人	人
悔	悔
式	式
芽	芽
中华民族	中 华 民 族
名手	名 手
引发	引 发
苦苦	苦 苦
历任	历 任
塞	塞
来的	来 的
快捷	快 捷
有效	有 效
球网	球 网
瞄	瞄
教	教
基础教育	基 础 教 育
保	保
与	与
痛苦	痛 苦
评论	评 论
捐赠	捐 赠
所在	所 在
年生	年 生
目	目
整治	整 治
动作	动 作
女宾	女 宾
英雄	英 雄
具有	具 有
于	于
建德	建 德
解读	解 读
卢	卢
所有	所 有
电子产品	电 子 产 品
纽	纽
揭牌	揭 牌
人体	人 体
处子	处 子
领先	领 先
霍	霍
日方	日 方
专业	专 业
再說	再 說
国	国
动漫	动 漫
签证	签 证
集	集
微	微
元	元
谱	谱
为	为
太子	太 子
本	本
結合	結 合
类	类
度	度
全民	全 民
科目	科 目
人民	人 民
阳城	阳 城
划算	划 算
移	移
逊	逊
大派	大 派
陕	陕
么	么
细	细
同	同
年	年
中国化	中 国 化
年间	年 间
水作	水 作
岭	岭
年底	年 底
宁波	宁 波
岭	岭
部长	部 长
着力	着 力
聊天	聊 天
舟	舟
无论	无 论
载	载
供应	供 应
画画	画 画
无	无
培育	培 育
优	优
月份	月 份
瑰	瑰
其中	其 中
策	策
举	举
区画	区 画
外国	外 国
否则	否 则
精	精
屏	屏
說完	說 完
寿县	寿 县
定位	定 位
赵	赵
世界	世 界
到	到
桃园	桃 园
么	么
妈妈	妈 妈
材	材
以为	以 为
对接	对 接
异化	异 化
浦北	浦 北
可可	可 可
些	些
头发	头 发
给予	给 予
什么	什 么
執行	執 行
嘴	嘴
世人	世 人
三	三
画面	画 面
推	推
刻	刻
西亚	西 亚
优质	优 质
状况	状 况
戶	戶
受	受
怎么样	怎 么 样
骄傲	骄 傲
安全	安 全
畫	畫
研讨	研 讨
允	允
犯法	犯 法
视	视
朗县	朗 县
已	已
名利双收	名 利 双 收
諸	諸
遇	遇
就要	就 要
聽課	聽 課
南特	南 特
孤	孤
州	州
不通	不 通
经	经
畸形	畸 形
话说	话 说
潛	潛
中国	中 国
怡	怡
登	登
鮪魚	鮪 魚
前提	前 提
诸位	诸 位
還	還
公	公
与	与
器	器
今	今
里	里
锈	锈
活动	活 动
不幸	不 幸
蜂	蜂
嘉兴	嘉 兴
苏	苏
一行	一 行
个	个
感叹	感 叹
晋	晋
其他	其 他
玉	玉
昆	昆
睁	睁
铺设	铺 设
违纪	违 纪
北新	北 新
四	四
市集	市 集
今	今
公教	公 教
好看	好 看
冯	冯
吉林	吉 林
奇兵	奇 兵
互联网	互 联 网
暧昧	暧 昧
宣	宣
此	此
丝袜	丝 袜
美	美
事务	事 务
设计师	设 计 师
啍	啍
难为	难 为
证明	证 明
击	击
暍	暍
对	对
联系人	联 系 人
博	博
这次	这 次
常	常
麻油	麻 油
生命	生 命
觉悟	觉 悟
受到	受 到
业	业
会	会
成年	成 年
评	评
外形	外 形
广播	广 播
寝	寝
辈子	辈 子
我	我
业经	业 经
度	度
内涵	内 涵
女子	女 子
会	会
艰	艰
走	走
顽	顽
持	持
将	将
郏	郏
佔	佔
驱使	驱 使
星	星
坚	坚
财	财
中一	中 一
处在	处 在
团队	团 队
出来	出 来
不给	不 给
天	天
媲	媲
探	探
镐	镐
对象	对 象
军	军
游泳	游 泳
病因	病 因
地利	地 利
新龙	新 龙
三	三
不翼而飞	不 翼 而 飞
励	励
水果	水 果
台湾	台 湾
锌	锌
规	规
相反	相 反
纪	纪
今	今
德	德
创新	创 新
薪	薪
世界	世 界
登入	登 入
客气	客 气
标准化	标 准 化
应	应
好评	好 评
费米	费 米
时间表	时 间 表
鄙	鄙
今	今
英国	英 国
川大	川 大
外衣	外 衣
度	度
单	单
喔	喔
等	等
教育学	教 育 学
错误	错 误
大洲	大 洲
始	始
导	导
價值	價 值
挑	挑
求	求
加上	加 上
保障	保 障
凰	凰
太太	太 太
损失	损 失
国务	国 务
法学	法 学
替代	替 代
尖叫	尖 叫
昔日	昔 日
冻	冻
效益	效 益
零	零
屿	屿
汽车	汽 车
护航	护 航
银	银
知名度	知 名 度
眸	眸
三角	三 角
罪大恶极	罪 大 恶 极
毫	毫
应该	应 该
衫	衫
炮轟	炮 轟
业	业
濇	濇
不适	不 适
精	精
会	会
正	正
度	度
广	广
苹果手机	苹 果 手 机
策	策
件	件
今	今
表达	表 达
斋	斋
兵	兵
成	成
地位	地 位
聚	聚
平果	平 果
冠军赛	冠 军 赛
悉	悉
攒	攒
举一反三	举 一 反 三
综	综
林区	林 区
花	花
手车	手 车
淡然	淡 然
此	此
家	家
費	費
自	自
计	计
市	市
合	合
峰	峰
君	君
网盘	网 盘
八	八
猜	猜
发布	发 布
驰	驰
特意	特 意
电话号码	电 话 号 码
杆	杆
例如	例 如
多功能	多 功 能
份	份
天然	天 然
市	市
日常	日 常
炮弹	炮 弹
租借	租 借
碎	碎
編	編
重创	重 创
头部	头 部
话	话
消解	消 解
评	评
我	我
師	師
有兴趣	有 兴 趣
有可能	有 可 能
瀵	瀵
信用貸款	信 用 貸 款
新闻	新 闻
備	備
高手	高 手
年	年
免职	免 职
资本	资 本
氣勢	氣 勢
假如	假 如
小康	小 康
材	材
子公司	子 公 司
决	决
最先	最 先
玉米花	玉 米 花
分配	分 配
脉	脉
摄影	摄 影
基础	基 础
家中	家 中
什么	什 么
腿	腿
贺	贺
我	我
办理	办 理
合	合
外汇	外 汇
国务院	国 务 院
什	什
乌兰	乌 兰
此	此
等	等
年	年
何在	何 在
发生	发 生
有價	有 價
点燃	点 燃
塞	塞
面馆	面 馆
仿	仿
将	将
心	心
剑	剑
专项	专 项
风能	风 能
肆虐	肆 虐
秩序	秩 序
船	船
水平	水 平
熺	熺
之中	之 中
着数	着 数
持	持
锤	锤
國務院	國 務 院
支行	支 行
商	商
统计	统 计
万贯	万 贯
秘密	秘 密
部队	部 队
前进	前 进
桃園	桃 園
正	正
诗文	诗 文
决	决
丧	丧
才干	才 干
關	關
于是	于 是
电磁学	电 磁 学
时	时
全称	全 称
無關	無 關
深度	深 度
能	能
登记	登 记
梁子	梁 子
格局	格 局
防控	防 控
每日	每 日
河北	河 北
公诉	公 诉
逐漸	逐 漸
璁	璁
孟	孟
决	决
与此同时	与 此 同 时
度	度
慌	慌
赌博	赌 博
力气	力 气
羊	羊
可爱	可 爱
上半	上 半
理由	理 由
手工	手 工
元日	元 日
渣	渣
自	自
不过	不 过
有多	有 多
二胎	二 胎
股份	股 份
避雷	避 雷
物流	物 流
軍	軍
根子	根 子
慰	慰
时期	时 期
里长	里 长
刑事	刑 事
潜	潜
法	法
过	过
到達	到 達
任意	任 意
笼罩	笼 罩
利	利
京	京
成本	成 本
擊	擊
栏	栏
今晨	今 晨
路	路
有机	有 机
旋转	旋 转
概	概
遭遇	遭 遇
个	个
基	基
奖	奖
如果	如 果
经	经
长寿	长 寿
找回	找 回
始終	始 終
西	西
上海	上 海
利比亚	利 比 亚
开始	开 始
北	北
挽	挽
笥	笥
土默特	土 默 特
驻	驻
纪念	纪 念
旗舰	旗 舰
简	简
独家	独 家
到	到
鶴	鶴
中有	中 有
时	时
组织	组 织
小姐	小 姐
鴨	鴨
配合	配 合
氛围	氛 围
防火	防 火
跌宕	跌 宕
古	古
塔	塔
晃	晃
日前	日 前
入伍	入 伍
播报	播 报
挖掘机	挖 掘 机
业	业
出发	出 发
本原	本 原
醴	醴
还清	还 清
昏	昏
应	应
常委	常 委
宁波	宁 波
警	警
理想	理 想
营销	营 销
队员	队 员
方式	方 式
擦	擦
祭	祭
胭脂	胭 脂
达坂城	达 坂 城
参考	参 考
陪伴	陪 伴
旗	旗
登	登
祖	祖
骤	骤
天使	天 使
峰	峰
纽	纽
应急	应 急
期末	期 末
中国	中 国
天	天
企业	企 业
夫人	夫 人
国际化	国 际 化
中的	中 的
整治	整 治
收购	收 购
家	家
産	産
介	介
书	书
广	广
集	集
话	话
骚扰	骚 扰
編號	編 號
规划	规 划
理工	理 工
自我	自 我
单	单
莹	莹
无法	无 法
喝酒	喝 酒
邓	邓
封建	封 建
人	人
荆	荆
南海	南 海
補	補
翠	翠
春光	春 光
世界	世 界
管理	管 理
房子	房 子
人民	人 民
消	消
探	探
那么	那 么
至少	至 少
山大	山 大
弘图	弘 图
篇章	篇 章
大地	大 地
帅	帅
象	象
进步	进 步
让	让
演奏	演 奏
吗	吗
下降	下 降
浩特	浩 特
专家	专 家
三	三
美国人	美 国 人
对	对
暂缓	暂 缓
青海	青 海
彪	彪
推	推
右手	右 手
使命	使 命
快	快
星	星
我	我
数字	数 字
師	師
問道	問 道
作用	作 用
年年	年 年
孜孜	孜 孜
鼻	鼻
热线	热 线
予	予
资阳	资 阳
过半	过 半
少将	少 将
沉沉	沉 沉
玛多	玛 多
拰	拰
生活	生 活
层次	层 次
警方	警 方
依法	依 法
一旦	一 旦
巴南	巴 南
囤积	囤 积
里	里
卡	卡
成	成
中心	中 心
巷弄	巷 弄
三	三
求学	求 学
不过	不 过
匹	匹
利	利
深	深
见面	见 面
高度	高 度
满足	满 足
讨论	讨 论
迅速	迅 速
米	米
给	给
其实	其 实
耐力	耐 力
时数	时 数
供应	供 应
樣	樣
继承	继 承
社会主义	社 会 主 义
江苏	江 苏
嶉	嶉
弓	弓
火	火
东山	东 山
蝙蝠侠	蝙 蝠 侠
动态	动 态
间	间
模	模
将	将
坟头	坟 头
除非	除 非
生活	生 活
能	能
敢	敢
情緒	情 緒
即便	即 便
哪	哪
艺术	艺 术
轰	轰
免	免
聚	聚
走進	走 進
个	个
鲸	鲸
家具	家 具
邮	邮
远大	远 大
中国	中 国
就	就
疗	疗
话	话
国度	国 度
过	过
湘潭	湘 潭
规	规
兩用	兩 用
敲	敲
打入	打 入
闖關	闖 關
莆田	莆 田
建制	建 制
保	保
唐	唐
中跑	中 跑
供应	供 应
精	精
摄影	摄 影
开发	开 发
来的	来 的
把家	把 家
義縣	義 縣
代言	代 言
先是	先 是
终	终
漯	漯
刊登	刊 登
异	异
晶	晶
仅	仅
图谋	图 谋
成	成
计分	计 分
组	组
油轮	油 轮
吉	吉
进步	进 步
栨	栨
修建	修 建
該	該
杭州	杭 州
涿州	涿 州
地域	地 域
一时	一 时
源地	源 地
连锁	连 锁
经	经
一时间	一 时 间
高深	高 深
手续费	手 续 费
扎	扎
宙	宙
提	提
校	校
一家	一 家
一流	一 流
包头	包 头
成为	成 为
标的	标 的
颁	颁
载	载
经	经
集水	集 水
莱芜	莱 芜
规划区	规 划 区
生机	生 机
就	就
歡呼	歡 呼
领	领
个	个
篇幅	篇 幅
园	园
将	将
校对	校 对
新颖	新 颖
靠	靠
路	路
他人	他 人
通道	通 道
下来	下 来
擬	擬
努	努
承诺	承 诺
垃圾	垃 圾
不无	不 无
理学	理 学
目	目
超	超
首次	首 次
爹	爹
成熟	成 熟
好生	好 生
空军	空 军
长沙	长 沙
国华	国 华
中签	中 签
彩虹	彩 虹
火锅	火 锅
成为	成 为
作者	作 者
节	节
提	提
中国	中 国
恢	恢
延续	延 续
式	式
主办	主 办
我	我
试	试
龄	龄
法国	法 国
登	登
错误	错 误
迫	迫
商用	商 用
一站式	一 站 式
租	租
高校	高 校
忠	忠
目标	目 标
加大	加 大
什么	什 么
无力	无 力
预防	预 防
总部	总 部
电视台	电 视 台
战机	战 机
对	对
交通	交 通
年	年
私	私
里	里
全身	全 身
租车	租 车
无	无
商鋪	商 鋪
度	度
出门	出 门
集	集
德	德
让	让
于	于
什么时候	什 么 时 候
社	社
不仅	不 仅
事务	事 务
中	中
节	节
取得	取 得
新一	新 一
扬	扬
不明	不 明
丰	丰
涵	涵
小一	小 一
店	店
战场	战 场
淡	淡
吸烟者	吸 烟 者
与	与
让	让
队伍	队 伍
自误	自 误
子女	子 女
易爆	易 爆
福利	福 利
力	力
样子	样 子
公	公
享	享
年	年
心情	心 情
利润	利 润
展	展
晒	晒
因	因
疣	疣
枪	枪
3月	3 月
份	份
街头	街 头
解开	解 开
变动	变 动
度	度
病毒	病 毒
象	象
如今	如 今
默默	默 默
年	年
植	植
极端	极 端
责任	责 任
泰	泰
财	财
闵	闵
借	借
敢	敢
博野	博 野
里	里
注	注
创建	创 建
嘴	嘴
集	集
出入	出 入
中国特色	中 国 特 色
免费软件	免 费 软 件
搏	搏
指定	指 定
处理	处 理
心中	心 中
冬天	冬 天
一面	一 面
领域	领 域
就	就
材	材
树立	树 立
浦北	浦 北
顾问	顾 问
有所	有 所
嘲	嘲
吉	吉
消极	消 极
导	导
业务	业 务
店	店
桓	桓
培训	培 训
业	业
怎地	怎 地
目	目
记	记
纲	纲
場	場
埕	埕
诉	诉
什么	什 么
达达	达 达
曲靖	曲 靖
投注	投 注
午饭	午 饭
动作	动 作
歇	歇
造型	造 型
烹饪	烹 饪
不动	不 动
资料	资 料
指导	指 导
到	到
东南	东 南
舊	舊
雜貨	雜 貨
队伍	队 伍
盲	盲
惨	惨
客房	客 房
創造力	創 造 力
辆	辆
会	会
海洋	海 洋
捕	捕
乃至	乃 至
國人	國 人
赤縣神州	赤 縣 神 州
端的	端 的
有害	有 害
招商	招 商
样子	样 子
日系	日 系
要求	要 求
于	于
四	四
閭	閭
崇州	崇 州
分解	分 解
下来	下 来
市	市
挂	挂
八	八
专业	专 业
元	元
不久	不 久
忘忧草	忘 忧 草
稳	稳
多少钱	多 少 钱
开启	开 启
绝	绝
人	人
提醒	提 醒
陌	陌
其他	其 他
合	合
后人	后 人
德	德
欧阳	欧 阳
势	势
信息流	信 息 流
开	开
票	票
到	到
度	度
普	普
金发	金 发
构	构
研究所	研 究 所
说话	说 话
弗	弗
集	集
暖	暖
推进	推 进
南部	南 部
乞怜	乞 怜
行政	行 政
錄	錄
极大	极 大
吹	吹
不遗	不 遗
很少	很 少
噶	噶
拼音	拼 音
阜	阜
下来	下 来
走出去	走 出 去
合	合
扶风	扶 风
為主	為 主
离奇	离 奇
菲律宾	菲 律 宾
當頭	當 頭
机制	机 制
那么	那 么
能	能
忘懷	忘 懷
加深	加 深
办	办
建立	建 立
皮影	皮 影
细腻	细 腻
應該	應 該
元	元
疲乏	疲 乏
透风	透 风
经	经
快车	快 车
追捕	追 捕
几	几
中国	中 国
据悉	据 悉
岩	岩
传国玉玺	传 国 玉 玺
赵	赵
渑	渑
产品	产 品
售卖	售 卖
关联	关 联
孟	孟
集	集
了本	了 本
戒毒	戒 毒
哪	哪
号角	号 角
寻找	寻 找
灏	灏
糖	糖
活动	活 动
口才	口 才
成长	成 长
平台	平 台
敢	敢
发起	发 起
后勤	后 勤
清理	清 理
注	注
裕	裕
博	博
西	西
交	交
小型	小 型
一系	一 系
到	到
什么	什 么
括	括
星	星
軟	軟
瞬	瞬
桐柏	桐 柏
武	武
人力	人 力
淘	淘
瞭	瞭
意气用事	意 气 用 事
多方	多 方
忆	忆
评	评
旅顺口	旅 顺 口
内	内
叱	叱
灣	灣
賀歲	賀 歲
骑士	骑 士
介	介
漆	漆
新增	新 增
目标	目 标
查收	查 收
纵身	纵 身
天然	天 然
追求	追 求
避雷	避 雷
类	类
相应	相 应
申办	申 办
垫	垫
哈德森	哈 德 森
长	长
與	與
妹	妹
吪	吪
提交	提 交
歹	歹
辅导员	辅 导 员
天	天
站点	站 点
隱私	隱 私
讲堂	讲 堂
保	保
今	今
形象	形 象
商业	商 业
管理	管 理
贽	贽
培训	培 训
智能	智 能
食	食
辛集	辛 集
陶	陶
蜜	蜜
致以	致 以
娜	娜
疆	疆
首相	首 相
商	商
哪	哪
西	西
日期	日 期
隆昌	隆 昌
外向	外 向
剧	剧
厂	厂
从	从
绝	绝
今	今
企业	企 业
不忘	不 忘
椿	椿
公	公
整个	整 个
陆续	陆 续
差点	差 点
涞	涞
诠	诠
之前	之 前
愛	愛
筹	筹
举	举
什	什
全国人民代表大会	全 国 人 民 代 表 大 会
晃	晃
三英	三 英
中式	中 式
无锡	无 锡
旱	旱
黑山	黑 山
保	保
住	住
浏览量	浏 览 量
已	已
图书	图 书
博	博
在建	在 建
合格	合 格
殑	殑
中国	中 国
精	精
二流	二 流
补给	补 给
竟	竟
简单	简 单
懿	懿
专机	专 机
据	据
出國	出 國
香港	香 港
不止	不 止
意向	意 向
彻	彻
南	南
应	应
剧	剧
贺	贺
电视节目	电 视 节 目
举	举
评	评
名	名
队	队
晚饭	晚 饭
拆	拆
注意到	注 意 到
建置	建 置
耐	耐
兵	兵
耳机	耳 机
博	博
可可	可 可
单	单
公	公
娱	娱
岭	岭
介	介
首先	首 先
政令	政 令
浦	浦
安陆	安 陆
检讨	检 讨
名	名
作用	作 用
手车	手 车
天时	天 时
唯	唯
粮	粮
芦	芦
大雪	大 雪
提前	提 前
分割	分 割
丰	丰
紹	紹
可	可
已	已
可	可
撥	撥
靠	靠
纯净	纯 净
岭南	岭 南
掾	掾
液体	液 体
排名	排 名
碼	碼
乙	乙
新闻	新 闻
条	条
会	会
父	父
音乐	音 乐
标的	标 的
汽车	汽 车
均	均
举足轻重	举 足 轻 重
语	语
愈发	愈 发
五星	五 星
银	银
庄	庄
不觉	不 觉
发起	发 起
被动	被 动
维稳	维 稳
这样	这 样
就学	就 学
清	清
订	订
公	公
照料	照 料
多元	多 元
已	已
担忧	担 忧
芷江	芷 江
等	等
方面	方 面
快板	快 板
迄	迄
敗	敗
钦佩	钦 佩
正	正
社交	社 交
又称	又 称
教	教
本	本
什锦	什 锦
时	时
时段	时 段
汝州	汝 州
植物	植 物
千里	千 里
少	少
不对	不 对
吆	吆
浦	浦
纽	纽
会	会
古	古
实地	实 地
给	给
三	三
經文	經 文
自驾	自 驾
留	留
藥	藥
骑	骑
就	就
概念	概 念
持	持
三	三
用品	用 品
否认	否 认
运作	运 作
青团	青 团
國度	國 度
还	还
三	三
地支	地 支
不起	不 起
博	博
青睐	青 睐
一家	一 家
不懂	不 懂
楼	楼
店	店
将	将
中	中
快	快
怪	怪
查重	查 重
湴	湴
为	为
颜	颜
娴	娴
知縣	知 縣
雄	雄
设备	设 备
长	长
于	于
市	市
伊春	伊 春
队	队
三	三
唬	唬
外国	外 国
周年	周 年
型	型
推	推
比分	比 分
名优	名 优
讼	讼
中	中
公设	公 设
不过	不 过
欧	欧
斥	斥
查詢	查 詢
草案	草 案
快捷	快 捷
对	对
結	結
从而	从 而
其他	其 他
几点	几 点
无	无
低	低
早	早
优	优
与	与
骗人	骗 人
楝	楝
只是	只 是
博	博
家	家
常	常
比分	比 分
公	公
本	本
灂	灂
展	展
四大	四 大
梳	梳
参军	参 军
聚	聚
领军	领 军
助学金	助 学 金
心	心
教師	教 師
要是	要 是
职工	职 工
風扇	風 扇
获悉	获 悉
章鱼	章 鱼
绽放	绽 放
卡	卡
石炭	石 炭
120	1 2 0
业	业
办	办
小的	小 的
广	广
举	举
武	武
屈	屈
海陆	海 陆
家門	家 門
广	广
注重	注 重
助力	助 力
放弃	放 弃
快	快
遮	遮
时候	时 候
扶贫	扶 贫
建鼓	建 鼓
便	便
暨	暨
利	利
要么	要 么
里	里
打工	打 工
于	于
注	注
树	树
查找	查 找
全本	全 本
复国	复 国
合约	合 约
与	与
峰	峰
本	本
商	商
炼	炼
果肉	果 肉
湖	湖
此	此
埠	埠
了解	了 解
浩瀚	浩 瀚
库伦	库 伦
逐	逐
商	商
力	力
违反	违 反
家人	家 人
什么	什 么
中介	中 介
曾	曾
求职	求 职
贵阳	贵 阳
提速	提 速
情報	情 報
鎬	鎬
心	心
订房	订 房
语	语
小组	小 组
辈	辈
代辦	代 辦
频发	频 发
家俱	家 俱
进食	进 食
份	份
利是	利 是
经典	经 典
季	季
森林	森 林
生活	生 活
兆	兆
书	书
分类	分 类
疾病	疾 病
建筑物	建 筑 物
广	广
栗	栗
赞助	赞 助
和諧	和 諧
名山	名 山
憶	憶
豪杰	豪 杰
公	公
内蒙	内 蒙
可	可
里	里
预计	预 计
造价	造 价
笺	笺
本	本
怀远	怀 远
本是	本 是
掌	掌
东阳	东 阳
人民	人 民
人	人
蒋	蒋
利	利
升官	升 官
很少	很 少
国	国
丰宁	丰 宁
加工厂	加 工 厂
南瓜	南 瓜
泰	泰
还	还
为了	为 了
大米	大 米
波	波
来人	来 人
缠身	缠 身
澳	澳
辐	辐
中	中
集	集
银	银
东安	东 安
查核	查 核
板	板
交通	交 通
萍	萍
其实	其 实
时	时
南	南
繁殖	繁 殖
定位	定 位
吾	吾
答	答
开奖	开 奖
微	微
太仆寺	太 仆 寺
適	適
首页	首 页
各種	各 種
有机玻璃	有 机 玻 璃
宗	宗
豢	豢
规	规
香港	香 港
連	連
式	式
暢銷	暢 銷
推进	推 进
事業	事 業
观	观
年	年
棋谱	棋 谱
範	範
莎	莎
面馆	面 馆
热情	热 情
丘	丘
长老	长 老
揮	揮
公开	公 开
淡	淡
派	派
原则	原 则
吹	吹
国	国
良多	良 多
短	短
骷	骷
复刻	复 刻
举	举
于	于
主管	主 管
目	目
会	会
东北	东 北
教	教
记	记
家	家
刮	刮
本	本
好說	好 說
投注	投 注
型	型
训	训
狻	狻
战略	战 略
为例	为 例
朋友	朋 友
专门	专 门
氛圍	氛 圍
普	普
出入	出 入
军舰	军 舰
实业	实 业
住	住
众	众
培训	培 训
面對	面 對
么	么
牵引	牵 引
稀	稀
内	内
供应商	供 应 商
域	域
臺	臺
新华社	新 华 社
祥	祥
人民共和国	人 民 共 和 国
日前	日 前
萍	萍
乱流	乱 流
公	公
能够	能 够
同	同
苏	苏
丰	丰
毁灭	毁 灭
起薪	起 薪
沉睡	沉 睡
公	公
發兵	發 兵
库	库
八公山	八 公 山
集	集
特地	特 地
古	古
所有物	所 有 物
玩家	玩 家
发布	发 布
土默特左	土 默 特 左
末	末
首	首
变	变
括	括
播讲	播 讲
親中	親 中
自贡	自 贡
等	等
懸	懸
合	合
高中生	高 中 生
会员	会 员
街机	街 机
立	立
乐观	乐 观
确	确
无时无刻	无 时 无 刻
放心	放 心
值班室	值 班 室
詹	詹
博	博
拉	拉
可以得	可 以 得
火灾	火 灾
精	精
于	于
红	红
认识	认 识
将军	将 军
自信心	自 信 心
丹凤	丹 凤
傳感器	傳 感 器
住房贷款	住 房 贷 款
备案	备 案
经	经
三水	三 水
猇	猇
交	交
还	还
今	今
州	州
锛	锛
三门	三 门
察雅	察 雅
此时	此 时
相比	相 比
食	食
厦	厦
娃	娃
年	年
齐鲁	齐 鲁
響	響
脑	脑
看看	看 看
参	参
家国	家 国
北	北
财	财
竟是	竟 是
同步	同 步
为	为
作计	作 计
请	请
开	开
会	会
皮	皮
不宜	不 宜
構築	構 築
穿过	穿 过
计算	计 算
清	清
嫣	嫣
倍加	倍 加
工作	工 作
的话	的 话
力	力
元	元
净	净
女同	女 同
欧	欧
绘	绘
襄	襄
万里	万 里
毫无疑问	毫 无 疑 问
茅塞顿开	茅 塞 顿 开
亿	亿
重度	重 度
能	能
拉丁	拉 丁
敢	敢
趣味	趣 味
充满	充 满
吗	吗
动手	动 手
商人	商 人
杂	杂
农田	农 田
声音	声 音
對仗	對 仗
姣	姣
腐	腐
县市	县 市
中	中
一周	一 周
家人	家 人
继	继
北	北
缙	缙
較	較
晚间	晚 间
滴	滴
全南	全 南
隐	隐
看出	看 出
這樣	這 樣
自动化	自 动 化
刚	刚
力	力
脚	脚
为	为
这	这
召集	召 集
櫻	櫻
结	结
介	介
象	象
四	四
岑溪	岑 溪
收到	收 到
目	目
咀嚼肌	咀 嚼 肌
教师	教 师
订	订
互	互
时	时
辰	辰
行礼	行 礼
剧	剧
龙王	龙 王
大学生	大 学 生
冰雪	冰 雪
事物	事 物
至于	至 于
裘	裘
如斯	如 斯
优质	优 质
斜	斜
式	式
注	注
中华	中 华
此	此
竖	竖
經	經
小组	小 组
遂	遂
俪	俪
跨界	跨 界
上台	上 台
对照	对 照
策	策
毫	毫
驗	驗
乎	乎
对	对
特朗普	特 朗 普
结	结
中醫	中 醫
风格	风 格
密码	密 码
翅	翅
预防	预 防
寡	寡
轰动	轰 动
正在	正 在
无数	无 数
还	还
过	过
際	際
只是	只 是
不住	不 住
澳	澳
楼	楼
汇聚	汇 聚
丰润	丰 润
公	公
能	能
米高	米 高
从	从
国学	国 学
认	认
號碼	號 碼
云集	云 集
推进	推 进
激励	激 励
为	为
带有	带 有
籯	籯
订	订
集	集
享有	享 有
中线	中 线
气度	气 度
天	天
会	会
申请	申 请
同	同
马克思	马 克 思
路网	路 网
中的	中 的
享	享
亿	亿
况	况
少數	少 數
丛	丛
毛衣	毛 衣
毁	毁
崇高	崇 高
術	術
理清	理 清
立	立
膏	膏
兴义	兴 义
享	享
挺	挺
地缘政治	地 缘 政 治
变化莫测	变 化 莫 测
由於	由 於
並不	並 不
能	能
場	場
爰	爰
参	参
證	證
店	店
出战	出 战
保康	保 康
徒刑	徒 刑
记	记
甚	甚
技术人员	技 术 人 员
间	间
等	等
这	这
狠	狠
公	公
票	票
擷	擷
机制	机 制
小学校	小 学 校
名	名
白河	白 河
超	超
齿轮	齿 轮
演	演
本	本
品质	品 质
英勇	英 勇
见习	见 习
直辖市	直 辖 市
咱	咱
报社	报 社
式	式
世界	世 界
不对	不 对
小将	小 将
规范	规 范
上映	上 映
指导	指 导
殡仪	殡 仪
斗地主	斗 地 主
深	深
全身	全 身
有的	有 的
玉	玉
轉	轉
董事	董 事
冷水	冷 水
内	内
孩	孩
服务器	服 务 器
宇航	宇 航
身边	身 边
花	花
遠眺	遠 眺
水域	水 域
男子	男 子
节	节
作出	作 出
国家安全	国 家 安 全
白宫	白 宫
中	中
留	留
苏联	苏 联
抵制	抵 制
检察	检 察
合辦	合 辦
书	书
心	心
身世	身 世
靠	靠
手拿	手 拿
冰船	冰 船
道歉	道 歉
讯	讯
委员会	委 员 会
械	械
手續費	手 續 費
增持	增 持
之下	之 下
载	载
州	州
不出	不 出
湖	湖
昏睡	昏 睡
勉强	勉 强
通知	通 知
谐	谐
什	什
不以为意	不 以 为 意
重磅	重 磅
贾	贾
工作	工 作
推	推
到	到
举	举
尺	尺
嚴	嚴
大大	大 大
决算	决 算
东	东
长	长
新闻	新 闻
毁	毁
命运	命 运
家生	家 生
美女	美 女
陪玩	陪 玩
可加	可 加
嶠	嶠
求	求
寓	寓
心得	心 得
似	似
给	给
建議	建 議
之中	之 中
时	时
陀	陀
责	责
哎	哎
村上	村 上
震	震
于	于
澳门	澳 门
打開	打 開
早	早
现象	现 象
加成	加 成
力	力
陆	陆
昭	昭
应	应
放学	放 学
袖	袖
谑	谑
隐士	隐 士
气质	气 质
人	人
北	北
结	结
沁	沁
如何	如 何
米通	米 通
高考	高 考
殴	殴
粘度	粘 度
志愿	志 愿
公交车	公 交 车
粒	粒
乏	乏
神圣	神 圣
敦	敦
争分夺秒	争 分 夺 秒
精	精
赵	赵
开	开
开	开
一期	一 期
份	份
疗	疗
微	微
湖南	湖 南
季	季
房租	房 租
消费者	消 费 者
橫	橫
深度	深 度
仿	仿
暨	暨
私通	私 通
隆盛	隆 盛
嵊	嵊
式	式
內涵	內 涵
一本	一 本
唐	唐
魚池	魚 池
酒泉	酒 泉
牲	牲
年	年
苔	苔
帽子	帽 子
商	商
人精	人 精
牧場	牧 場
中	中
终	终
共和国	共 和 国
带	带
持	持
巡禮	巡 禮
德	德
偶然	偶 然
协议	协 议
濒	濒
幅度	幅 度
几十	几 十
懂	懂
無比	無 比
应	应
扔	扔
学位	学 位
学历	学 历
有田	有 田
理事	理 事
队伍	队 伍
一天	一 天
消	消
多少钱	多 少 钱
名	名
话说	话 说
教科书	教 科 书
师传	师 传
坚	坚
中	中
导	导
颁	颁
掌握	掌 握
瑞	瑞
怎么样	怎 么 样
就	就
恙	恙
成	成
輕	輕
人民币	人 民 币
卡	卡
模	模
不动	不 动
卻是	卻 是
愤	愤
为期	为 期
保安	保 安
悔	悔
服务器	服 务 器
借貸	借 貸
散开	散 开
应	应
閣	閣
优先	优 先
迫使	迫 使
年轻	年 轻
脚	脚
红	红
要好	要 好
石油	石 油
输	输
立	立
学长	学 长
多发	多 发
喝水	喝 水
同感	同 感
成	成
100米	1 0 0 米
聂	聂
陸	陸
筹	筹
封地	封 地
苏	苏
定義	定 義
合	合
際	際
去年	去 年
江河	江 河
展示	展 示
美	美
请	请
名	名
做客	做 客
条	条
建阳	建 阳
国有	国 有
朗诵	朗 诵
财	财
内	内
畨	畨
澧	澧
园区	园 区
浠水	浠 水
围绕	围 绕
年	年
作者	作 者
邮	邮
能	能
曲	曲
一席之地	一 席 之 地
口腔	口 腔
止	止
一万	一 万
连接	连 接
深	深
展示	展 示
咸宁	咸 宁
甚	甚
于	于
房子	房 子
细腻	细 腻
傻	傻
后人	后 人
坚	坚
法则	法 则
狩	狩
參	參
教	教
達	達
旗	旗
业	业
国公	国 公
长	长
拓	拓
民法	民 法
迷	迷
证	证
黄人	黄 人
12月	1 2 月
吉	吉
经济	经 济
国际机场	国 际 机 场
杰克逊	杰 克 逊
能手	能 手
引导	引 导
自	自
掀	掀
虚拟	虚 拟
變	變
普	普
间	间
生機	生 機
人	人
与	与
數量	數 量
新一	新 一
展	展
度	度
县	县
华人	华 人
单	单
搞笑	搞 笑
电动车	电 动 车
长	长
可可	可 可
高清	高 清
突泉	突 泉
新区	新 区
沉着	沉 着
缔	缔
新兴	新 兴
对	对
峻	峻
斋	斋
对准	对 准
请	请
国	国
胡天	胡 天
放下	放 下
本	本
动画	动 画
推	推
愿意	愿 意
军	军
民革	民 革
福利	福 利
石墙	石 墙
怎么办	怎 么 办
以外	以 外
隶属	隶 属
年轻	年 轻
能量	能 量
半径	半 径
港台	港 台
创	创
上杭	上 杭
繼續	繼 續
流通	流 通
无力	无 力
贡献	贡 献
备有	备 有
禁止	禁 止
工人	工 人
泥	泥
雾气	雾 气
达成	达 成
原则	原 则
争夺	争 夺
兵	兵
使用	使 用
干	干
孔子	孔 子
服务器	服 务 器
视	视
州	州
對於	對 於
昨日	昨 日
夜不闭户	夜 不 闭 户
犬	犬
不中	不 中
应对	应 对
三	三
合	合
新闻	新 闻
聯	聯
就	就
持	持
坤	坤
依旧	依 旧
臣	臣
美媒	美 媒
質	質
就	就
什	什
江东	江 东
登记	登 记
識	識
微博	微 博
演	演
演员	演 员
俊	俊
轉	轉
阜南	阜 南
业	业
球队	球 队
妮	妮
迅	迅
指	指
黄	黄
驗	驗
日系	日 系
铂	铂
江苏	江 苏
中心	中 心
评	评
个	个
招商	招 商
托克逊	托 克 逊
什	什
蛇	蛇
目	目
直属	直 属
稳	稳
内部	内 部
棰	棰
地球	地 球
自	自
相对	相 对
逻	逻
物业	物 业
吾	吾
五月	五 月
動	動
晋	晋
自	自
花	花
舟	舟
家	家
強	強
种苗	种 苗
晋中	晋 中
始	始
提	提
工委	工 委
大渡	大 渡
阵	阵
噎	噎
态度	态 度
就座	就 座
備	備
于	于
倍	倍
堪称	堪 称
组	组
临澧	临 澧
蜂	蜂
给	给
西天	西 天
创造	创 造
喜	喜
中国	中 国
提问	提 问
忆	忆
内	内
企	企
年	年
花	花
朋友圈	朋 友 圈
秦皇岛	秦 皇 岛
雙魚	雙 魚
会	会
卡	卡
電子	電 子
耗	耗
奴才	奴 才
利	利
領導	領 導
笃	笃
体制	体 制
校园	校 园
園	園
冷酷	冷 酷
鹿	鹿
身边	身 边
軟體	軟 體
作者	作 者
与	与
走	走
地球	地 球
苹果	苹 果
大量	大 量
放心	放 心
锈	锈
红	红
已	已
军	军
轩	轩
创	创
大货车	大 货 车
折	折
赵	赵
什	什
保	保
京	京
丰厚	丰 厚
件	件
教学	教 学
双	双
仇	仇
住	住
挥军	挥 军
记	记
啤	啤
精	精
红	红
运用	运 用
没落	没 落
刻	刻
弊	弊
环	环
季	季
人力资源	人 力 资 源
店小二	店 小 二
组	组
业	业
生活	生 活
登记	登 记
离开	离 开
掉	掉
巩	巩
平台	平 台
有限公司	有 限 公 司
斐然	斐 然
陽	陽
投注	投 注
甚至	甚 至
专一	专 一
奋	奋
养老金	养 老 金
时	时
干	干
深化	深 化
到场	到 场
心	心
步	步
将	将
已	已
上大	上 大
中餐	中 餐
环	环
消灭	消 灭
法	法
罂	罂
方向	方 向
附加值	附 加 值
硕士	硕 士
鞋	鞋
些	些
填	填
一部分	一 部 分
渠	渠
掠	掠
督	督
业经	业 经
人大	人 大
王牌	王 牌
融	融
留下	留 下
主城	主 城
书店	书 店
盯	盯
豆	豆
南北	南 北
修复	修 复
共有	共 有
等	等
此	此
提速	提 速
功夫	功 夫
打击	打 击
玲	玲
菊花	菊 花
普京	普 京
书法	书 法
一举一动	一 举 一 动
落客	落 客
的话	的 话
邮	邮
商	商
墓	墓
府中	府 中
状况	状 况
受	受
人体	人 体
命运	命 运
演练	演 练
证	证
假如	假 如
搷	搷
肿瘤	肿 瘤
员工	员 工
应	应
瘫	瘫
下面	下 面
股指	股 指
有鬼	有 鬼
加上	加 上
有功	有 功
不行	不 行
动荡	动 荡
鸟	鸟
苹果手机	苹 果 手 机
抽	抽
哪	哪
达沃斯	达 沃 斯
清	清
个	个
收藏	收 藏
公	公
三水	三 水
苏	苏
破损	破 损
怒怼	怒 怼
出演	出 演
肚子	肚 子
京	京
描	描
间	间
证	证
关东	关 东
往往	往 往
國內	國 內
粹	粹
企	企
这	这
开复	开 复
路	路
而且	而 且
特別	特 別
业	业
经济	经 济
邓	邓
其实	其 实
晴	晴
班级	班 级
容城	容 城
回购	回 购
遗落	遗 落
涉疆	涉 疆
会	会
拉	拉
决一死战	决 一 死 战
截止	截 止
倒	倒
执着	执 着
厦	厦
霍	霍
缱绻	缱 绻
汕	汕
首	首
绝	绝
让	让
娱	娱
電視	電 視
家	家
众	众
通知	通 知
同	同
滞	滞
票	票
京京	京 京
自称	自 称
西盟	西 盟
歡迎	歡 迎
年內	年 內
优	优
大数	大 数
板	板
得了	得 了
薪传	薪 传
受众	受 众
愛	愛
一天	一 天
清真	清 真
创客	创 客
能	能
荆楚	荆 楚
宣化	宣 化
完好	完 好
割裂	割 裂
成	成
确认	确 认
里	里
日前	日 前
海口	海 口
單位	單 位
已	已
目光	目 光
总裁	总 裁
单	单
份	份
党派	党 派
否	否
新闻	新 闻
暴怒	暴 怒
流行	流 行
力	力
報酬率	報 酬 率
周围	周 围
呆	呆
美	美
市	市
本部	本 部
项目	项 目
司马	司 马
飘	飘
实意	实 意
家族	家 族
并且	并 且
滆	滆
简体	简 体
华美	华 美
西铁	西 铁
並且	並 且
项目	项 目
剧	剧
产品	产 品
宝山	宝 山
接管	接 管
认为	认 为
中原	中 原
靠	靠
供氧	供 氧
多种	多 种
徜	徜
是誰	是 誰
时	时
厚	厚
件	件
运城	运 城
成效	成 效
首页	首 页
飯	飯
良	良
交	交
柜	柜
腦	腦
璃	璃
介	介
阳光	阳 光
吃	吃
岔	岔
试	试
潜艇	潜 艇
添加	添 加
里	里
尉	尉
邦	邦
宸	宸
大成	大 成
温	温
屾	屾
些	些
溯	溯
臉	臉
记忆	记 忆
等	等
血液	血 液
计	计
集	集
视	视
刺激	刺 激
邮箱	邮 箱
过	过
以来	以 来
白河	白 河
自由	自 由
哪下	哪 下
扑	扑
骗人	骗 人
这	这
朋友	朋 友
密码	密 码
平邑	平 邑
俸	俸
美	美
河北	河 北
组	组
彻	彻
时	时
旗舰	旗 舰
善后	善 后
协议	协 议
满足	满 足
标枪	标 枪
照片	照 片
国土安全	国 土 安 全
激动	激 动
拥护	拥 护
此	此
自	自
厚	厚
襄	襄
筒	筒
就	就
枝	枝
本	本
霸道	霸 道
能够	能 够
这	这
蹦	蹦
不愁	不 愁
復	復
图解	图 解
丰	丰
雄	雄
江津	江 津
虹	虹
看看	看 看
博	博
拥有	拥 有
公斤	公 斤
不同凡响	不 同 凡 响
房价	房 价
连胜	连 胜
连衣	连 衣
牌	牌
确	确
快马加鞭	快 马 加 鞭
心	心
萧山	萧 山
前往	前 往
免责	免 责
天	天
正在	正 在
传承	传 承
行业	行 业
尴	尴
同时	同 时
批驳	批 驳
乎	乎
工程师	工 程 师
部队	部 队
隆	隆
入手	入 手
丘	丘
极速	极 速
邮箱	邮 箱
尽管	尽 管
州	州
京	京
福州	福 州
办公厅	办 公 厅
基	基
柴	柴
包装	包 装
邵	邵
奎	奎
上海	上 海
田阳	田 阳
伸	伸
姐	姐
么	么
莒	莒
泰國	泰 國
正是	正 是
結束	結 束
等	等
同志	同 志
思维	思 维
评	评
好用	好 用
新年	新 年
心	心
成	成
留学	留 学
汾阳	汾 阳
就	就
我	我
祖	祖
各级	各 级
兑现	兑 现
育人	育 人
结	结
州	州
自	自
个	个
烤肉	烤 肉
元	元
人	人
式	式
药	药
家祠	家 祠
紧	紧
求	求
指	指
提篮	提 篮
出兵	出 兵
专门	专 门
住	住
上级	上 级
家	家
环	环
品质	品 质
企	企
勘察	勘 察
队员	队 员
国	国
其他	其 他
介	介
可	可
说出	说 出
国内外	国 内 外
家里	家 里
本	本
了解	了 解
声望	声 望
邮箱	邮 箱
固	固
研究	研 究
结	结
安全	安 全
高清	高 清
哪個	哪 個
左	左
管理	管 理
巩	巩
牛仔裤	牛 仔 裤
导	导
推	推
逾期	逾 期
存款	存 款
平民	平 民
附属	附 属
公	公
彝族	彝 族
几	几
手续	手 续
力	力
近来	近 来
涟源	涟 源
當然	當 然
事务所	事 务 所
括	括
同	同
域	域
跃马	跃 马
奥	奥
星期二	星 期 二
公	公
间	间
作人	作 人
人家	人 家
经济	经 济
力	力
新人	新 人
推	推
型	型
比分	比 分
大伙	大 伙
不愿	不 愿
北線	北 線
湖北	湖 北
IP地址	I P 地 址
度	度
海拔	海 拔
似	似
業務	業 務
留言	留 言
客车	客 车
机制	机 制
火	火
隕	隕
展	展
電腦	電 腦
总书记	总 书 记
让	让
式	式
驾车	驾 车
躲开	躲 开
曾	曾
牵	牵
合	合
东川	东 川
经	经
芒果	芒 果
器具	器 具
规	规
一級	一 級
容纳	容 纳
讯	讯
变	变
拢	拢
楼	楼
械	械
份量	份 量
曹县	曹 县
浦	浦
夜	夜
踪	踪
搭建	搭 建
圆	圆
有声	有 声
余	余
开	开
时节	时 节
通电	通 电
大限	大 限
曲目	曲 目
镇巴	镇 巴
胭脂	胭 脂
首	首
茨	茨
他們	他 們
詢	詢
提	提
擇	擇
意向	意 向
博	博
闹心	闹 心
开始	开 始
可	可
据	据
外人	外 人
家乡话	家 乡 话
排行榜	排 行 榜
揭秘	揭 秘
路	路
中东	中 东
女子	女 子
宁夏	宁 夏
隔	隔
国	国
心	心
发布	发 布
洛隆	洛 隆
届	届
极品	极 品
同一个	同 一 个
方式	方 式
黑色	黑 色
看点	看 点
留	留
聚	聚
法学	法 学
陛	陛
彝	彝
印度	印 度
成为	成 为
提	提
印象	印 象
上大	上 大
養	養
篮球	篮 球
作协	作 协
不时	不 时
存款	存 款
就要	就 要
对打	对 打
綜合節目	綜 合 節 目
债	债
名	名
编导	编 导
什	什
世家	世 家
罕	罕
下来	下 来
融合	融 合
名稱	名 稱
广东	广 东
宜秀	宜 秀
購	購
票	票
肺炎	肺 炎
遂	遂
威县	威 县
派	派
安装	安 装
亲人	亲 人
適	適
国会	国 会
叮	叮
洗澡	洗 澡
布达	布 达
农林	农 林
中肯	中 肯
日前	日 前
刀削面	刀 削 面
架	架
内	内
外星	外 星
联手	联 手
体式	体 式
进入	进 入
一天	一 天
利	利
鞍	鞍
爬山	爬 山
接管	接 管
驻	驻
国	国
贫民区	贫 民 区
珊	珊
持	持
沸騰	沸 騰
参	参
濮	濮
地图	地 图
許	許
鲜	鲜
浇	浇
社会科学院	社 会 科 学 院
此	此
新闻	新 闻
狂风	狂 风
路	路
处于	处 于
为	为
古	古
高清	高 清
党	党
疫苗	疫 苗
基督	基 督
西兰	西 兰
吸睛	吸 睛
庆安	庆 安
元	元
年	年
大中	大 中
示威者	示 威 者
业	业
年	年
举	举
所在	所 在
就	就
鸣	鸣
推	推
首	首
件	件
欲	欲
度	度
認可	認 可
卡	卡
遇	遇
卡通	卡 通
相当	相 当
牌	牌
鞋	鞋
进做	进 做
旁边	旁 边
类似	类 似
内	内
认定	认 定
廠	廠
提醒	提 醒
十全	十 全
备货	备 货
商业	商 业
升降	升 降
面談	面 談
泰	泰
式	式
化工	化 工
宴會廳	宴 會 廳
纯	纯
普	普
国	国
土木	土 木
褰	褰
程度	程 度
快	快
艳	艳
上思	上 思
下注	下 注
这样	这 样
还	还
邮箱	邮 箱
紧张	紧 张
临行	临 行
镇	镇
几	几
构建	构 建
视	视
上升	上 升
帅哥	帅 哥
优质	优 质
红烧	红 烧
外贸	外 贸
试	试
令人	令 人
开奖	开 奖
机身	机 身
怏	怏
動	動
受众	受 众
此时	此 时
匯市	匯 市
钟情	钟 情
嬰	嬰
探	探
文史	文 史
年	年
藝名	藝 名
钢铁	钢 铁
万代	万 代
本书	本 书
自拍	自 拍
年	年
自	自
赴	赴
走	走
袍	袍
邪	邪
会	会
装饰	装 饰
州	州
今	今
業	業
夫人	夫 人
船厂	船 厂
凉	凉
美	美
挑	挑
莫大	莫 大
出轨	出 轨
咬	咬
记得	记 得
恭	恭
邮	邮
巨无霸	巨 无 霸
烧	烧
扫描	扫 描
回到	回 到
为	为
复印	复 印
旗	旗
校园	校 园
下降	下 降
五角	五 角
右边	右 边
创	创
第四	第 四
提	提
这	这
求	求
踩	踩
注	注
概念	概 念
雪地	雪 地
路	路
之际	之 际
梅	梅
娱	娱
我	我
轻轻	轻 轻
值得	值 得
储蓄	储 蓄
天	天
国人	国 人
董事	董 事
干燥	干 燥
间	间
一体	一 体
器	器
江苏	江 苏
给	给
赶紧	赶 紧
3月	3 月
为	为
繁	繁
一下	一 下
再开	再 开
大连	大 连
体能	体 能
溶	溶
气度	气 度
满	满
大规模	大 规 模
乎	乎
改造	改 造
取代	取 代
模	模
商业	商 业
相似	相 似
栏	栏
心	心
如果	如 果
烽	烽
诏	诏
内	内
儿子	儿 子
澳	澳
排名	排 名
活动	活 动
笨	笨
氬	氬
不行	不 行
训练	训 练
什	什
请	请
荥阳	荥 阳
4月	4 月
中有	中 有
在一起	在 一 起
借	借
过	过
路	路
网课	网 课
瑞昌	瑞 昌
力	力
最爱	最 爱
横扫	横 扫
匠	匠
蔓	蔓
睌	睌
鹰潭	鹰 潭
结成	结 成
保	保
鸢尾花	鸢 尾 花
经贸	经 贸
扫地	扫 地
围网	围 网
關心	關 心
即是	即 是
心	心
团团	团 团
过	过
工作	工 作
娱	娱
让	让
低调	低 调
人	人
清闲	清 闲
一句	一 句
时	时
服務	服 務
天	天
开	开
環境	環 境
搭档	搭 档
天下第一	天 下 第 一
銷售	銷 售
路上	路 上
爆	爆
娴	娴
作战	作 战
抢购	抢 购
星級	星 級
展出	展 出
款式	款 式
快	快
矛	矛
常	常
首页	首 页
啦	啦
共管	共 管
陶	陶
伙伴	伙 伴
话	话
开销	开 销
情报	情 报
漫画	漫 画
舉辦	舉 辦
阔	阔
操作	操 作
始	始
奋进	奋 进
生命	生 命
聘任	聘 任
不住	不 住
攻	攻
澳门	澳 门
沁	沁
提醒	提 醒
祖	祖
教	教
上班	上 班
开奖	开 奖
意思	意 思
下来	下 来
之类	之 类
决	决
这	这
申请	申 请
么	么
融	融
言及	言 及
节	节
合	合
影视	影 视
大都	大 都
读数	读 数
高职	高 职
斤	斤
名	名
胶	胶
成了	成 了
有什	有 什
到	到
正	正
接连不断	接 连 不 断
高层	高 层
澶	澶
每日	每 日
六枝	六 枝
介	介
为人	为 人
契合	契 合
介	介
勃	勃
而是	而 是
局长	局 长
简	简
黄色	黄 色
还	还
火	火
天数	天 数
灵活	灵 活
厂	厂
温情	温 情
惠來	惠 來
苏丹	苏 丹
氒	氒
中的	中 的
资料	资 料
保	保
人员	人 员
蜓	蜓
经	经
巨无霸	巨 无 霸
欢庆	欢 庆
反转	反 转
盘山	盘 山
桃紅	桃 紅
不可或缺	不 可 或 缺
法院	法 院
完善	完 善
元	元
車債	車 債
移	移
线下	线 下
我	我
固	固
強	強
晖	晖
阜新	阜 新
艺术	艺 术
救世	救 世
包含	包 含
项目	项 目
共产党	共 产 党
迈	迈
创造	创 造
内心	内 心
生殖	生 殖
联盟	联 盟
梦游	梦 游
侵略	侵 略
一部	一 部
貨款	貨 款
增添	增 添
陕	陕
有待	有 待
人力	人 力
对	对
启	启
看看	看 看
下单	下 单
篮	篮
全民	全 民
四	四
蕪	蕪
不过	不 过
源自	源 自
教	教
法	法
据	据
侀	侀
走	走
僧	僧
转基因	转 基 因
观众	观 众
进入	进 入
到目前为止	到 目 前 为 止
嚎	嚎
下面	下 面
冠状	冠 状
新生	新 生
京都	京 都
于今	于 今
病毒	病 毒
四	四
显出	显 出
累计	累 计
脑	脑
违	违
霍林郭勒	霍 林 郭 勒
散文	散 文
畫	畫
飾	飾
财物	财 物
建德	建 德
财政部	财 政 部
人	人
畞	畞
力	力
奥	奥
垎	垎
守候	守 候
里	里
盗	盗
将	将
协商	协 商
人	人
良多	良 多
红教	红 教
就	就
免	免
原本	原 本
多大	多 大
浗	浗
深	深
重點	重 點
国	国
范畴	范 畴
这	这
脂	脂
火	火
摇	摇
里	里
仓储	仓 储
面对面	面 对 面
各样	各 样
到位	到 位
丰	丰
沧桑	沧 桑
阜新	阜 新
欏	欏
规	规
长泰	长 泰
中国	中 国
创始	创 始
活动	活 动
带	带
冈	冈
把握	把 握
利于	利 于
锅	锅
過	過
德	德
毁	毁
纸	纸
式	式
250	2 5 0
提	提
店	店
研究院	研 究 院
脉	脉
邮件	邮 件
四川盆地	四 川 盆 地
哪	哪
保利	保 利
玉	玉
彻	彻
能	能
摩	摩
好评	好 评
这的	这 的
捕	捕
享	享
实现	实 现
跟从	跟 从
情人节	情 人 节
毅	毅
公益	公 益
計劃	計 劃
供不应求	供 不 应 求
人工	人 工
咕	咕
决赛	决 赛
搞笑	搞 笑
挑战	挑 战
吊销	吊 销
一体	一 体
王八	王 八
少年	少 年
人	人
歡迎	歡 迎
钻	钻
话	话
強勢	強 勢
短	短
正	正
人民	人 民
俱	俱
本	本
公	公
大字	大 字
会长	会 长
公路	公 路
方面	方 面
申請	申 請
中部	中 部
舆	舆
庄	庄
观	观
篮	篮
佐	佐
访客	访 客
立	立
连线	连 线
这样	这 样
四分	四 分
简介	简 介
升级	升 级
贼	贼
合	合
剑	剑
微	微
拉	拉
对上	对 上
交	交
处理	处 理
会集	会 集
活动	活 动
陵	陵
颜值	颜 值
理论	理 论
建国	建 国
商标	商 标
常	常
前几天	前 几 天
黃	黃
为	为
邵	邵
俱	俱
度	度
博客	博 客
认	认
话	话
位居	位 居
部落	部 落
山楂	山 楂
三島	三 島
亲吻	亲 吻
童子	童 子
烧	烧
内蒙	内 蒙
平台	平 台
业务	业 务
風	風
指令	指 令
心	心
推	推
處事	處 事
三国演义	三 国 演 义
州	州
一本	一 本
小心	小 心
依托	依 托
会	会
博	博
提高	提 高
集	集
泰安	泰 安
董事	董 事
三	三
军	军
身体健康	身 体 健 康
坚	坚
亚	亚
邦	邦
求	求
学历	学 历
西	西
营商	营 商
参观	参 观
意思	意 思
一千	一 千
办	办
自	自
日常	日 常
化解	化 解
工作	工 作
爱	爱
新型	新 型
就	就
并举	并 举
買房	買 房
人员	人 员
机械	机 械
平方米	平 方 米
巫	巫
常見	常 見
早	早
宠物	宠 物
截至	截 至
亿	亿
还	还
传感器	传 感 器
熊猫	熊 猫
阿波	阿 波
中国画	中 国 画
時候	時 候
好生	好 生
职称	职 称
透露	透 露
讯	讯
小头	小 头
式	式
正	正
调整	调 整
一塊	一 塊
成为	成 为
艾	艾
门面	门 面
继	继
实现	实 现
世界	世 界
老河口	老 河 口
叮	叮
员工	员 工
社	社
紐西蘭	紐 西 蘭
感情	感 情
余	余
咱们	咱 们
进行	进 行
主義	主 義
唯	唯
囨	囨
围网	围 网
无	无
无线	无 线
发生	发 生
吐	吐
同	同
椰子	椰 子
国人	国 人
走出	走 出
还	还
分为	分 为
基础	基 础
概	概
关注	关 注
无锡	无 锡
块	块
中国	中 国
境界	境 界
于	于
评	评
已	已
旗舰	旗 舰
轉向	轉 向
干	干
享有	享 有
试	试
输入	输 入
心血	心 血
公	公
局部	局 部
成本	成 本
短	短
旺	旺
国际	国 际
决	决
兴奋	兴 奋
認	認
西	西
傳	傳
上体	上 体
能	能
弱	弱
微	微
京	京
请问	请 问
道路	道 路
国	国
栖	栖
闲暇	闲 暇
火灾	火 灾
平稳	平 稳
大国	大 国
么	么
击败	击 败
惑	惑
无敌	无 敌
双休	双 休
扬	扬
华盛顿	华 盛 顿
昆	昆
组织	组 织
发风	发 风
公	公
高管	高 管
利	利
融	融
曾经	曾 经
博士	博 士
台南	台 南
桥	桥
法	法
如何	如 何
娱	娱
能	能
宾	宾
外资	外 资
山坡	山 坡
屏幕	屏 幕
从	从
日喀则	日 喀 则
价钱	价 钱
会	会
确	确
跟前	跟 前
导	导
公园	公 园
可	可
登記	登 記
步	步
创始人	创 始 人
简历	简 历
君	君
岭	岭
编译	编 译
黄河	黄 河
地图	地 图
下滑	下 滑
雲	雲
過程	過 程
提高	提 高
这	这
放弃	放 弃
冷	冷
旗	旗
鸡尾	鸡 尾
材质	材 质
法	法
多伦	多 伦
笢	笢
曾	曾
生产线	生 产 线
分之	分 之
堤	堤
向前	向 前
安心	安 心
设计师	设 计 师
余	余
到	到
天	天
红	红
国优	国 优
號	號
产业链	产 业 链
叫做	叫 做
稳	稳
深海	深 海
预订	预 订
满	满
種類	種 類
国体	国 体
从而	从 而
阳城	阳 城
筑	筑
操作	操 作
就	就
示范	示 范
欢乐	欢 乐
案	案
择	择
实现	实 现
磨刀石	磨 刀 石
悸	悸
闭目	闭 目
即	即
摩	摩
壈	壈
企业	企 业
玉山	玉 山
人	人
突围	突 围
樂透	樂 透
还	还
喀	喀
红	红
一面	一 面
正	正
就	就
評分	評 分
交	交
关注	关 注
在位	在 位
决心	决 心
江宁	江 宁
展	展
過後	過 後
利	利
规划	规 划
证	证
生计	生 计
合照	合 照
蛇	蛇
业	业
实物	实 物
拉	拉
夠	夠
黑桃	黑 桃
内	内
建档	建 档
荣耀	荣 耀
有价	有 价
使命	使 命
劃	劃
本成	本 成
給	給
引诱	引 诱
家	家
台湾	台 湾
郭	郭
均	均
中	中
可	可
蒙古语	蒙 古 语
震	震
鲅鱼	鲅 鱼
边处	边 处
办	办
间房	间 房
是时	是 时
中	中
加害	加 害
摇	摇
环球	环 球
么	么
视	视
湖水	湖 水
武	武
在外	在 外
当天	当 天
变	变
刚	刚
醒悟	醒 悟
铁路	铁 路
和亲	和 亲
郁	郁
纷纷	纷 纷
身材	身 材
对	对
责任	责 任
淡	淡
今	今
避	避
家规	家 规
分子	分 子
移	移
京	京
导	导
里面	里 面
晴	晴
圍	圍
业	业
舉	舉
业	业
处在	处 在
战略	战 略
祝愿	祝 愿
郁	郁
受邀	受 邀
渴望	渴 望
聯合會	聯 合 會
对	对
乞	乞
心想	心 想
峻	峻
东	东
物美价廉	物 美 价 廉
驱动程序	驱 动 程 序
街女	街 女
照顾	照 顾
十五	十 五
同期	同 期
教	教
人员	人 员
高階	高 階
查禁	查 禁
父	父
狹小	狹 小
结婚	结 婚
残留	残 留
家	家
加工厂	加 工 厂
晚间	晚 间
指导	指 导
有情	有 情
地位	地 位
生面	生 面
可	可
攻坚	攻 坚
借	借
综	综
党建	党 建
沙盘	沙 盘
中	中
字表	字 表
中	中
胶	胶
什么	什 么
策	策
屠	屠
西沙	西 沙
相比	相 比
网赌	网 赌
随后	随 后
康保	康 保
台风	台 风
非法	非 法
餐厅	餐 厅
早期	早 期
海建	海 建
拥护	拥 护
免	免
六合	六 合
保	保
值得	值 得
声明	声 明
票	票
可	可
基于	基 于
曲阳	曲 阳
无法	无 法
印发	印 发
众	众
教	教
据	据
法	法
公	公
首页	首 页
基层	基 层
青绿	青 绿
哲	哲
元	元
保	保
借	借
娱	娱
红	红
上将	上 将
既定	既 定
仅	仅
公益	公 益
婚纱	婚 纱
鼓	鼓
竞争力	竞 争 力
诏	诏
必恭必敬	必 恭 必 敬
敬	敬
橱柜	橱 柜
比分	比 分
观赏	观 赏
板块	板 块
孤本	孤 本
狂	狂
介	介
華大	華 大
间	间
家电	家 电
火	火
即	即
经济	经 济
帶領	帶 領
前天	前 天
揭牌	揭 牌
影像	影 像
弹药	弹 药
语言	语 言
应该	应 该
文县	文 县
导	导
路	路
志	志
么	么
推进	推 进
花蓮	花 蓮
尚未	尚 未
校对	校 对
焊工	焊 工
利	利
社	社
作出	作 出
澳	澳
签发	签 发
婴	婴
脑	脑
生命	生 命
里	里
斋	斋
照片	照 片
经	经
预计	预 计
间	间
基	基
商	商
惊蛰	惊 蛰
载	载
圆	圆
浩特	浩 特
一百	一 百
快	快
个	个
第五	第 五
这	这
有關	有 關
组成	组 成
断粮	断 粮
进行	进 行
快餐	快 餐
力	力
沦为	沦 为
展出	展 出
离开	离 开
脂	脂
预防	预 防
资讯	资 讯
阜南	阜 南
个	个
不是	不 是
起急	起 急
良	良
有一些	有 一 些
爽	爽
体格检查	体 格 检 查
条	条
内	内
个	个
截至	截 至
特有	特 有
全体	全 体
帖	帖
广场	广 场
开弓没有回头箭	开 弓 没 有 回 头 箭
獨立	獨 立
联系	联 系
天气	天 气
感到	感 到
度	度
去世	去 世
兴办	兴 办
业务	业 务
妙	妙
百家	百 家
敲	敲
自主	自 主
绌	绌
存储	存 储
十足	十 足
箭	箭
蘭	蘭
莘县	莘 县
鍟	鍟
新冠	新 冠
展现	展 现
满	满
貼	貼
讓	讓
妹子	妹 子
拉	拉
扬州	扬 州
工艺	工 艺
过度	过 度
爱	爱
我等	我 等
汗	汗
这	这
深	深
熔	熔
周期	周 期
角度	角 度
些	些
粤	粤
試	試
观	观
妇	妇
对	对
均	均
内	内
鼎	鼎
键角	键 角
快	快
贡献	贡 献
大多	大 多
姹	姹
乐园	乐 园
戏	戏
国人	国 人
抹黑	抹 黑
营造	营 造
繼	繼
電子	電 子
欺诈	欺 诈
旋	旋
鐮	鐮
新闻	新 闻
微信	微 信
华蓥	华 蓥
玩具	玩 具
妥	妥
役	役
土語	土 語
异	异
鱿	鱿
耳目	耳 目
到了	到 了
拦住	拦 住
载	载
店	店
国	国
滿足	滿 足
铅	铅
作者	作 者
英雄	英 雄
这次	这 次
军事	军 事
刻	刻
迨	迨
坡县	坡 县
相比	相 比
预计	预 计
甸	甸
指	指
宁夏	宁 夏
平均	平 均
力	力
回應	回 應
画幅	画 幅
庄	庄
輸	輸
温	温
毅力	毅 力
校	校
结	结
经	经
安装	安 装
时	时
提升	提 升
汽车	汽 车
弥	弥
坪	坪
忽	忽
特朗普	特 朗 普
中	中
人	人
我	我
景山	景 山
其他	其 他
天池	天 池
岳阳	岳 阳
循	循
公	公
每年	每 年
之无	之 无
初心	初 心
不给	不 给
之中	之 中
力	力
载	载
本质	本 质
于	于
技術含量	技 術 含 量
东风	东 风
流程	流 程
细	细
恐怕	恐 怕
蟮	蟮
紧	紧
遥	遥
投注	投 注
寄生虫	寄 生 虫
鸽	鸽
操控	操 控
喜	喜
记	记
桑	桑
兵	兵
中国特色	中 国 特 色
据悉	据 悉
楼	楼
微微	微 微
早点	早 点
钩	钩
降低	降 低
调研	调 研
避	避
勒令	勒 令
曾	曾
保護膜	保 護 膜
系	系
漁	漁
遭遇	遭 遇
唐	唐
合	合
风雨	风 雨
首位	首 位
同	同
厅	厅
液压	液 压
整體	整 體
手记	手 记
鲍	鲍
抽	抽
立	立
书	书
西	西
血管	血 管
忠	忠
彩电	彩 电
人民	人 民
与	与
始	始
提	提
灵敏	灵 敏
收益率	收 益 率
结	结
星光	星 光
能為	能 為
满	满
删除	删 除
努力	努 力
平和	平 和
总攻	总 攻
注	注
友的	友 的
家家	家 家
会	会
就	就
牌	牌
模	模
青草	青 草
机制	机 制
泉水	泉 水
宣	宣
山脉	山 脉
年	年
上游	上 游
體系	體 系
资料	资 料
定式	定 式
流感	流 感
年	年
恒久	恒 久
擦	擦
终	终
巩	巩
消	消
没法	没 法
欧美	欧 美
自力更生	自 力 更 生
比对	比 对
南	南
承认	承 认
无所谓	无 所 谓
邮	邮
鞋	鞋
变成	变 成
耕耘	耕 耘
中国	中 国
出来	出 来
靜	靜
掠过	掠 过
儿童	儿 童
鋼	鋼
饮马	饮 马
声音	声 音
东北亚	东 北 亚
汉中	汉 中
遠	遠
業	業
党	党
首	首
节	节
街道	街 道
条	条
训	训
皇马	皇 马
醴陵	醴 陵
介	介
个	个
潞	潞
沸	沸
盈利	盈 利
水面	水 面
好多	好 多
就业	就 业
国	国
与	与
使用	使 用
傲	傲
成	成
占先	占 先
丫头	丫 头
模	模
官员	官 员
垮	垮
天	天
水利	水 利
无	无
细	细
决策	决 策
超	超
新市	新 市
炭	炭
骄	骄
匈牙利	匈 牙 利
管辖	管 辖
单	单
发热	发 热
开阳	开 阳
时	时
等	等
如同	如 同
元	元
恳请	恳 请
国	国
符合	符 合
告别	告 别
制冷剂	制 冷 剂
讲座	讲 座
不止	不 止
板	板
